δρύπτω|δρύψ̓|δρύφθη|δρυψαμένω
θοόω|ἐθόωσα
δεδίσκομαι|δεδισκόμενος
ἀποδειροτομέω|ἀπεδειροτόμησα|ἀποδειροτομήσειν|ἀποδειροτομήσω
τρώγω|τρώγειν
ῥύομαι|ῥύονται|ἐρρύσατο|ῥύεται|ῥύσαιτό|ῥύεταί|ῥύοιτο|ῥύομαί|ἔρυτο|ῥυσάσθην|ἔρυσο|ῥῦσθαι|ῥῦσαι|ῥύατ̓|ῥύετ̓|ῥυσάμην|ῥύομ̓|ἐρύετο|ῥύοισθε|ῥύσατ̓|ῥύσαιτο
προσειλέω|προτιειλεῖν
κεῖμαι|κείσθω|κείσοντ̓|κέαται|κεῖμαι|κέων|ἐκείμην|κέατο|κείσεθ̓|κείμεθ̓|κέσκετ̓|κείμενον|κεῖτο|κείατ̓|κεῖσθαι|κέονται|κείσομαι|κειμένῳ|κείσεται|κέατ̓|κεῖτ̓|κεῖταί|κείμεν̓|κείμενος|κείμεθα|ἔκειτο|κειμένου|κεῖθ̓|κεῖσο|κεῖσαι|κείμενα|ἐκείμεθα|κεῖντο|κείσομ̓|κείμην|κείσεαι|κεῖται
ἀποπνέω|ἀποπνείων|ἀποπνείουσα|ἀποπνείουσαι
εἴδω|εἰδυῖα|εἰδησέμεν|εἴσατο|οἶδεν|εἴδετ̓|ἴστέ|εἰδότες|ᾔδεεν|ἠείδης|ἰδέω|ᾔδεα|ἴσασιν|εἴσομαι
ἀπίσχω|ἄπισχε
τελέω|τετελεσμένον|τετέλεσται|τελέοιεν|τελέσωσι|τετελεσμένος|τελέσσῃς|τετέλεστο|τελέσειας|τελέσειε|τελέσσω|τελέω|τελέσειεν|τελέσαι|τελέσσαι|ἐτέλεσσα|τελέσω|τελέσθη|τέλεον|ἐτέλεσσας|τελέουσι|τέλεσ̓|ἐτέλεσσεν|τέλεσσαν|ἐτέλειον|τετελεσμένα|ἐτελέσθη|ἐτελείετο|τελέοντες|τελέσαιμεν|τελέσσῃ|τελεῖται|τελεῖσθαι|τελέεσθαι|ἐτέλεσσε|ἐτέλεσσαν|τελέωμεν|τελεῖ|τελέει|τελείεται|τελέουσιν|τελέσεἰ|τελέσαιμι|τέλεσόν|τελείει|τελέσῃ
ἐξευρίσκω|ἐξεύροι
στρατόω|ἐστρατόωνθ̓|ἐστρατόωντο
δισκέω|ἐδίσκεον
τολμάω|τολμήσεις|ἐτόλμησεν|τόλμησεν|τολμήσειεν|ἐτόλμας|ἐτόλμα|τόλμων|τολμήσαντα
πτήσσω|ἔπτηξαν|πτῆξε
ὑπεκπροφεύγω|ὑπεκπροφυγὼν|ὑπεκπροφύγοιμι
κατατήκω|κατέτηξεν|κατατήκετ̓|κατατήκομαι
ἀνιάζω|ἀνιάζουσιν|ἀνίαζον|ἀνίαζ̓|ἀνιάζῃ|ἀνιάζει|ἀνιάζων
στάζω|στάξον|στάξε|στάξ̓
οἰόομαι|οἰώθη
γνάμπτω|γνάμψεν
πέσσω|πέσσων|πέσσω|πέσσῃ|πεσσέμεν|πέσσει
κατέχω|καθέξει|κατείχετο|κάτεχ̓|κατέσχεν|κατασχομένη|κατάσχῃ|κατέχει|κατέχων|κατέχουσι|κατέχοντο|κάτεχεν|κατέσχετ̓|κατέσχετο|κατέχονται
ἀπατάω|ἀπάτησεν|ἀπάτησας|ἀπάτησε|ἀπατήσω
σμήχω|ἔσμηχεν
κυδαίνω|κύδηνεν|κυδαίνων|κύδαινε|κύδαινόν|κυδῆναι
καθοράω|καθορώμενος|καθορῶν
θαμβέω|θαμβήσασα|θαμβήσαντ̓|θάμβησαν|θάμβησε|ἐθάμβεον|θάμβησάν|θάμβησεν|θάμβησέν
αὐερύω|αὐερύοντα|αὐέρυον|αὐέρυσαν
πημί|φάσθε
ὑποκλίνομαι|ὑπεκλίνθη
ὑποσείω|ὑποσσείουσιν
εὐνάω|εὐνηθέντε|εὐνηθέντες|εὐνηθῆναι|εὐνηθεῖσα|εὔνησε
δαρθάνω|ἔδραθ̓
δολοφρονέων|δολοφρονέουσα|δολοφρονέων
ἀντιφερίζω|ἀντιφερίζεις|ἀντιφερίζειν
δαίω|δεδαίαται|δεδήει|δαιόμενον|δαίετο|δαιομένων|δάηται|δαιόμενος|δαῖον|δέδηεν|δαίεται|δέδηε|δαῖεν|δέδαε|δαῖε|δαῖέ
μάχομαι|μαχησομένους|μαχέσαιο|μαχέσθω|μαχέοιντο|μαχεούμενοι|μαχέσσατο|μάχεαι|μάχεσθ̓|μαχειόμενος|μαχησόμενον|μαχοίμην|μαχέονται|ἐμάχοντο|μάχοιτο|μαχόμην|μαχεσσαμένω|μαχέσσασθαι|μαχήσοντ̓|μαχήσεται|μαχησόμεθα|μαχεσσάμεθ̓|μάχεσθον|μαχησόμεθ̓|μάχηαι|μαχέσασθαι|μαχήσομαι|μαχεούμενον|μαχήσεσθαι|μάχηται|μάχοιο|μαχήσασθαι|μαχώμεθα|μαχήσεαι|μάχετ̓|μαχέσαιτο|μαχόμεσθα|μάχοντο|μαχέσκετο|μαχοίατο|μαχέσθην|μαχησόμενος|μάχωμαι|μάχονται|μαχεσσάμενον|μάχεσθαί|μάχεσθαι|μαχεσσαίμην|μαχόμεσθ̓|μαχησόμενοι|μάχωνται|μάχεσθε
συμμίγνυμι|συμμίσγεται
πνέω|πνείοντας|πεπνῦσθαι|πνείουσα|πνείουσαν|πνέει|πνείοντε|ἔπνευσ̓|πνείοντος|πνείοντες|πνεύσῃ|πνείει
ἀποπέτομαι|ἀποπτάμενος|ἀποπταμένη
ἵλημι|ἵληθι|ἵληθ̓
ἀχλύω|ἤχλυσε
μεταβουλεύω|μετεβούλευσαν
ὑποβάλλω|ὑπέβαλλεν|ὑββάλλειν
μηρύομαι|μηρύσαντο
διαφθείρω|διέφθορας|διαφθέρσει
καταφέρω|κατοίσεται
αἰνέω|αἰνήσωσιν|αἰνεῖτ̓|αἰνήσωσι|αἰνεῖτον|ᾔνησ̓|αἰνήσουσιν|αἴνεε|ᾔνεον
κτυπέω|κτυπέει|κτύπε|κτυπέων|ἔκτυπε|κτυπέουσαι
πυργόω|πύργωσάν
πυνθάνομαι|πεπύθοιτ̓|πέπυστο|πύθωνται|πυθοίμην|πυθοίατο|πύθησθε|πυνθανόμην|πύθηαι|πευσόμενον|πυθόμην|πεύσομαι|πέπυσσαι|πέπυσμαι|πυθέσθαι|πύθοιτο|πύθηται|πεύσεαι|πέπυσται|πυνθάνομαι|ἐπύθοντο|πυθέσθην|πευσόμενος|πεύσεται|ἐπέπυστο|πεπύσθαι|πεπύσθην
θήγω|θήγων|θηξάσθω|θήγει
φρίσσω|πεφρίκασι|φρίσσει|φρίξας|φρίσσουσιν|ἔφριξεν|πεφρίκασιν|πεφρικυῖαι
ῥιζόω|ἐρρίζωται|ἐρρίζωσεν
διασκίδνημι|διασκιδνᾶσιν
ἐπεντύνω|ἐπέντυε|ἐπεντύνονται
κτίζω|κτίσσε
ἀμφιέννυμι|ἀμφιέσαντο
σπεύδω|σπεύδοντε|σπεύσομαι|σπευδέμεν|σπεύδουσ̓|σπεῦσε|σπεύδοντι|σπεύδοντα|σπευδόντων|σπεύδειν|σπεύσομεν|σπεύσατέ|σπεύδετον|σπεύδουσιν|σπεύδοντας|σπευδόντεσσιν
πολίζω|πολίσσαμεν|πεπόλιστο
εἴδομαι|εἴδοντο|εἰδομένη|εἴδεται|εἴδονθ̓|ἐείσαο|εἰσάμενος|εἴσαντο|εἴσαιτο|εἰδόμενος|ἐεισάμενος|ἐείσατο|εἴσατ̓|ἐεισαμένη|εἰσαμένη
συγκλονέω|συνεκλόνεον
θεμόω|θέμωσε
λάμπω|λάμπετον|λαμπόμενοι|λαμπομενάων|λαμπομένης|λάμπετο|λάμπ̓|λάμφ̓|λαμπέσθην|ἐλάμπετο|λαμπόμενος|λάμπε|λαμπόμενον|ἔλαμπε
ὄλλυμι|ὄλωμαι|ὀλέσῃ|ὤλεσας|ὀλόμην|ὀλλύντάς|ὀλέεσθαι|ὄλεσσον|ὤλετό|ὀλέσσεις|ὀλέσαι|ὄλωλεν|ὀλλυμένων|ὀλέσσει|ὤλεσε|ὄλωλε|ὄλεσσαν|ὄλοισθε|ὄλεθ̓|ὀλέσαντες|ὀλλύμενοί|ὀλέσσας|ὀλέσασα|ὀλλύντ̓|ὀλέσῃς|ὤλεσ̓|ὀλέσω|ὤλετο|ὀλώλει|ὄληαι|ὀλέσειε|ὀλέσθαι|ὀλλύντων|ὄλεσαν|ὀλέσσῃ|ὀλέσσαι|ὄλοντο|ὀλεῖται|ὄλεσεν|ὤλεσα|ὤλετ̓|ὄλωνται|ὀλέσαντ̓|ὄλεσσεν|ὀλλὺς|ὄλωλας|ὤλεσαν|ὄλεσε|ὤλεο|ὀλώλῃ|ὀλέσωσιν|ὀλέεσθε|ὄλεσσε|ὤλονθ̓|ὀλλῦσαι|ὀλέσσῃς|ὤλεθ̓|ὀλέσας|ὤλεσεν|ὄλετ̓|ὄληται|ὀλλυμένους
ἀφύσσω|ἀφυσσόμενοι|ἀφύσσας|ἀφύσσατο|ἄφυσσε|ἀφύσσων|ἄφυσσον|ἀφυσσάμενοι|ἀφυσσόμενος|ἀφυσσάμεθ̓|ἠφυσάμην|ἀφύξειν|ἠφύσσετο|ἄφυσσεν|ἠφύσαμεν|ἤφυσ̓
σκαίρω|σκαίρουσιν|σκαίροντες
ῥέω|ῥέε|ἔρρεον|ἔρρεε|ῥύη|ἔρρεεν|ῥέει|ῥέουσαι|ἔρρει|ῥέοντα|ῥέουσιν|ῥέοντες|ῥέον|ῥέοι|ῥέοντε|ῥέεν|ῥέων|ῥέοντος
χρίω|χρῖσαί|χρῖσέν|ἔχρισεν|χρῖον|χρισάμεναι|χρίεται|χρίσομαι|χρῖεν|χρῖσεν|χρίεσθαι|χρῖσαν|χρῖσόν
εἰσχέω|ἐσέχυντο
οἰνίζομαι|οἰνίζεσθε|οἰνίζοντο
ἀπαείρω|ἀπαειρόμενον
πατέω|πάτησαν
δείξω|δίον
φυσάω|φύσει|φυσῶντες|ἐφύσων
συνίημι|ξυνέηκε|ξυνίει|ξύνες|συνώμεθα|ξυνέηχ̓|ξύνετο|ξύνιεν
ἀμφίστημι|ἀμφέσταν|ἀμφίσταθ̓
καθαίρω|καθαίρειν|κάθηρεν|κάθηρον|καθήραντες|καθήρατε|ἐκάθηρε|καθῆραι|κάθηράν|κάθαιρον
δραγμεύω|δραγμεύοντες
χαλιφρονέω|χαλιφρονέοντα
γηθέω|γεγήθει|γηθεῖ|γηθήσαι|γήθησέν|γήθησαν|ἐγήθεις|γηθήσειν|ἐγήθεον|γηθήσει|ἐγήθεεν|γηθήσειε|γηθήσειεν|γέγηθε|γήθησε|γήθησεν
μεθέπω|μετασπὼν|μετασπών|μέθεπε|μεθέπεις|μετασπόμενος
προκαλίζομαι|προκαλίζεο|προκαλίζετο
ἀγκάζομαι|ἀγκάζοντο
εἰσεῖδον|εἰσιδέειν
κατερητύω|κατερήτυε|κατερήτυον|κατερήτυεν
ἀλέομαι|ἀλεύασθαι|ἀλέηται|ἄλευαι|ἀλευάμενοι|ἀλέοντο|ἀλέασθε|ἀλευάμενον|ἀλεύεται|ἀλεύατο|ἀλευάμενος|ἀλεύατ̓|ἠλεύατο|ἀλεύαντο
τροχάζω|τροχόωντα
προσπλάζω|προσέπλαζε|προσπλάζον
συναντάω|συναντήσωνται|συναντήτην
βόσκω|βοσκήσεις|βόσκ̓|βόσκει|βοσκομενάων|βοσκέσκονθ̓|βοσκομένας|βοσκομένη|βόσκοντ̓|βόσκειν|βόσκουσι|βοσκόμενος|βόσκοι|βοσκομένης
περιτρέω|περίτρεσαν
ἀναστενάχω|ἀνεστενάχοντο|ἀναστενάχουσιν
ἐξέρχομαι|ἐξελθέμεναι|ἐξῆλθε|ἐξῆλθον|ἐξελθόντες|ἔξελθε|ἐξελθών|ἐξελθὼν|ἐξελθόντε|ἐξελθεῖν|ἐξέλθωμεν|ἐξελθόντα|ἐξελθοῦσα
ὁμοιόω|ὁμοιωθήμεναι
κατέρχομαι|κατῆλθον|κατελθόντ̓|κατέρχεται|κατῆλθε|κατήλυθον|κατήλθομεν|κατερχομένης|κατελθέμεν|κατελεύσομαι|κατῆλθεν
προλείπω|προλέλοιπεν|προλιπόντες|προλιπὼν|προλιπεῖν
ἀνακηκίω|ἀνεκήκιεν|ἀνακηκίει
ἀντιάω|ἀντιόων|ἀντιόωσαν|ἀντιάσας|ἀντιόωσι|ἀντιόωσιν|ἀντιάσαντες|ἀντιόωντες|ἀντιάασθε|ἀντιόωσα|ἀντιάσειεν|ἀντιοώντων|ἀντιάσεις|ἀντιάαν
δεῖ|δεῖ
ἀνασεύομαι|ἀνέσσυτο
προσστείχω|προσέστιχε
ματεύω|ματεύσομεν
ἀποπροτέμνω|ἀποπροταμών
ἀπέρχομαι|ἀπῆλθεν|ἀπελήλυθα|ἀπερχομένη|ἀπελήλυθε
χώομαι|χωομένης|χωόμενος|χωσαμένη|χώσατ̓|χώσεται|χωομένου|χώσατο|χωσάμενος|χωομένη|χώεο|χωομένῳ|χώετο|χωόμενοι|χωομένοιο|χωόμενός|χωόμενον|ἐχώσατο|χώεται
κεάζω|κέασαν|κέασσε|κεάσαιμι|κεάσθη|κεκεασμένα|κέασε|κεάσσαι|ἐκέασσε
ἀποξύω|ἀποξύσας
ἀποπλήσσω|ἀποπλήξας
τεκταίνομαι|τεκτήναιτο|τεκτήνατο
καταπλήσσω|κατεπλήγη
ἐπιπροιάλλω|ἐπιπροΐηλε
κτείνω|κτεινώμεθα|κτενέω|κτείνοντο|κταμένοισιν|κτανέοντα|κτείνω|ἔκταν|κταμένῳ|ἔκταθεν|κτείνεσθαι|ἔκταν̓|κτεῖνον|κτενεῖ|κτεινομένων|κτεινόμενος|ἔκτανε|κτεῖν̓|κτεινομένους|κταμένης|κτείνας|κτείνεσκε|κτείνειν|ἔκτεινον|κτείνῃς|ἔκτανες|κτάνον|κτείναιμι|κτεῖνεν|κτεινομένῳ|κτεῖνας|κταμένοιο|κτείνωμεν|κτείνουσι|κτείνοντ̓|κταμένοισι|ἔκτεινε|κτείνοντές|κτενέει|κτέωμεν|κτείνεις|κτάνε|κτεῖναι|κτείνονται|κτεῖνε|κταμένων|κτείνων|ἔκτεινεν|κτάν̓|κτάμεναι|κτείνωμι|κτείνει|κτεινώμεθ̓|ἔκτα|κτενέειν|ἔκτανον|κτείνασα|κτενέεις|κτάσθαι|κτείναντες|κτείνῃ|κτεῖναί|ἔκτανεν
ἀπάγω|ἀπήγαγε|ἀπάξειν|ἀπήγαγον|ἀπάγουσι|ἀπήγαγεν
ἠλασκάζω|ἠλασκάζων|ἠλασκάζει
δειδίσκομαι|δειδισκόμενος|δειδίσκετο
κλάω|ἐκλάσθη|κλάσε
φθάνω|φθῇσιν|φθέωσι|φθέωμεν|φθάμενός|ἔφθη|ἔφθης|φθαίη|φθὰν|φθάμενος|φθάνει|φθήῃ|φθῆ|φθήσονται
ἀμφιμάχομαι|ἀμφιμάχεσθαι|ἀμφεμάχοντο|ἀμφιμάχωμαι|ἀμφιμάχωνται|ἀμφιμάχονται
αὐδάω|ηὔδα|αὐδήσασκεν|αὔδα|αὐδήσαντος|αὐδησάσης|αὐδήσασχ̓
ἀγγέλλω|ἀγγείλας|ἀγγείλωσι|ἀγγελέων|ἄγγειλον|ἀγγεῖλαι|ἀγγέλλων|ἀγγείλαιμι|ἤγγειλε|ἀγγελέουσι|ἀγγελέουσαν|ἤγγειλ̓|ἀγγελλόντων|ἀγγείλειε|ἀγγελέοντα|ἀγγελέουσα
μητιάω|μητιόωσι|μητιόωντες|μητιόωσα|μητιόωντι|μητιάασθε|μητιόωντο
ἐπιπταίρω|ἐπέπταρε
ἀποθρῴσκω|ἀποθρῴσκοντα|ἀποθρῴσκων
καταδέω|καταδήσῃ|κατέδησ̓|κατέδησαν|κατέδησε|κατέδει
ἐμμεμαώς|ἐμμεμαῶτε|ἐμμεμαώς|ἐμμεμαῶτες|ἐμμεμαὼς|ἐμμεμαυῖα|ἐμμεμαῶτ̓
ὁμιλέω|ὁμίλει|ὁμιλέοι|ὡμίλευν|ὁμιλήσωσι|ὁμίλεον|ὁμιλέομεν|ὁμιλεῖν|ὁμιλεῖ|ὡμίλησα|ὁμιλήσειεν|ὁμιλεῖς|ὁμιλήσαντες
φωνέω|φωνήσαντος|φωνήσαντε|ἐφώνησεν|φωνήσασα|φωνησάσης|φωνήσαντες|φωνήσασ̓|φώνησέν|φωνήσας
προσθέω|προσέθη
κελαδέω|κελάδησαν
φαγεῖν|φαγὼν|ἔφαγόν|φάγωσιν|φαγέμεν|φάγε|φάγῃσιν|φάγον|φάγοι|φάγωσι|ἔφαγε|φάγοιτε|φάγομεν|φαγέειν|φάγῃσι|φαγόντε|φάγες
εἶμι|ἰούσης|ἰόντε|ᾖεν|ἴτω|ἰόνθ̓|ἴῃ|ἐεισάσθην|ἤιε|εἴσεται|ἴθ̓|ἤϊ̓|ἰόντων|ἰέναι|εἶσ̓|ἴω|ἴτ̓|ᾔει|ἴοι|ἤιομεν|ἴασιν|ἰόντας|ἴεν|ἤἰ|ἤιεν|ἴε|ἤια|ἴθι|ἰὼν|εἴσατο|ἤϊσαν|ἤϊε|ἰόντ̓|ἰόντες|ἰοῦσαι|ἰών|εἶσι|ἰοῦσα|εἶμι|ᾖε|ἐείσατο|ἰόντι|ἰείη|ἰούσας|ἰούσῃ|ἴῃσθα|ἴῃσιν|εἶμ̓|ἴτην|ᾔομεν|ἴῃς|ἰόντα|ἴμεν|εἶσθα|ἤϊεν|ἴμεναι|εἶσιν|ἴσαν|εἴσῃ|ἤϊον|ἴομεν
ἀμφαραβέω|ἀμφαράβησε
πρόσφημι|προσέφης|προσέφη|προσφάσθαι|προσέφην
ὑπερίημι|ὑπερήσει
καταπτώσσω|καταπτώσσουσι|καταπτώσσοντες|καταπτώσσοντ̓|καταπτώσσειν
ἐμπάσσω|ἐνέπασσεν
ἀνακοντίζω|ἀνηκόντιζε
ἀμφιχέω|ἀμφιχυθῆναι|ἀμφεχύθη|ἀμφέχυτ̓|ἀμφεχέοντο|ἀμφιχυθεὶς|ἀμφιχυθείς
ἐξεμέω|ἐξεμέσειε|ἐξεμέσειεν
θέω|θέει|θεύσεαι|θέοντες|θέων|θέουσαι|θέειν|θέομεν|θεύσεσθαι|θείμεν|θέῃσιν|θέε|ἔθεεν|θέον|θέουσ̓|θέεν|θέοντος|θέουσα|θείῃ|θέεις|θέεσκον|ἔθει|θέῃσι|θέουσι|θέω|θείειν|θεούσης|θέοιμεν|θείω
ἐποπτεύω|ἐποπτεύεσκε
ἐγρήσσω|ἐγρήσσοντα|ἐγρήσσοντες|ἐγρήσσεις
ἠχέω|ἀχέων
κνάω|κνῆ
ἀνασπάω|ἀνεσπάσατ̓
θριγκόω|ἐθρίγκωσεν
ῥύσκομαι|ῥύσκευ
σεβάζομαι|σεβάσσατο
ἐλαύνω|ἔλασ̓|ἐλάσας|ἐλάσαντας|ἔλασσαν|ἐλάσσῃ|ἐλάσσας|ἐλαύνει|ἐλάσασκεν|ἐλάαν|ἤλασα|ἐλαύνων|ἤλασ̓|ἐλαύνετον|ἐλαυνόμενος|ἐλασσάμενος|ἐλάσῃ|ἠλασάμεσθα|ἐλαύνειν|ἔλασαν|ἐλάσειε|ἤλασε|ἐλαύνωσιν|ἔλασε|ἔλασσεν|ἐλαύνετε|ἐλάσωσιν|ἐλάσωσι|ἐλασαίατο|ἐλαύνοντες|ἐλάσεἰ|ἐληλέδατ̓|ἐλαυνόντων|ἐλόωσι|ἔλαυνες|ἐλήλαται|ἐλαύνοι|ἐλάσαιο|ἐλήλατο|ἔλασσε|ἐλάσαι|ἐλάσσαι|ἠλήλατο|ἐλαύνομεν|ἔλων|ἐλαυνέμεν|ἐλάσαντες|ἔλασεν|ἐλαυνομένην|ἤλασεν|ἐλαύνοντ̓|ἔλαυνε|ἤλασαν
ἐρυθαίνομαι|ἐρυθαίνετο
δηριάομαι|δηριόωντο|δηριαάσθων|δηριάασθον|δηριάασθαι|δηρίσαντο|δηρινθήτην
ῥάπτω|ῥάψαι|ῥάπτειν|ἐράπτομεν|ῥάψε|ῥάπτεις|ῥάπτομεν
καταδάπτω|καταδάψαι|κατέδαψαν|καταδάπτετ̓
ὀχλέω|ὀχλεῦνται
περιβαίνω|περιβάντα|περίβη|περιβῆναι|περίβησαν|περιβὰς
νέμω|νέμε|ἔνεμον|νέμεται|νεῖμαν|νεῖμε|νέμηαι|νέμεαι|νέμεσθαι|ἔνειμε|νέμονται|νέμοντο|νέμει|ἐνέμοντ̓|ἐνέμοντο|νεῖμεν|νεμόμεσθα|νεῖμον|ἔνειμαν|νέμοιτο|νέμων|νεμόμεσθ̓
ὑπερθρῴσκω|ὑπερθορέονται
συντίθημι|σύνθεο|σύνθεσθ̓|σύνθετο
ἐκγελάω|ἐκγελάσας
βρέμω|βρέμεται|βρέμει
καθεύδω|καθεύδειν|καθεῦδε|καθεύδετον|καθεῦδ̓
ὑπερηφανέω|ὑπερηφανέοντες
παρέλκω|παρέλκετο
ὀρούω|ὄρουσ̓|ὄρουσεν|ὄρουσαν|ὄρουσε|ὀρούσας
σκηρίπτομαι|σκηριπτόμενος|σκηρίπτεσθ̓
ψύχω|ψύξασα
σφηκόω|ἐσφήκωντο
ἀνθέω|ἀνθῆσαι
ὑπεξαλεύω|ὑπεξαλέασθαι
δραίνω|δραίνεις
ὀλοφύρομαι|ὀλοφυρόμεθ̓|ὀλοφυρόμεναι|ὀλοφυρομένους|ὀλοφυρομένην|ὀλοφύρατο|ὀλοφύρεαι|ὀλοφύρεται|ὀλοφύραο|ὀλοφυρόμενος|ὀλοφυρόμενοι|ὀλοφύρομαι|ὀλοφυρομένη
ἰύζω|ἰύζουσιν|ἰΰζοντες
βιάω|βιόωνται|βιῴατο|βιόωντό|βιήσεται|ἐβιήσατο|βιήσατο|βεβίηκεν|βιησάμενος
ἐνιζάνω|ἐνίζανον
σκήπτω|σκηπτόμενος|σκηπτόμενον
ἀπείργαθον|ἀποέργαθε|ἀποέργαθεν
χολόω|κεχολωμένον|χολωσάμενοι|χολωσάμεναι|κεχόλωσο|κεχόλωτο|κεχολώσεται|χολωθείς|κεχολώσεαι|χολώσῃς|ἐχολώθη|χολωσάμενος|ἐχολώσατο|ἐχόλωσεν|κεχολωμένη|χολώσαιτο|κεχολωμένοι|χολώσεαι|χολώσατο|κεχολώσομαι|χολωσαμένη|κεχόλωται|χολοῦται|κεχολωμένος|χολωθῇς|ἐχολώσατε|κεχολώατο|χολώθη|κεχολῶσθαι|χολωθεὶς|χολωσέμεν|χολωσάμενός
τήκω|τηκόμενος|τῆκε|τηκομένης|τήκετο|τέτηκα
ἐπιθαρσύνω|ἐπιθαρσύνων
τέρπω|τεταρπόμενος|ἐτέρφθησαν|ἐτέρφθητε|τερπώμεθα|τέρπονται|τέρπῃσιν|τέρπεσθον|τερπόμενοι|τάρπησαν|τερπομένη|τερπομένω|τερπομένοισιν|τερπέσθην|τέρπηται|τέρποιτο|τέρπεσθε|ἐταρπήτην|τεταρπόμενός|τέρποντο|ἔτερπεν|τραπείομεν|τεταρπόμενοι|τέρψομαι|τερπέσθω|τέρπεται|τέρπετ̓|ταρπώμεθα|τέρπετε|ταρπήμεναι|τέρποντες|τέρποντ̓|ἔτερπον|τερπόμεθ̓|τετάρπετο|τερπομένοισι|τέρπειν|τάρφθη|τεταρπώμεσθα|ἐτέρπετ̓|τέρπετο|ἐτέρπετο|τερπόμενος|τερφθείη|τέρπομ̓|ταρπῆναι|ἔτερπε|τέρπεαι|τάρφθεν|τέρπομαι|τερπόμενόν|τερπόμενον|τάρπημεν|τέρπεο|τέρπεσθαι|τερψάμενος
κέλλω|κέλσαι|κελσάσῃσι|ἐκέλσαμεν
αὐλίζομαι|αὐλιζομενάων
ἀποδοχμόω|ἀποδοχμώσας
χάσκω|χανὼν|χανών|χάνοι|κεχηνότα
προφέρω|προφέρουσα|προφέρηται|προφέρουσαι|προφέροις|προφέρωμεν|προφέρονται|πρόφερε|προφέρῃσι
παρεκπροφεύγω|παρεκπροφύγῃσιν
γανάω|γανόωσαι
ἐπαγλαίζω|ἐπαγλαϊεῖσθαι
εἰσίημι|ἐσιέμεναι
ἀνατρέχω|ἀνέδραμον|ἀνέδραμε|ἀνέδραμεν|ἀναδέδρομε
γεγωνέω|γεγώνευν|ἐγεγώνευν|γεγωνεῖν
καταικίζω|κατῄκισται
ἐκπίπτω|ἐκπεσέειν|ἔκπεσον|ἔκπεσε|ἔκπιπτον
αἰτέω|ᾔτεόν|ᾔτεον|ᾐτέομεν|ᾔτεεν|αἴτει|αἰτήσοντα|αἰτήσασα|αἰτήσων|ᾔτεέ|αἰτήσουσα|ᾔτεε
ἐπιφθονέω|ἐπιφθονέῃς
ἀπορρήγνυμι|ἀπορρήξας
παχνόω|παχνοῦται
εἴσειμι|εἴσειμι
πόρω|πεπρωμένον|πόρωσιν|ἔπορον|πόῤ|πέπρωται|πόρον|πορόντες|πόρε|ἔποῤ|πόροις|πόρῃ|πόρεν|πορὼν|πόροι|πορών|πόρῃσιν|πόρωμεν
μενεαίνω|μενεαίνετε|μενέαινεν|μενεαίνει|μενέαινον|μενεαινέμεν|μενέαινε|μενεήναμεν|μενεαίνεις|μενεαίνω|μενεαίνομεν|μενεαίνων
βέομαι|βείομαι|βέῃ|βέομαι
ἀναπηδάω|ἀμπήδησε
λάσκω|λελακυῖα|λάκε|λεληκὼς
ἱμάσσω|ἱμάσσω|ἵμασεν|ἱμάσσῃ|ἵμασ̓
ἀναλύω|ἀλλύεσκον|ἀλλύεσκεν|ἀνέλυσαν|ἀλλύουσαν
προμαχίζω|προμάχιζε|προμάχιζεν
ἔγκειμαι|ἐγκείσεαι
φθινύθω|φθίνυθον|φθινύθουσι|φθινύθουσιν|φθινύθεσκε|φθινύθει|φθινύθω|φθινύθειν
χράομαι|χρεώμενος
ἐγρηγορόων|ἐγρηγορόων
ἐξαίνυμαι|ἐξαίνυτο
οἴω|οἴω
πημαίνω|πημανθῆναι|πημήνειαν|πημάνθη|πημαίνει|πημανέειν
τρέχω|ἔδραμον|ἔδραμ̓|δράμεν|δραμέτην|τρέχει|θρέξασκον|ἔδραμε
ἀριθμέω|ἀριθμήσει|ἀριθμηθήμεναι|ἠρίθμεον|ἀριθμήσας|ἠρίθμει|ἀριθμήσω
βλεμεαίνω|βλεμεαίνων|βλεμεαίνει
ἐνστάζω|ἐνέστακται
πρίαμαι|πρίατο
μεταλήγω|μεταλήξαντι
ὑπερβάλλω|ὑπερβαλέειν|ὑπέρβαλε|ὑπειρέβαλον
ὑποσταχύομαι|ὑποσταχύοιτο
σήπω|σήπεται|σέσηπε|σαπήῃ
κατέπεφνον|κατέπεφνον|κατέπεφνεν|καταπέφνῃ|καταπέφνων|κατέπεφνε
τρίβω|τρίβεσθε|τρῖψαι|τριβέμεναι
ἀωτέω|ἀωτεῖτε|ἀωτεῖς
ἐφέλκω|ἐφέλκετο|ἐφέλκεται|ἐφελκομένοισι
διαφύσσω|διήφυσε|διαφυσσόμενον
ἀποπροαιρέω|ἀποπροελὼν
ἔξειμι|ἔξειμι|ἔξεισθα|ἐξιέναι|ἔξεσσι|ἔξιτέ
ἐάω|ἐάσομεν|ἔασκεν|ἐῶ|ἔασ̓|εἴασ̓|ἐάσει|ἐῶμέν|ἐῶσιν|ἔασκε|εἴασαν|ἔασεν|ἐάσετε|ἐάσουσιν|ἐάσειε|ἐάαν|ἐᾶν|εἰῶσ̓|ἐάᾳς|ἔασκες|ἐᾶσαι|ἐᾷς|εἴων|ἐάσατε|ἐᾷ|εἴασκεν|ἐῶσι|ἔασε|ἐάσῃς|ἔα|ἐάσαιμεν|εἴασκε|ἐῷμι|εἴασκον|ἐῶμεν|εἰῶ|ἐάας|ἐάσω|ἐάᾳ|ἔασας|εἴασχ̓|εἴας|ἐῷ|εἴασε|εἴασεν|εἰῶσι|εἰῶμεν|ἔασον|εἴα
παλιμπλάζομαι|παλιμπλαγχθέντας|παλιμπλαγχθέντα
ὁμοκλέω|ὁμόκλησάν|ὁμοκλήσειεν|ὁμοκλήσας|ὁμόκλα|ὁμόκλεον|ὁμοκλήσασκέ|ὁμοκλέομεν|ὁμόκλησαν|ὁμοκλήσαντες
βιβάω|βιβᾶσα
ἐπιπλέω|ἐπιπλὼς|ἐπιπλώσας|ἐπέπλεον|ἐπέπλως|ἐπιπλώων|ἐπιπλεῖν
ἐκτίνω|ἔκτισαν
ἐκβάλλω|ἔκβαλεν|ἔκβαλε|ἔκβαλον|ἔκβαλλε
βύω|βεβυσμένον
ἐντύω|ἔντυον|ἔντυεν
ἡγέομαι|ἡγήσομαι|ἡγήσασθαι|ἡγεῖσθαι|ἡγείσθω|ἡγεόμην|ἡγεῖθ̓|ἡγήσαιο|ἡγεῖτο|ἡγησάσθην|ἡγεῖτ̓|ἡγήσαιτο|ἡγήσατο|ἡγήσατ̓|ἡγησάσθω|ἡγείσθην
χωλεύω|χωλεύων
καθέννυμι|καταείνυσαν|καταειμένον
συγκυρέω|συγκύρσειαν
δαίνυμι|δαίνυσαι|δαινῦτό|δαίνυντο|δαίνυσθαί|δαισάμενοι|δαίνυνται|δαίνυσθ̓|δαινύμενοι|δαίσειν|δαινύῃ|δαίνυσθε|δαίνυνθ̓|δαινυμένω|δαίνυντ̓|δαινύατ̓|δαινύμενον|δαίνυται|δαίνυσθαι|δαινυμένοισι|δαίνυ|δαίνυνταί|δαίνὐ|δαινυμένους|δαινύντα|δαινύσθω
δεύω|δεύονθ̓|δεύοντο|δεύεσθαι|δεύεαι|δεῦε|δεύεται|δεύετο|δεύεσκον|ἐδεύησεν|δευήσεαι|δεύει|ἐδεύεο|δεύσω|δευέσθην|δευόμενον|δευήσεσθαι|δευέσθω|ἔδευεν|δευοίατο
ἀλδήσκω|ἀλδήσκοντος
ἔκφημι|ἐκφάσθαι
ἐκτελέω|ἐκτελέωμεν|ἐξετελεῦντο|ἐκτελέσωσι|ἐξετέλεσσα|ἐκτελέσω|ἐκτελέσας|ἐξετέλεσσε|ἐκτελέουσιν|ἐκτελέσειεν|ἐξετέλεσσεν|ἐξετέλειον|ἐκτελέσαντες|ἐκτετέλεσται|ἐκτελέειν|ἐκτελέει|ἐκτελέεσθαι|ἐξετέλεσσαν|ἐκτελέω
τρέμω|τρέμε|ἔτρεμε|τρέμον
προβοάω|προβοῶντε
πληκτίζομαι|πληκτίζεσθ̓
λεύσσω|λεύσσων|λεῦσσ̓|λεύσσουσιν|λεύσσω|ἐλεύσσομεν|λεῦσσε|λεύσσει|λευσσόντων|λεύσσετε|λεύσσουσι
δάμνημι|δάμναται|δάμνημ̓|δάμνατο|δάμνασθαι|δάμνησι
φλέγω|φλέγετο|φλέγει
ἀμέρδω|ἀμερθῇς|ἄμερσε|ἀμέρδεαι|ἀμέρδει|ἄμερδεν|ἀμέρσαι
ἐπηπύω|ἐπήπυον
περιφύομαι|περιφῦναι|περιφῦσ̓|περιφύς|περιφὺς
καταθνήσκω|κάτθανε|καταθνῄσκων|κατατεθνηῶτας|κατατεθναίη|κατατεθνηυίης|κατατεθνηῶτι|κατατεθνηῶτος|κατατεθνηώτων|κατατεθνήκασι|κάτθαν̓
ἀμφιμυκάομαι|ἀμφιμέμυκεν
παρακαταβάλλω|παρακάββαλεν|παρακάββαλον
ἐξέρομαι|ἐξείρετο|ἐξερέοιθ̓|ἐξερέοιτο|ἐξερέηται|ἐξερέεσθαι|ἐξερέῃσι
εἰσέρχομαι|εἰσήλυθον|εἰσελθών|ἐσελεύσομαι|εἰσῆλθον|εἰσήλυθεν|εἰσῆλθ̓|εἰσῆλθεν|εἴσελθε|ἐσέλθετε|εἰσελθοῦσα|εἰσῆλθε|ἐσέρχονται|εἰσέλθῃσι|ἐσέρχεται|εἰσέρχεο|ἔσελθε|ἐσελθεῖν|εἰσελθὼν
μηχανάομαι|μηχανόωντο|μηχανάασθε|μηχανόωνται|μηχανόωντας|μηχανάασθαι|μηχανόῳτο
εἰσάνειμι|εἰσανιών
ἄλαλκε|ἀλάλκῃσιν|ἄλαλκε|ἀλαλκέμεναι|ἀλάλκοις|ἀλάλκοιεν|ἀλαλκέμεν|ἀλάλκοι|ἀλαλκών|ἀλαλκεῖν
θλίβω|θλίψεται
ἀναδύνω|ἀναδύη|ἀνεδύσετο|ἀνδύεται|ἀναδῦναι|ἀνέδυ
προβαίνω|προβέβηκε|προβεβήκῃ|προβέβηκας
ἕωμεν|ἕωμεν
ἀπόλλυμι|ἀπώλεσαν|ἀπώλεο|ἀπολέσθαι|ἀπόλλυται|ἀπολοίμην|ἀπωλόμεθ̓|ἀπώλεσεν|ἀπόλωλε|ἀπώλεσα|ἀπόλοιτο|ἀπόλωνται|ἀπόλεσσαν|ἀπολέσθω|ἀπολέσκετ̓|ἀπώλεσε|ἀπόλωλεν|ἀπολοίατο|ἀπόληται|ἀπόλοντο|ἀπώλετο|ἀπολλυμένους|ἀπώλεσ̓
ἀναστρέφω|ἀνστρέψειαν|ἀναστρέφομαι
ἀίσσω|ἀίσσουσιν|ἀΐσσοντε|ἤϊσσον|ἀΐσσουσι|ἀίξαντε|ἤϊξε|ἀίξασα|ἀΐξας|ἀΐξαντα|ἀΐσσονται|ἠΐχθη|ἀΐσσουσα|ἀΐξασθαι|ἀΐσσων|ἀΐξῃ|ἀΐσσοντος|ἠΐχθησαν|ἀίσσοντα|ἀΐξωσι|ἀΐξασα|ἀΐξασκε|ἤϊξεν|ἤϊξαν|ἀΐξασαι|ἀϊχθήτην|ἤιξαν|ἀϊχθῆναι|ἀΐξαντε
ἔρρω|ἔρρων|ἔρρετε|ἔρῤ|ἔρρε|ἔρροντι|ἐρρέτω
ἀλαόω|ἀλάωσεν
ἐφίζω|ἐφεσσάμενος|ἐπιείσομαι|ἐπιέσσαμεν|ἐφέσσαι|ἐφίζεσκε|ἐπιεισαμένη|ἐφῖζε
ὁμαδέω|ὁμάδησαν
ἐποίχομαι|ἐποιχόμενος|ἐποιχομένης|ἐποιχομένην|ἐποιχομένη|ἐποιχόμενοι|ἐποιχόμενον|ἐπῴχετο|ἐποίχεσθαι
ἀπαυράω|ἀπηύρων|ἀποέρσειε|ἀπούρας|ἀπηύρας|ἀπηύρα
ἐνιαύω|ἐνίαυεν|ἐνίαυε
ἀποικίζω|ἀπῴκισε
ἀμφράζομαι|ἀμφράσσαιτο
δακρυπλώω|δακρυπλώειν
θρηνέω|θρήνεον|ἐθρήνεον
σκεπάω|σκεπόωσι
ἀγρέω|ἀγρεῖθ̓|ἄγρει
ἔργνυμι|ἐρχθέντ̓|ἔρχατο|ἐργομένη|ἐέργνυ|ἐέρχατο|ἔρχαται
ἐπιλλίζω|ἐπιλλίζουσιν
ἀμφιποτάομαι|ἀμφεποτᾶτο
πυκάζω|πύκασεν|πεπυκασμένα|πεπυκασμένος|πυκάσασα|πυκάσαι|πυκάζοιεν|πύκασε|πυκάσας
ὑφίημι|ὑφέντες
βροντάω|ἐβρόντησας|βρόντησε|βροντήσας|ἐβρόντησεν
ἐκκαλέω|ἐκκαλέσαντες|ἐκκαλέσας|ἐξεκαλεῖτο
ἀποστείχω|ἀπέστιχον|ἀποστείχειν|ἀπέστιχε|ἀπόστιχε
προσπελάζω|προσπελάσας
κυκάω|κυκώμενος|ἐκύκα|κυκόωντι|κυκώμενον|κύκησε|κυκωμένη|κυκήθησαν|κυκηθήτην
δύναμαι|δύνατο|δυνάσθη|ἐδύνασθε|δύνασαι|δυνάμεσθα|δύναται|δυνησόμεθ̓|ἐδύναντο|δυνήσεαι|δύναμ̓|δύναιο|δύναταί|ἐδυνάσθη|δυναίμην|δύνηαι|δυνήσατο|δυνήσεται|δυνάμην|δύναντο|δυναμένοιο|δύνανται|δύναμαι|δυνήσομαι|ἐδυνήσατο|δύναιτό|δύνασαί|δύνατ̓
ὄνομαι|ὀνόσαιτο|ὠνοσάμην|ὀνόσαιτ̓|ὀνοσσάμενος|ὀνόσσεται|ὀνόσασθ̓|ὄνοσαι|ὄνονται|ὄνοιτο|ὤνατο|ὀνόσσεσθαι
χολάω|χολοῦμαι
ἑταιρίζω|ἑταιρίσσαι|ἑταρίσσαιτο
ἅλλομαι|ἅλεται|ἆλσο|ἆλτο|ἆλτ̓|ἅληται
μανθάνω|μάθον|ἔμμαθεν|ἔμμαθες
χατίζω|χατίζεις|χατίζει|χατίζων
ξαίνω|ξαίνειν
εἰσαγείρω|ἐσαγείρατο|ἐσαγείρετο
ἐξελαύνω|ἐξήλασσαν|ἐξελάσαι|ἐξελάσας|ἐξελάσειε|ἐξελάων|ἐξελάσωσι|ἐξέλασ̓|ἐξήλαυνεν|ἐξελάαν|ἐξέλασε|ἐξελάσαιμι|ἐξήλασε|ἐξελάσαντας
ἀπολύω|ἀπολύσομεν|ἀπέλυσε|ἀπολυσόμεθ̓|ἀπέλυσας|ἀπέλυσεν|ἀπολυσάμενος
κρίνω|κρίνας|κρίνοντες|ἐκρίνατ̓|ἔκριναν|κεκριμένον|κρινώμεθ̓|κρίνοιμι|κρῖν̓|κρινάμενος|κρινάσθων|κεκριμένους|κρινθέντες|κρίνονται|κρίνασθαι|κρίνωσι|ἔκρινεν|κεκριμένοι|κρίνῃ|κρινθέντε|κεκριμένη|κρίνηται|κρίνων
ῥιγέω|ῥίγησέν|ἔρριγα|ῥιγήσειν|ῥίγησε|ἐρρίγει|ἐρρίγῃσι|ἐρρίγησε|ἐρρίγησαν|ῥίγησ̓|ἔρριγ̓|ῥίγησεν
κάτειμι|κατήιεν|κάτεισι|κατίμεν|κάτειμι|κατιοῦσα|κατιοῦσαν|κατιόντα
λέγω|ἐλέξατο|λέξαιτο|λέξασθαι|λέγοντο|ἐλέχθην|λέγε|λέγεσθαι|λέξεο|λέγων|ἐείλεον|λεγοίμεθα|λέξον|λέξεαι|λέγ̓|λέξεται|λέγοντες|λέξομαι|ἔλεκτο|λέξοντες|ἔλεξα|λέξο|ἐλέγμην|λέγομεν|λεξαίμην|λέξατο|λέκτο|λέγωμεν|λεγώμεθα|λέγεσθε|ἔλεγ̓|λεξάσθην|ἔλεξεν|λεξάσθων
ἐπιθέω|ἐπιθεῖτε
ὀχθέω|ὄχθησαν|ὀχθήσας
ἐπιμίμνω|ἐπιμίμνω
ἐμπίμπρημι|ἐνέπρησεν|ἐνιπρῆσαι
βιβρώσκω|βεβρωκὼς|βεβρώσεται|βεβρώθοις
ἐφομαρτέω|ἐφομαρτεῖτε|ἐφομαρτεῖτον
ἀνακαίω|ἀνέκαιον|ἀνέκαιε
ὑποφέρω|ὑπήνεικαν
βραχεῖν|ἔβραχε|βράχε|ἔβραχ̓
ἐπιδημεύω|ἐπιδημεύεις
ἀμφιτρομέω|ἀμφιτρομέω
κευθάνω|ἐκεύθανον
ἀποφθίνω|ἀποφθιμένου|ἀπέφθιτο|ἀποφθίσθω|ἀποφθίμενον|ἀποφθιμένη|ἀπέφθιθεν|ἀποφθίμην|ἀποφθιμένοιο
ἀνατίθημι|ἀναθήσει|ἀντίθεόν
ἐπικουρέω|ἐπικουρήσοντα
μετοχλίζω|μετοχλίσσειε|μετοχλίσσειεν
ῥοιβδέω|ῥοιβδήσειεν
ἀναρροιβδέω|ἀναρροιβδεῖ|ἀναροιβδεῖ|ἀνερροίβδησε
πήγνυμι|ἐπεπήγει|πῆξεν|πήγνυται|πήγνυτ̓|πῆξαί|πάγεν|πῆχθεν|πῆξε|πῆξαι|ἐπάγη|πήξαμεν|πήξεις|πεπήγει|πήξῃ|πέπηγεν|πήξαντ̓|ἔπηξεν|πήξας|ἔπηξε|πάγη
αἰχμάζω|αἰχμάσσουσι
ὑπνάω|ὑπνώοντας
παραφθάνω|παραφθαίησι|παραφθάμενος|παραφθὰς
ῥαίω|ῥαιομένου|ῥαίῃσι|ῥαῖσαι|ῥαίοιτο|ῥαίσῃ|ῥαισέμεναι|ἔρραιε|ἐρραίσθη
κυλίνδω|κυλίσθη|κυλίνδων|κυλίνδον|κυλινδόμενος|κυλινδόμενα|ἐκυλίνδετο|κυλίνδετο|κυλίνδει|κυλινδομένην|κυλίνδεσθαι|κυλινδομένη|κυλίνδεται|κυλινδόμενός
ἀφικνέομαι|ἀφικόμεθ̓|ἀφικοίμεθα|ἀφίκοντο|ἀφικώμεθα|ἀφῖχθαι|ἀφίκωμαι|ἀφίξεται|ἀφίκεσθε|ἀφίξεαι|ἀφικοίμην|ἀφίκοιο|ἀφίκηται|ἀφίκετο|ἀφίκωνται|ἀφίκηαι|ἀφίκεο|ἀφικέσθαι
ἀσπαίρω|ἤσπαιρε|ἤσπαιῤ|ἀσπαίροντα|ἀσπαίροντας|ἤσπαιρον|ἀσπαίροντες|ἀσπαίρουσα
σκυδμαίνω|σκυδμαινέμεν
ἀνακόπτω|ἀνέκοπτεν
ἀγαπάω|ἀγάπησα|ἀγαπᾷς
ἐπάγω|ἐπήγαγον|ἐπάγοντες
φλεγέθω|φλεγέθει|φλεγέθοντι|φλεγεθοίατο|φλεγέθουσιν
ἀναπίμπλημι|ἀναπλῆσαι|ἀναπλήσας|ἀναπλήσῃς|ἀναπλήσαντες|ἀναπλήσειν
ἀμφιστρατάομαι|ἀμφεστρατόωντο
ἐκδέχομαι|ἐξεδέχοντο
ἐπινεύω|ἐπένευσα|ἐπένευε
βαρύθω|βαρύθει
βαστάζω|ἐβάστασε|βαστάζοντα
ἀθύρω|ἀθύρων
γηράσκω|γηράσκωσι|ἐγήρα|γηράσκοντα|γηράς|γήρασκε|γηρασκέμεν|γηράσκει
ἐπιπλάζομαι|ἐπιπλαγχθείς
ἀπαγγέλλω|ἀπαγγεῖλαι|ἀπαγγείλῃσι|ἀπαγγέλλων|ἀπαγγέλλεσκε|ἀπαγγεῖλαί|ἀπαγγείλας|ἀπαγγείλειε
διαείδω|διαείδεται|διαείσεται
διεῖπον|διείπομεν|διαειπέμεν|δίειπέ
θοινάω|θοινηθῆναι
θαρσύνω|θαρσύνω|θάρσυνάς|θαρσύνονθ̓|θάρσυνον|θαρσύνεσκε|θάρσυνέ|θαρσύνων
ἀνέβραχε|ἀνέβραχεν|ἀνέβραχε
ἐπανατίθημι|ἐπανθέμεναι
μιγάζομαι|μιγαζομένους
λιστρεύω|λιστρεύοντα
καταμάω|καταμήσατο
κεραίζω|κεραΐζων|κεραϊζέμεν|κεραϊξέμεν|κεραϊζομένην|κεραϊζομένους|κεραΐζετον|κεράϊζε
ἀποκόπτω|ἀπέκοψα|ἀπέκοψε|ἀποκόψειν
διαπλήσσω|διαπλῆξαι|διαπλήσσοντες
ἰάλλω|ἴηλον|ἰήλω|ἰῆλαι|ἴηλεν|ἴαλλε|ἴαλλεν|ἴηλα|ἴαλλον|ἰάλλοντα|ἰάλλειν
ἀγινέω|ἀγίνεον|ἠγίνεον|ἀγίνεσκον|ἀγινεῖ|ἀγινεῖς|ἀγινέμεναί
ἐναμέλγω|ἐνάμελγεν
ἀκοστάω|ἀκοστήσας
νεμεσίζομαι|νεμεσιζέσθω|νεμεσίζετο|νεμεσίζεται|νεμεσίζομαι|νεμεσίζομ̓|νεμεσίζῃ
μέδομαι|μέδοντο|μεδέσθην|μεδήσομαι|μεδέσθω|μέδηαι|μεδοίατο|μεδώμεθα|μέδεσθαι|μέδηται
πέκω|πεξαμένη|πείκετε
ἐξαποδύνω|ἐξαπέδυνε
ὑπαλύσκω|ὑπάλυξας|ὑπάλυξε|ὑπαλύξας|ὑπάλυξεν|ὑπαλύξαι
ἀνακυμβαλιάζω|ἀνακυμβαλίαζον
ἀποδρύπτω|ἀπέδρυφθεν|ἀποδρύφοι|ἀποδρύψωσι
παραπλέω|παρέπλω
ἐπιτίθημι|ἐπιθεῖτε|ἐπιθήσομεν|ἐπίθες|ἐπέθηκεν|ἐπέθηκε|ἐπιθεῖσα|ἐπιθήσω|ἐπιθήσει|ἐπιθέντε|ἐπέθηχ̓|ἐπέθηκα|ἐπιθεῖναι|ἐπιθείη|ἐπιθήσεις
παρατρέχω|παρέδραμον|παραδραμέτην|παρέδραμεν
ἀμύσσω|ἄμυσσε|ἀμύξεις
παραβάλλω|παραβαλλόμενος
πένομαι|πένεσθαι|ἐπένοντο|πενώμεθα|πένοντο
ἀντιτορέω|ἀντετόρησεν|ἀντιτορήσας
ἀνέρχομαι|ἀνελθών|ἀνερχόμενον|ἀνερχομένῳ|ἀνελθὼν|ἀνήλυθεν
εἰσάλλομαι|ἐσήλατο|ἐσᾶλτο
εἰλύω|εἴλυται|εἰλυμένω|εἰλυμένα|εἰλύσω|εἰλυμένοι|εἴλυτο|εἰλύαται|εἰλυμένος
φθέγγομαι|φθέγξατο|φθέγξατ̓|φθεγγώμεθα|φθεγξάμενος|φθεγξάμενός|φθεγγομένου|φθεγξαμένη|φθέγγεο|φθέγξομ̓|φθεγξαμένου|φθέγγοντο
ἐξανύω|ἐξανύω|ἐξήνυσε
ἐξαναδύομαι|ἐξαναδῦσαι|ἐξαναδύς
προσάπτω|προτιάπτω
μετανίσσομαι|μετενίσετο|μετενίσσετο
προγίγνομαι|προγένοντο
διερέσσω|διήρεσσ̓|διήρεσα
χαίρω|χαῖῤ|χαὶρων|κεχαρηότα|χαίρετον|χαῖρέ|χάρη|χαίρετ̓|χαίρουσιν|ἔχαιρε|χαίροντα|κεχαρησέμεν|χαίρων|κεχάροιτο|χήρατο|χαίρω|χαίρετε|χαίρει|χαῖρεν|κεχαρήσεται|χαρείη|κεχαροίατο|ἐχάρη|χαρέντες|χαίρεσκον|ἐχάρημεν|χαίροντ̓|χαίρῃς|χαῖρον|ἐχάρησαν|χαίρουσι|χαίροντες|χαῖρε|χαίροντι|χαιρήσειν|χάρησαν|κεχάροντο
προπροκυλίνδομαι|προπροκυλινδόμενος
ἐπαλάομαι|ἐπαληθεὶς|ἐπαληθῇ|ἐπαληθείς
ἀπεῖπον|ἀποείπῃ|ἀποείποι|ἀπέειπε|ἀπόειπ̓|ἀποειπὼν|ἀποείπω|ἀποειπεῖν|ἀπειπέμεν|ἀπέειπεν|ἀπειπόντος
πωτάομαι|πωτῶντο
κελητίζω|κελητίζειν
ἀποθνήσκω|ἀποθνῄσκων|ἀποθνήσκων|ἀποτεθνηῶτος|ἀποτέθνασαν
ἰδίω|ἴδιον
θαρσέω|θαρσήσας|τεθαρσήκασι|θάρσει|θαρσῶν|θάρσησε
νίσσομαι|νίσοντο|νισόμενον|νίσομαι|νισσόμεθα
πιέζω|πιέζειν|πιεσθεὶς|πίεζον|πίεζεν|ἐπίεζε
μαργαίνω|μαργαίνειν
ἀλδαίνω|ἤλδανε
ὁμαρτέω|ὁμαρτήσειεν|ὁμαρτήσαντες|ὁμαρτέων|ὁμαρτήσανθ̓
ἀνιάω|ἀνιηθέντα|ἀνιᾶται|ἀνιήσει|ἀνιηθεὶς|ἀνιήσεις
φαληριάω|φαληριόωντα
διακλάω|διακλάσσας
αἰτιάομαι|ᾐτιόωντο|αἰτιόῳο|αἰτιόωνται|αἰτιάασθαι|ᾐτιάασθε|αἰτιόῳτο
περαιόω|περαιωθέντες
γαμέω|γήμας|γῆμ̓|γήμασθαι|γαμέειν|γήμαιθ̓|γήμασθ̓|ἔγημε|γῆμαι|γῆμεν|γαμέω|γαμέεσθαι|ἔγημεν|γαμέοντί|γημαμένη|γήμαντα
ἀπορραίω|ἀπορραῖσαι|ἀπορραίσει
στρεφεδινέω|στρεφεδίνηθεν
ἐρέικω|ἐρεικόμενος
μήδομαι|μήδετο|ἐμήσατ̓|μήδεαι|μήδετ̓|μήδονθ̓|ἐμήσατο|μήδεται|μήσεαι|μήσατο|μήσατ̓|μήσαο|μήδεο|μηδοίμην
μονόω|μονωθεὶς|μούνωσε|μουνωθέντα
βίβημι|βιβάντα|βιβάς
ἠμύω|ἤμυσε|ἠμύσειε|ἠμύει
ἐπικέλομαι|ἐπεκέκλετ̓
εἴκω|εἴξῃ|εἴξωσι|εἴξασκε|εἴξειαν|εἶκε|εἶξαί|εἴξατέ|εἶξαν|εἴξαντος|εἴκουσι|εἴκων|εἴξας|εἶξε|εἴξειε|εἴκοι|εἴξασα|εἴξαντες
ἐξοφέλλω|ἐξώφελλεν
μεταστρέφω|μεταστρεφθέντι|μεταστρέψωσιν|μεταστρέψειε|μεταστρέψῃ|μεταστρεφθέντα|μεταστρεφθεὶς|μεταστρεφθέντε|μεταστρεφθείς|μεταστρέψεις
ἐξερύω|ἐξέρυσε|ἐξείρυσε|ἐξέρυσεν|ἐξέρυσαν|ἐξερύσασκε|ἐξέρυσ̓|ἐξείρυσσαν|ἐξερύοι|ἐξερύσας|ἐξερύσαι
παλύνω|πάλυνε|πάλυνεν|ἐπάλυνεν|παλύνας|πάλυνον|παλύνειν
ἀνιχνεύω|ἀνιχνεύων
ἐπεῖδον|ἐπιδόντα
νηέω|νήει|νήησαν|νηήσασθαι|νηῆσαι|νηήσας|νηησάσθω|νήεον
κυρέω|κύρεται|κῦρε|κύρσας
ἐξαπαφίσκω|ἐξαπάφω|ἐξήπαφε|ἐξαπάφοιτο|ἐξαπάφοιτ̓
ἐπανίστημι|ἐπανέστησαν
καταβλώσκω|καταβλώσκοντα
καθίστημι|καθίστα|κατάστησον|καταστῆσαι
ἐπιόσσομαι|ἐπιοσσομένω
ἀμελέω|ἀμέλησεν|ἀμέλησε
ἐλελίζω|ἐλελιξάμενος|ἐλελίχθη|ἐλέλικτο|ἐλελιχθέντες|ἐλελίχθησαν|ἐλέλιξεν|ἐλέλιξε|ἐλέλιχθεν
ἄντομαι|ἄντεσθ̓|ἤντετο|ἤντετ̓|ἀντόμεναι|ἀντομένη
διανύω|διήνυσεν
ἐπίσταμαι|ἐπιστάμεθα|ἐπισταμένῳ|ἐπιστήσονται|ἐπιστάμενοι|ἐπίσταμαι|ἐπιστάμεναι|ἐπισταμένου|ἐπίσταιτο|ἐπίστηται|ἐπισταμένοισι|ἐπισταίμεσθα|ἐπίστασθαι|ἐπιστάμενος|ἐπίστατο
διακρίνω|διακρινθῆτε|διακρίνῃ|διακρίνειε|διακρινέεσθαι|διακρινθέντε|διακεκριμέναι|διακρίνωσιν|διέκρινεν|διέκριθεν|διακρινθεῖτε|διακρινθέντας|διέκριναν|διακρινθήμεναι|διακρινέει
οἰκέω|οἰκέοιτο|ᾤκηθεν|οἰκέομεν|οἴκεον|ᾤκεον|ᾤκει
ποντοπορεύω|ποντοπορευέμεναι|ποντοπορεύων
ἐκπίνω|ἔκπιον|ἐκπέποται|ἔκπιεν
μύω|μέμυκεν|μύσαν
καταδέομαι|κατέδησεν
ἵστημι|στάντες|ἑσταότων|ἕστηκεν|ἑστεῶτ̓|στῆμεν|ἕσταμεν|στήσασα|στήσεσθ̓|στήσειν|στέωμεν|ἱστάμεναι|στῆτ̓|ἵστανται|στῆ|ἵστασο|στῆσε|ἵσταμαι|στησάμενοι|ἱστάμενος|στησαμένῃ|ἱσταμένῳ|στάσκεν|ἑσταότες|στήῃς|στήμεναι|ἑσταότας|ἕστηκ̓|ἱσταμένοιο|ἔστησαν|ἑστήκει|ἑστᾶσιν|ἔστην|στάντων|στῆθι|στάσκε|ἔστητε|ἵστασθ̓|ἕστατε|στᾶσ̓|στήσωσ̓|στήσας|στήσεσθαι|ἵστασ̓|ἕστασαν|ἑσταότα|ἐστάθη|ἑσταότος|στήτην|στησαμένη|ἕστατον|ἕστηκας|στήῃ|στήσαμεν|ἕσταθ̓|ἵσταται|ἱστᾶσιν|στῆν|στῆσαν|στῆσεν|ἑστάμεναι|ἑστήκῃ|στῆναι|ἵστασχ̓|στῆσαι|ἑστήκειν|ἑστεῶτες|στὰν|ἑστᾶσ̓|στὰς|ἵστατο|στήσομαι|ἕστηχ̓|ἑσταότ̓|στήομεν|στήσαντο|ἔστης|ἵσταντ̓|ἵστασαν|ἵστατ̓|ἔστη|σταίη|ἔστησε|ἑστάμεν|στήσαντες|ἱσταμένη|ἱστάμενοι|ἑστᾶσι|ἵσταντο|στήσασθαι|στᾶσα|ἑσταόθ̓|στάς|στησόμεθ̓|ἵστασθαι|στήσαντ̓|ἔστησεν|στῆτέ|ἵσταο|στῆσα|ἔσταν|στῆσον|στῆθ̓|ἕστηκε|ἵστη|σταίησαν|ἑστήκασιν|στάντε
μάρναμαι|μάρναται|μαρνάμενον|μαρναμένοισιν|μάρναθ̓|μάρνασθαι|ἐμάρναο|μαρναμένοιο|μάρνατο|μάρναο|μαρνάμενος|μάρναντο|μαρνάμεθ̓|μάρνασθ̓|μαρναμένοιιν|ἐμάρνατο|μάρναό|ἐμαρνάσθην|μαρναμένοιϊν|μαρνάμενοι|μαρναμένων|μαρναμένοισι|ἐμαρνάμεθ̓|μαρναίμεθα|μαρναμένους
παρεξέρχομαι|παρεξελθεῖν|παρεξελθοῦσα
λιάζομαι|λίασθεν|λιάσθης|λιασθεὶς|λιασθείς|λιάζετο|λιάσθη|ἐλιάσθη|λιαζόμενον
ἐκρήγνυμι|ἐξέρρηξε|ἐξέρρηξεν
πλίσσομαι|πλίσσοντο
δικάζω|δικαζέτω|δίκαζον|δικαζέμεν|δικάσσατε|δικαζόμενος|δικαζομένων|δίκασαν|δικάσω
κίδναμαι|ἐκίδνατο|κίδναται
ἐπιδέω|ἐπέδησε|ἐπιδεύομαι|ἐπιδεύεαι
ἀλγέω|ἀλγήσας|ἀλγήσετε
ἐπελαύνω|ἐπέλασσε|ἐπέλασσέ|ἐπελήλατο|ἐπέλασσεν|ἐπέλασσαν|ἐπέλασσα
διαρρίπτω|διαρρίπτασκεν
ἔνειμι|ἐνείη|ἐνῆεν|ἔνεστι|ἔνειμεν|ἐνέην
καπύω|ἐκάπυσσε
νίφω|νιφέμεν
τετίημαι|τετιημένη|τετιηότι|τετιηότες|τετίησθον|τετιημέναι|τετιημένος
τραπέω|τραπέουσι
περιέχω|περισχόμεθ̓|περίσχεο
προιάλλω|προΐαλλε|προΐαλλεν
κλαίω|κλαύσομαι|κλαίοντες|κλαῖε|κλαίετον|κλαίουσα|κλαύσας|κλαίεις|κλαίῃσι|κλαίων|κλαίοντέ|ἔκλαιον|κλαῖον|κλαιούσης|κλαίω|κλαίωμεν|κλαίοντα|κλαίοντε|κλαίοισθα|κλαίοντας|κλαίῃ|κλαῖ̓|κλαύσονται|κλαίειν|κλαίεσκε|κλαίουσ̓|κλαιόντεσσι|κλαῦσεν|κλαῦσε|κλαῖεν|κλαίομεν
προσερεύγομαι|προσερεύγεται
νοέω|ἐνόησεν|νοήσεις|νοῆσαι|νοήσει|νόησα|νόησε|ἐνόησε|ἐνόησαν|νόησεν|νοῆσαί|νοήσω|νοήσῃ|νοήσατο|ἐνόησα|νόει|ἐνόησ̓|νοεούσῃ|νοέω|νοήσῃς|νοέεις|νόησον|νοέοντι|νοήσας|ἐνόησας
προποδίζω|προποδίζων
ῥιπτάζω|ῥιπτάζων
μεταίσσω|μεταΐξας|μεταΐσσων
αἰνίζω|αἰνίζομ̓
ἀποφέρω|ἀπένεικας|ἀποίσετον|ἀπένεικαν|ἀποίσειν
ἐξαποτίνω|ἐξαποτίνοις
κατερείπω|κατερήριπεν|κατήριπε
ὑποζεύγνυμι|ὑποζεύξω
ἐξεναρίζω|ἐξεναρίξων|ἐξενάριζεν|ἐξενάριξα|ἐξεναρίξας|ἐξεναρίζεις|ἐξεναρίζων|ἐξενάριξαν|ἐξεναρίξῃς|ἐξενάριξε|ἐξενάριξεν|ἐξεναρίξαι|ἐξενάριξας|ἐξεναρίξει
εὐφημέω|εὐφημῆσαί
κεραίω|κέραιε
ἐπαλέξω|ἐπαλεξήσων|ἐπαλεξήσουσαν
μυκάομαι|μεμυκὼς|μύκε|μεμύκει|μυκώμεναι|μύκον
ἀλλοφρονέω|ἀλλοφρονέοντα|ἀλλοφρονέων
πάλλω|πάλλεν|πάλτο|πάλλειν|πῆλαι|πάλλε|πάλλον|πάλλομεν|πάλλεται|παλλόμενος|πάλλων|πῆλέ|πάλλ̓|πῆλ̓|παλλομένη|παλλομένων
κλέω|κλέομαι|ἔκλἐ
ἀρτύνω|ἀρτύναντε|ἀρτύνθη|ἤρτυνον|ἀρτύναντες|ἀρτύνοντας|ἠρτύναντο|ἀρτύνετο|ἀρτυνέουσιν
νηπιαχεύω|νηπιαχεύων
κατεφάλλομαι|κατεπάλμενος
ἐγκατατίθεμαι|ἐγκάτθεο|ἐγκάτθετο
συνδέω|ξυνέδησεν|ξυνδῆσαι|συνέδησα
ἀνάπτω|ἀνῆπτον|ἀνῆψεν|ἀνήφθω|ἀνάψαι
κροαίνω|κροαίνων
ἀνεγείρω|ἀνέγειρεν|ἀνεγείρεις|ἀνέγειρε|ἀνέγειρα|ἀνεγεῖραι
προρέω|προρέουσι|προρέοντος|προρέει|προρέειν|προρέοντα|προρέοντι
ἐπαπειλέω|ἐπαπειλήσας|ἐπηπείλησ̓|ἐπηπείλησε|ἐπηπείλησεν
πάρειμι|παρέσσομαι|παρῆσθα|πάῤ|πάρεστιν|παριὼν|παρέσται|παρεὼν|παρεόντος|παρεόντ̓|παρεόντι|παρεῖναι|παρεόντων|πάρεσαν|παρέμμεναι|παριών|παρέασι|παρεόντε|παρείη|πάρεστέ|παρέσσεται|παρῆεν|παρεόντα|πάρεστι
σημαίνω|σήμαινε|σήμαιν̓|σημανέω|σημαίνων|σημαίνουσιν|σημαινέτω|σημαίνει|σημαίνειν|ἐσημήναντο|σήμηνε
προτρέπω|προτραπέσθαι|προτρέποντο|προτράπηται|προτραποίμην
ἐκθρῴσκω|ἐκθρῴσκει|ἐξέθορε|ἔκθορε
ῥέζω|ἐρέξαμεν|ῥέξαιμι|ἔρεξα|ῥέξ̓|ῥέξαντα|ῥέξειν|ῥέζον|ῥέξωσι|ῥέξῃ|ἔρεξας|ῥέζουσ̓|ῥέζειν|ῥέζετε|ῥέξαντας|ἔρεξε|ἔρρεξεν|ῥεχθέντος|ῥέζω|ἔρρεξε|ῥέξομεν|ῥεχθὲν|ῥέζων|ῥέξει|ῥέξω|ῥέξας|ῥέξαντι|ἔρεξαν|ῥέζουσι|ῥέξαντες|ῥέζεις|ῥέζεσκον|ῥέζοι|ἔρεζον|ῥέξῃς|ῥέζε|ῥέξειε|ῥέξαι|ἔρεξ̓|ἔρεζε|ῥέζουσαν|ῥέζει|ῥέζουσιν|ἔρεξεν
ἴσκω|ἴσκουσ̓|ἴσκοντες
ἀμενηνόω|ἀμενήνωσεν
γελάω|γελόωντες|γέλασσε|γελοίωντες|γελάσας|γελώοντες|ἐγέλασσαν|γελόω|γελάσσας|γέλασσαν|ἐγέλασσε|γελάσασα|γέλασαν|γελάσαι|γελοίων|ἐγέλασσεν
κατακαίω|κατέκηε|κατακῆαι|κατακήομεν|κακκῆαι|κατέκαιον|κατακαιέμεν
κακόω|κάκου|κακῶσαι|κεκακωμένον|κακοῖς|κεκακωμένος|κεκακωμένοι|ἐκάκωσε|ἐκακώσατε
ὑποδείδω|ὑποδείδἰ|ὑποδείσασα|ὑποδείσαντες|ὑποδείσας|ὑποδείσατε|ὑπέδεισαν|ὑπεδείδισαν
τοξεύω|τοξεύειν
θυμηγερέων|θυμηγερέων
φυτεύω|φυτεύει|φυτεύουσιν|ἐφύτευσαν|φύτευεν|φυτεύων|φυτεύσω|φυτεῦσαι
μετάφημι|μετέφη
νομεύω|νομεύων|ἐνόμευε
ῥοχθέω|ῥόχθει|ῥοχθεῖ
ἐπιπρέπω|ἐπιπρέπει
στένω|στένει|ἔστενε|ἔστενεν
συγκαλέω|συγκαλέσας
κατακλίνω|κατακλίνας
διόλλυμι|διόλωλε
ἐνθρῴσκω|ἔνθορεν
κεύθω|ἐκεκεύθει|κεκύθωσι|κεύθει|κεύθετε|κεύθωμαι|ἔκευθεν|κεύσω|κέκευθε|κεύθῃ|κεῦθε|κεύθω|κεῦθεν|κύθε
λέπω|ἔλεψε
ὑπείκω|ὑποείξω|ὑποείξομεν|ὑπόειξε|ὑποείκειν|ὑπόεικε|ὑποείξομαι|ὑπόειξεν|ὑπείξεαι|ὑπόεικον|ὑπείξομαι
πίμπρημι|πρῆσαι|πρήσαντες
κτάομαι|ἐκτήσατο|ἐκτήσω|κτάμενον
ἐξαφύω|ἐξαφύοντες
ἀθλέω|ἀθλήσαντε|ἀθλήσαντα
λιπάω|λιπεῖν|λιποῦσα|λίποιμεν
ὑπάρχω|ὑπάρξῃ
μέμονα|μέμονέν|μέμονάς|μέμονε|μέμονας|μέμον̓|μέμονεν
ἀρήγω|ἀρήγων|ἀρήγει|ἀρῆξαι|ἀρήγεις|ἀρήξειν|ἀρήγειν|ἀρηγέμεν|ἀρήγεθ̓|ἀρηξέμεν|ἀρήγῃ
δέω|δήσας|δέοιμι|ἐδεύετο|δευομένους|δέδετο|δέδεντο|δῆσεν|δησάντων|δέον|δῆσε|ἔδησε|δέοντο|ἐδήσατο|δησάσκετο|δησάμενοι|δήσαντες|δησαίμην|ἔδησαν|δησάμενος|δήσατ̓|δέδετ̓|δευόμενος|ἔδησεν|δεύῃ|δῆσαι|δῆσα|δῆσαν|δήσειν
παριαύω|παριαύων
ὀκριάομαι|ὀκριόωντο
εἰσβαίνω|εἴσβαινον|ἐσβαίη|ἐσβάντες
κόπτω|ἔκοψα|κόπτοντες|κόψατο|κεκοπὼς|κόπτον|κόπτ̓|κόψ̓|κόπτων|κόπτε|κεκόπων|κόψας|κόψεν|κόψε
τεκμαίρομαι|τεκμαίρομαι|τεκμήραντο|τεκμήρατο|τεκμαίρομ̓|τεκμαίρεται
εἰσδύνω|ἐσδύσεαι
ὑπομιμνήσκω|ὑπέμνησέν|ὑπομνήσουσα
ὄρνυμι|ὄρμενον|ὄρσουσα|ὤρορεν|ὄρνυθ̓|ὄρνυτε|ὄρσητε|ὄρηται|ὤρνυντο|ὠρώρει|ὤρνυθ̓|ὄρσασ̓|ὦρσαν|ὀρνυμένη|ὄρσο|ὄρνυσθ̓|ὄρσεο|ὄρσευ|ὦρτ̓|ὀρνυμένου|ὀρνυμένοιο|ὀρνυμένων|ὀρμένω|ὀρνύμενον|ὀρώρηται|ὄρνυον|ὀρνύμεν|ὤροῤ|ὀρεῖται|ὀρώρει|ὄρσομεν|ὄρθαι|ὤρνυτ̓|ὀρώρεται|ὦρσεν|ὄρμενα|ὄρσ̓|ὄρωρεν|ὤρορε|ὄρσασκεν|ὄρνυσθε|ὄρσας|ὄρσε|ὄρσωμεν|ὦρσε|ὄρνυτο|ὀρέοντο|ὀρώρῃ|ὤρνυε|ὦρτο|ὄρωρε|ὄρνυται|ὤρετο|ὄρνυντο|ὀρνύμεναι|ὄρνυθι|ὄρνυτ̓|ὄρσῃ
βαμβαίνω|βαμβαίνων
τορέω|ἔτορε
ἐπαρκέω|ἐπήρκεσεν|ἐπήρκεσε
ἀπάλαλκε|ἀπαλάλκοι|ἀπάλαλκε
κυδιάω|κυδιόωντες|κυδιόων
προσκλίνω|ποτικέκλιται|προσέκλινε
μέλπω|ἐμέλπετο|μέλποντες|μέλπεσθαι|μελπομένῃσιν
ἔγρω|ἔγρεσθαι
καπνίζω|κάπνισσάν
κικλήσκω|κικλήσκειν|κικλήσκουσιν|κικλήσκοντος|κικλήσκων|κικλήσκεις|κικλήσκεται|κικλήσκετο|κικλήσκουσ̓|κικλήσκει|κίκλησκεν|κίκλησκον|κικλήσκουσι
φυσιάω|φυσιόωντας
παραφεύγω|παρφυγέειν
θεειόω|θεειώσω|θεειοῦται
κατακείρω|κατακείρετε|κατεκείρετε|κατέκειραν
ὑπεκφέρω|ὑπεξέφερεν|ὑπεξέφερον|ὑπέκφερον
πρόσειμι|προσιόντι|προσιόντα
κηρύσσω|κηρύσσοντες|κηρύσσων|κηρύσσειν|ἐκήρυσσον
ἐθέλω|ἐθελήσετον|ἐθέλῃσ̓|ἐθέλῃς|ἐθέλεσκον|ἐθέλουσα|ἐθέλοντά|ἤθελεν|ἐθέλοντα|ἔθελεν|ἔθελ̓|ἐθέλεις|ἐθελήσεις|ἐθέλητε|ἐθέλοιμεν|ἐθέλουσ̓|ἤθελε|ἐθέλωμι|ἐθελούσης|ἐθέλωσι|ἐθέλοις|ἐθέλῃσθα|ἐθέλοντας|ἐθέλουσαν|ἐθέλησε|ἔθελον|ἔθελόν|ἐθέλει|ἠθελέτην|ἐθέλεσκε|ἠθέλετον|ἐθελήσω|ἐθέλοντ̓|ἐθέλοι|ἐθελούσῃ|ἐθέλοιεν|ἔθελε|ἐθέλουσι|ἐθέλῃσιν|ἐθέλητον|ἐθέλων|ἐθέλουσιν|ἐθέλεσκες|ἤθελ̓|ἐθέλοιτέ|ἐθέλῃσι|ἐθελήσει|ἐθέλωσ̓|ἐθέλω|ἐθέλοντες|ἐθέλουσά|ἐθέλωσιν|ἐθέλοιμι|ἤθελον|ἐθέλῃ|ἐθέλησα
καταπύθω|καταπύθεται
πρόκειμαι|προκείμενα
διαρραίω|διαρραίσει|διαρραίουσι|διαρραῖσαι|διαρραίσουσι|διαρραίσεσθαι
καθάλλομαι|καθαλλομένη
γουνόομαι|γουνούμενος|γουνοῦσθαι|γουνούμενοι|γουνοῦμαι|γουνοῦμαί|γουνούμην
εἰσερύω|εἰσερύσαντες
ἀποθρώσκω|ἀποθρῴσκοντα
εἰσφέρω|ἐσφέρεται|ἔσφερον
εὕω|εὗσαν|εὗσεν|εὕοντας|εὑόμενοι|εὗσέ
παραμυθέομαι|παραμυθήσασθαι|παραμυθησαίμην
ἀναγιγνώσκω|ἀνέγνω|ἀνέγνων|ἀναγνοίη|ἀναγνούσῃ|ἀναγνόντος
διικνέομαι|διίξομαι|διίκεο
καταβάλλω|κάββαλ̓|κατέβαλλε|κάββαλεν|κάββαλε
τειχίζω|ἐτειχίσσαντο
ἀκοντίζω|ἀκόντισεν|ἠκόντισαν|ἀκοντίσσαντος|ἀκόντισε|ἀκόντισαν|ἀκοντίσαι|ἀκοντίσατ̓|ἀκοντίζουσι|ἀκόντιζον|ἀκοντίζω|ἀκοντίσσαι
κιθαρίζω|κιθάριζε
ἵζω|ἵζ̓|ἵζεσκεν|ἵζοντο|εἷσέ|ἕσας|ἕσσας|ἷζον|ἷζε|εἷσ̓|εἷσεν|ἱζόντων|εἷσε|ἵζει|ἕσσα|ἕσσον|εἷσαν|ἷζεν|ἵζεσκε|ἵξετ̓|ἕσασα|ἕσσε|ἵζοιτο|ἵζευ|εἷσον|ἵζοντ̓|ἵζε
σείω|ἐσσείοντο|σείσατο|σείοντ̓|σείετο|σειόμενον|σειόμεν̓|σεῖον|σεῖσ̓|σείων
ἐκδέρκομαι|ἐκδέρκεται
διαμοιράω|διεμοιρᾶτο
προσπίλναμαι|προσεπίλνατο
ἀμπέχω|ἄμπεχεν
χραισμέω|χραῖσμ̓|χραίσμῃ|χραίσμωσιν|ἔχραισμε|χραίσμησεν|χραισμήσει|χραίσμῃσι|χραισμεῖν|χραισμησέμεν|χραισμῆσαι|χραῖσμε
ἀντιάζω|ἀντιάσητον|ἀντιάσειας|ἀντιάσειε|ἀντιόω|ἀντιάσαιμεν|ἀντιόωσα|ἀντιάσαντι|ἀντιάσαντα
γείνομαι|γείνατ̓|γείνεαι|γείνασθαι|ἐγείνατο|ἐγείναο|γεινομένῳ|γεινόμεθ̓|γείνατο
ῥυπάω|ῥυπόωντα|ῥυπόω
καταβαίνω|κατέβην|καταβῆναι|καταβὰς|καταβήσεται|κατάβηθι|κατεβήσετο|καταβάς|καταβήομεν|καταβήμεναι|κατεβαίνομεν|κατέβαιν̓|κατέβαν|κατέβησαν|καταβήσεο|καταβᾶσα
παραδράω|παραδρώωσι
κροτέω|κροτέοντες
ἐποπτάω|ἐπώπτων
ὑπίσχομαι|ὑπισχόμεναι|ὑπίσχεο
ἐπιτοξάζομαι|ἐπετοξάζοντο
ὑποτρέχω|ὑπέδραμε
πτοέω|ἐπτοίηθεν
ἔθω|ἔθοντες|εἰωθότες|εἴωθε|ἔωθεν|εἰωθὼς|εἰωθότι|ἔθων
τρομέω|ἐτρόμεον|τρομέει|τρομέεσθαι|τρομέοντο|τρομέουσι|τρομέεις|τρομεοίατο
ἀποπίπτω|ἀπέπιπτον|ἀποπέσῃσιν
αἰδέομαι|αἰδέσσομαι|αἰδομένη|αἴδεσσαι|αἰδομένων|αἰδεῖται|αἰδόμενος|αἴδετο|αἴδεσθεν|αἰδεσθείς|αἰδέσσεται|αἰδεῖο|αἰδομένω|αἰδεῖσθαί|αἰδεσθεὶς|αἰδέομαι|αἰδέσεται|ᾐδέσατ̓|αἰδεῖσθε|αἴδεο
καγχαλάω|καγχαλόων|καγχαλόωσα|καγχαλόωσι
ἀμφιζάνω|ἀμφίζανε
καταπαύω|κατέπαυσα|καταπαυέμεν|καταπαύσῃ|καταπαύετε|καταπαύσομεν|καταπαυσέμεν|κατέπαυσε
αἴνυμαι|αἰνυμένους|αἴνυτ̓|ᾔνυτο|αἰνυμένῳ|αἰνύμενοι|αἰνύμενος|αἰνύμεναι|αἴνυτο|αἴνυται
πεσσεύω|ἐπεσσεύοντο|ἐπέσσευεν
ἐνθρώσκω|ἔνθορε|ἔνθοῤ
ἀσκέω|ἤσκηται|ἀσκήσασα|ἤσκησαν|ἤσκησεν|ἤσκειν|ἀσκήσας
ξέω|ἔξεσε|ξέσσε|ξέσσεν|ἔξεον
ἴπτομαι|ἴψεται|ἴψαο
μεταπαύομαι|μεταπαυόμενοι
ἐργαθεῖν|ἐέργαθεν|ἔργαθεν
τείρω|τειρόμενον|τειρομένοιο|τείρεσθαι|τειρόμενος|τειρόμενοι|ἔτειρεν|τείροντο|ἔτειρε|τείρουσι|τείρει|τείρετο|τειρόμενός|τείρεσθ̓|τειρόμενοί|τείρουσ̓|ἐτείρετο|τείροντ̓|τεῖρε|τειρομένοις|τειρομένους|τείρεθ̓
ἐκπεράω|ἐκπεράᾳ|ἐξεπέρησε|ἐκπερόωσιν|ἐξεπέρησεν
ἀποσφάλλω|ἀποσφήλειε|ἀποσφήλωσιν
ἐνδέω|ἐνέδησε|ἐνέδησα|ἐνέδησεν
ἀπορούω|ἀπόρουσε|ἀπόρουσεν
ἐπίσχω|ἐπίσχετε|ἐπίσχειν|ἐπισχόμενος
ἀναπάλλω|ἀμπεπαλὼν|ἀναπάλλεται|ἀνεπᾶλτο|ἀνέπαλτο|ἀνέπαλτ̓
πείρω|πεῖρε|πείρων|πεπαρμένη|πεῖράν|ἔπειρε|πειρώμεσθα|ἔπειρεν|ἔπειρον|πεῖρεν|ἔπειραν|πεπαρμένον|πεπαρμένος|πείροντες
κλύζω|κλύζεσκον|ἐκλύσθη
ἐπιλείβω|ἐπέλειβον
ἀκηδέω|ἀκήδεσεν|ἀκήδεις
θεμιστεύω|θεμιστεύει|θεμιστεύοντα
μάσσω|μάσασθαι
κατάνομαι|κατάνεται
ὑποκρύπτω|ὑπεκρύφθη
ἐπαιγίζω|ἐπαιγίζοντα|ἐπαιγίζων
περιδίδομαι|περιδώσομαι|περιδώμεθον
ἐπιλάμπω|ἐπέλαμψε
ἀναπαύω|ἀνέπαυσεν
ψευστέω|ψευστήσεις
ὀχλίζω|ὀχλίσσειαν
ἀμφιλαχαίνω|ἀμφελάχαινε
ἐπιμειδάω|ἐπιμειδήσας
ἀποκείρω|ἀπεκείρατο
ἀκουάζομαι|ἀκουάζωνται|ἀκουάζεσθον|ἀκουάζεσθε
ἐντίθημι|ἔνθετο|ἐνθεμένη|ἔνθεο|ἐνθήσω|ἐνθέμεναι|ἐντιθέμεσθα
δείκνυμι|δεξαμένῳ|δείξω|δεῖξον|ἔδειξε|δεῖξαι|δεικνὺς|δείξειας|δείξειε|δεικνύμενος|δεῖξε|δεῖξεν|ἔδειξεν|δεῖξ̓
νεύω|ἔνευεν|νεῦσε|νευόντων|νεῦσ̓|νεύσω|νεῦον|νεύοντα|νεύοιεν|νεῦσεν
ἀνατέλλω|ἀνέτειλε
εἰσανεῖδον|εἰσανιδών
διατρέω|διέτρεσαν
ἀμφιδαίω|ἀμφιδέδηε
ἀναθρῴσκω|ἀναθρῴσκων
τῆ|τῆ
κατηφέω|κατηφήσας|κατήφησάν
κτέομαι|ἐκτῆσθαι|κτήσατο
περιφράζομαι|περιφραζώμεθα
θαλέθω|θαλέθων|θαλέθοντες
ἀνακράζω|ἀνέκραγον
ἰχθυάω|ἰχθυάᾳ|ἰχθυάασκον
λάω|λάε|λάων|λῆθ̓
ζάω|ζῶντος|ζώοντ̓
ἁρμόζω|ἥρμοσεν|ἁρμόζεο|ἥρμοσε
ἐπιτρέπω|ἐπετράπομέν|ἐπέτρεπεν|ἐπιτρέψαι|ἐπιτέτραπται|ἐπέτρεψεν|ἐπιτραπέουσι|ἐπιτράπεθ̓|ἐπέτρεπε|ἐπέτρεψας|ἐπιτρέψειας|ἐπετράπετο|ἐπίτρεψον|ἐπιτρέψειεν|ἐπιτετράφαται
πταίρω|ἔπταρεν
ἀφοπλίζω|ἀφωπλίζοντο
θεάομαι|θηήσαιτο|θηήσατο|θηήσαντο|θηοῖό|θηήσαντ̓|θηήσαιο|θηεῦντό|ἐθηήσαντο|ἐθηεύμεσθα|θηεῦντο|θηήσαο|θηεῖτο
μετακλαίω|μετακλαύσεσθαι
καθεψιάομαι|καθεψιόωνται
ἀλιταίνω|ἤλιτεν|ἀλιτέσθαι|ἀλίτωμαι|ἀλιτήμενός|ἀλίτοντο|ἀλίτηται
ἀυτέω|ἀΰτευν|ἀΰτει
χυτλόω|χυτλώσαιτο
εἰσελαύνω|εἰσελάων|εἰσελάσαντες|εἰσέλασαν
περιτρέφομαι|περιτρέφετο|περιτρέφεται
ἀπονοστέω|ἀπονοστήσειν
μωμάομαι|μωμήσονται
ὀπάζω|ὄπαζε|ὀπάσσω|ὄπασσε|ὀπάσαιμι|ὀπάσσαι|ὀπάζων|ὀπάσσομεν|ὄπαζεν|ὄπασσα|ὀπάσσεαι|ὄπασσον|ὀπάσσας|ὀπασσάμενος|ὤπασαν|ὤπασε|ὄπασσεν|ὀπάσειαν|ὤπαζον|ὀπάζει|ὤπασα|ὀπαζόμενος|ὀπάσσει|ὤπαζε|ὀπάσσατο|ὀπάζειν
ἐντρέχω|ἐντρέχοι
κατάρχω|κατήρχετο
φθείρω|φθείρουσι|φθείρεσθ̓
συμφέρω|συνοισόμεθα|συμφερόμεσθα
παρατροπέω|παρατροπέων
τρωπάω|τρωπάσκετο|τρωπῶσα|τρωπῶντο|τρωπᾶσθε|τρωπᾶσθαι
ἀμφαγαπάζω|ἀμφαγαπαζόμενος|ἀμφαγάπαζον
κρατύνω|ἐκαρτύναντο
κορέννυμι|κεκόρησθε|κορέσωνται|κορεσσάμεθα|κορέσσατο|κορεσσάμενος|ἐκορέσσατο|κορέει|ἐκορέσθην|κορέσειεν|κορέεις|κεκορηότε|κεκορήμεθ̓|κορέσθην|κεκορήμεθα|κορέσασθαι|κορεσαίατο|κεκορημένοι
μελάνω|μελάνει
ἀνάσσω|ἀνάσσοις|ἀνάσσεις|ἀνασσέμεν|ἀνάσσω|ἄνασσεν|ἀνάσσοντ̓|ἀνάσσοι|ἀνάσσει|ἀνάσσειν|ἀνάξασθαι|ἀνάξει|ἀνάξειν|ἀνάξομεν|ἀνάσσονται|ἄνασσε|ἄνασσες|ἀνάσσων|ἤνασσε
ἐπιβάσκω|ἐπιβασκέμεν
ἐπαγάλλομαι|ἐπαγαλλόμενος
ἀλοάω|ἀλοία
ὑποδύομαι|ὑποδύσεαι|ὑπέδυ|ὑποδῦσα|ὑποδύντε|ὑπεδύσετο
μογέω|ἐμόγησαν|μόγησα|μογέοντες|μογήσας|μόγησας|μογέων|ἐμόγησε|ἐμόγησεν|μογήσῃ|ἐμόγησα|μόγησαν
τεχνάομαι|τεχνήσομαι|τεχνήσαιτο|τεχνήσατο|τεχνησάμενος
δυάω|δυόωσι
οὔλω|οὖλέ
ἀπολείπω|ἀπέλειπεν|ἀπολείπει|ἀπολείπουσιν
ζωγρέω|ζωγρεῖτ̓|ζώγρει
μετέρχομαι|μετέλθοι|μετέρχεται|μετέρχεο|μέτελθε|μετελεύσομαι|μετελθὼν|μετελθών|μετερχόμενος|μετέρχομαι
ἐκχέω|ἔκχεον|ἐκχεύατ̓|ἐκχύμενοι|ἐκχυμένοιο|ἔκχυτο|ἐξέχυθ̓|ἐξεκέχυντο|ἐξεχέοντο
πίμπλημι|πλῆτο|πιμπλᾶσι|πλησαίατο|πλήσειαν|πλῆσεν|πλῆσε|πλῆθεν|πλησάμενος|πλησάμενοι|πλήσασα|πλῆσθεν|πλῆντο|ἐπλήσθη|πίμπλαντ̓|πίμπλαντο|ἔπληντ̓|πλῆσαν
ὑπολύω|ὑπέλυντο|ὑπέλυσε|ὑπέλυσα|ὑπελύσαο
μένω|μένετε|μεῖνα|μενόντων|μενέω|μέν̓|μεῖναί|μένοντι|μένῃ|μένῃσι|μενέουσι|μένομέν|ἔμεν̓|μένω|μεῖναι|μένωμεν|μένειν|μενέεις|μένον|μένουσ̓|μείνατ̓|μένετ̓|μεῖνε|μεῖν̓|μένεν|μένοιεν|μενέμεν|μείναμεν|μένοντε|μείνειας|ἔμεινας|μένε|μένομεν|μενέτω|ἔμειναν|μείνῃ|μενέτην|μένοις|μενέουσ̓|μένων|ἔμεινα|ἔμενον|μένουσιν|μενέειν|μένοντες|μένουσι|ἐμείναμεν|μένεσκον|μένοντα|ἔμεινε|μένει|μενέουσιν
ἐμπολάω|ἐμπολόωντο
διέρχομαι|διερχόμενος|διῆλθε|διέρχεται|διελεύσεσθαι|διέλθοιεν|διελθέμεν
ὠδίνω|ὠδίνων|ὠδίνουσαν
ἑδριάω|ἑδριάασθαι|ἑδριόωντο
διάημι|διάη|διάει
ἀτέμβω|ἀτέμβονται|ἀτέμβειν|ἀτεμβόμενος|ἀτέμβει|ἀτεμβόμενός
νοσφίζομαι|νοσφιζοίμεθα|νοσφίσατ̓|νοσφίζεαι|νοσφισσαμένη|νοσφισθείς|νοσφισάμην|νοσφισσαμένην
δύω|δῦνε|δῦτε|δῦθι|δύεται|δύσεαι|δύντε|ἐδύτην|δύῃ|δυσομένου|ἔδυ|δύνοντες|δέδυκεν|ἔδυσαν|δύοντο|ἔδυτε|δύτω|ἔδυνεν|δύσονται|ἔδυν|δύσαντο|δύσεο|δυέσθην|ἔδυνον|δύσω|δύνεις|δῦν̓|δύνει|δύμεναι|δύσεσθαι|δύσετο|δῦνεν|δῦσαι|δύσετό|δῦναι|δύσετ̓|δῦνον|ἔδυνε|δύσεθ̓|δύσκεν|δῦ|δύῃς|ἐδύσαντο|ἐδύσετο|δύντα|δύσομαι|δύων|δυσαίατ̓|δύοντα
ἐνίσσω|ἐνισσόμενος|ἐνισσέμεν|ἐνίσσομεν|ἐνίσσων
ἐρῶ|ἐρέουσιν|εἴρητο|ἐρέοντα|ῥηθέντι|ἐρέοιμεν|ἐρέουσα|ἔρειο|ἐρέοντε|ἐρέων|εἴρηθ̓|ἐρέουσ̓|ἐρέειν|ἐρέει|εἰρημένα|εἰρημένος|ἐρέοιμι|ἐρέω|εἰρήσεται
διαγλάφω|διαγλάψασ̓
τυγχάνω|τυχὼν|τύχῃσι|τετευχώς|τύχοις|τύχῃ|τετύχηκε|τύχωμι|τεύξεσθαι|τύγχανε|ἐτύχησεν|ἔτυχες|τύχῃς|τετυχηκώς|ἐτετεύχατο|τυχήσας|τύχε|τύχησε|τυχών|ἐτύχησε
ἐξερεείνω|ἐξερεείνετο|ἐξερέεινεν|ἐξερεείνοι|ἐξερέεινον|ἐξερέεινε|ἐξερεείνων
καταζαίνω|καταζήνασκε
ἀρθμέω|ἀρθμήσαντε
λίγγω|λίγξε
ἰσόω|ἰσωσαίμην
ἐπιψαύω|ἐπιψαύῃ
ὀφείλω|ὄφειλον|ὄφελον|ὄφελόν|ὤφελες|ὄφελ̓|ὀφείλετ̓|ὄφελεν|ὤφελεν|ὠφέλετ̓|ὄφελέν|ὄφελες
πράσσω|πρήσσεσκον|πρήσσει|πρήξεις|πρήσσοντε|πρῆξαι|πρήξει|πρήξαντα|πρήσσουσι|πρήσσωμεν|πρήσσῃσιν|πρήσσοντες|ἔπρηξας
ἐκθνήσκω|ἔκθανον
ἐκποτάομαι|ἐκποτέονται
ἐριδμαίνω|ἐριδμαίνωσιν
φημί|φημὶ|φησὶν|φήῃ|φάτο|φασι|ἔφαντο|φαμεν|φασὶν|ἔφησθα|φασ̓|ἔφης|φὰς|φάντες|ἔφην|φαίη|φῆ|ἔφατο|ἔφασαν|φησί|φάν|φησὶ|φησιν|φημ̓|πεφασμένον|φάμενος|φάθ̓|φασιν|φαῖμεν|ἔφη|ἐφάμην|φησι|φαίην|ἔφαθ̓|φατε|ἔφαντ̓|φαίης|φάσθω|φὰν|φημι|φαμένη|φῆς|φασὶ|φῇσιν|φάσ̓|ἔφατ̓|φάσθαι|ἔφαμεν|φάμεν|φῇσθα|φῆν|φάσθ̓|φῇ|φησ̓|φάσαν|φῂς|φάμενοι|φάο|φῆσθα|φάντο|φήσει|φατ̓|φὴ|φημί|φάτ̓|ἔφαν
φυλάσσω|φυλάσσετε|φυλάσσων|φυλάσσοντας|φυλάξεις|φυλασσέμεναι|φυλάσσειν|φυλάσσει|ἐφύλασσε|φυλάσσοιμεν|φυλάσσοις|φυλάσσεις|φυλάξων|πεφυλαγμένος|φυλασσομένοισι|φυλάσσονται|φύλαξεν|φυλασσέμεναί|ἐφύλασσεν|φύλασσε|φυλάξω|φυλάσσω
κωκύω|κώκυσ̓|κώκυσεν|ἐκώκυε|κώκυσέν|κωκύσασα|ἐκώκυον|κωκύει
οἰνόω|οἰνωθέντες
πέρνημι|περνὰς|πεπερημένος|περνάμεν̓|πέρνασχ̓
ἐνῆμαι|ἐνήμεθα
νεμέθω|νεμέθοντο
τελέθω|τελέθει|τελέθοντες|τελέθουσι|τελέθουσιν
ὀδύσσομαι|ὠδύσαο|ὀδύσαντο|ὠδύσατο|ὀδυσσαμένοιο|ὠδύσατ̓|ὀδυσσάμενος|ὀδώδυσται
φέβομαι|φέβωμαι|ἐφέβοντο|φέβεσθαι|φέβοντο|φεβώμεθα
φεύγω|φεύγοντας|φεύγειν|φεύγω|φύγωμεν|φύγῃσι|φύγε|πεφεύγοι|φυγόντε|φύγοι|φεύγοντι|φύγοιμεν|φεύγεις|πεφυγμένος|φευγέμεν|φεύγων|φεῦγε|φυγὼν|φύγον|φύγομεν|φύγῃσιν|φύγοιμι|φυγόντες|φυγέειν|φεύγοντες|φεῦγ̓|φεύγετε|πεφυγμένον|φεύξομαι|φύγῃ|φευγέμεναι|ἔφυγες|φεύξονται|φεύγοντα|φύγεν|φεύγει|φεύξεσθ̓|φυγεῖν|φεύγεσκεν|πεφυζότες|πεφευγότες|φυγόντα|ἔφευγε|φεύγωμεν|φεῦγον|φεύγοντ̓|φύγεσκε|φυγόντι|φευγόντων|φεύξεσθαι
ἐπιγράφω|ἐπιγράψας|ἐπέγραψε|ἐπέγραψεν|ἐπιγράψαι
διαφράζω|διεπέφραδε
συμμητιάομαι|συμμητιάασθαι
διαπράσσω|διαπρήσσουσα|διαπρήσσωσι|διαπρήξαιμι|διέπρησσον
ἀπονέω|ἀπονέωνται
ὀρέγνυμι|ὀρεγνύς
ζώννυμι|ζῶσαι|ζώννυσθαι|ζώννυνταί|ζωννύσκετο|ζώσατο|ζωσαμένω|ζώσαντες|ζώννυθ̓
ἀπομόργνυμι|ἀπομορξαμένω|ἀπομόρξατο|ἀπομόργνυ
κνυζόω|κνύζωσεν|κνυζώσω
ἐπαρτύω|ἐπήρτυε
μετατίθημι|μετέθηκε
ἐγγείνωνται|ἐγγείνωνται
ὀτρύνω|ὀτρύνεσθε|ὀτρύνουσιν|ὀτρύνῃσιν|ὄτρυν̓|ὀτρυνέει|ὀτρύνωμεν|ὀτρύνομεν|ὄτρυνε|ὀτρυνέουσα|ὀτρύνειε|ὀτρύνετον|ὀτρύνοντο|ὀτρύνοντος|ὀτρύνοντες|ὤτρυνον|ὀτρύνετε|ὄτρυνον|ὀτρύνω|ὀτρύναντος|ὀτρυνέεις|ὀτρύνει|ὀτρυνέων|ὄτρυνεν|ὀτρύνουσα|ὀτρύνεσθαι|ὀτρύνων|ὀτρύνουσι|ὤτρυνεν|ὀτρύνουσ̓|ὀτρύνεις|ὤτρυνα|ὠτρύνοντ̓|ὤτρυνε|ὀτρυνέω|ὄτρυνέ|ὀτρύνοιτε|ὀτρύνοντι|ὀτρύνοντα|ὀτρύνῃσι|ὀτρῦναι|ὀτρύνεσκον|ὀτρυνώμεθ̓|ὀτρύνειαν|ὤτρυν̓|ὀτρυνέμεν
κρεμάννυμι|κρεμόω|κρέμασεν|κρεμάσαντες|ἐκρέμω
παρίσχω|παρισχέμεν|παρίσχομεν
κοτέω|κοτέσσατο|κοτέουσιν|κοτέων|κοτεσσαμένη|κοτέοντο|κοτέοντε|κοτέσσεται|κεκοτηότι|κοτέουσ̓|κοτέοντος|κοτεσσάμενος
ἐπιχέω|ἐπιχεῦαι|ἐπεχεύατο|ἐπέχυντο|ἐπέχευε
συμμαχέω|μαχεῖται|μαχώμεθ̓|μαχέοιτο|μαχήσονται
ἐκνοστέω|ἐκνοστήσαντε|ἐκνοστήσαντι
πετάννυμι|πετάσσας|πέτασσαν|πεπταμένας|πετάσειε|πέτασ̓|πέπταται|πέτασαν|πέπτατο|πετάσθησαν|πετασθεῖσαι|πέπτανται
ἐκτίθημι|ἐκθεῖσαι
εἰλυφάζω|εἰλυφάζει|εἰλυφόων
γράφω|γράψεν|γράψας
βυσσοδομεύω|βυσσοδόμευον|βυσσοδομεύων
ὑπολείπω|ὑπελείπετ̓|ὑπελείπετο|ὑπολείψομαι|ὑπέλειπον
τελευτάω|τελεύτησάν|τελευτήσας|τελευτήσεις|τελευτήσειας|τελευτήσειεν|τελευτήσεσθαι|τελευτῆσαι|τελευτήσουσιν|τελεύτα|τελευτᾷ|τελευτήσω|τελευτηθῆναι|τελευτήσειν|ἐτελεύτα|τελεύτησέν|τελευτήσει|τελευτήσῃς
ἐπακούω|ἐπακούσω|ἐπακούσαι|ἐπακούεις|ἐπάκουσαν|ἐπακούσαις|ἐπακοῦσαι|ἐπακούει|ἐπακούσῃ
ἀμφιχάσκω|ἀμφέχανε
συναείρω|συναείρεται
ἐπιμύζω|ἐπέμυξαν
ἀπόφημι|ἀπόφημι|ἀπόφασθε
εἰσαφικνέομαι|εἰσαφικέσθαι|εἰσαφίκηαι|εἰσαφίκοιτο|εἰσαφίκηται
κελάδω|κελάδοντα|κελάδων|κελάδοντ̓
βασιλεύω|βασιλεύσομεν|βασιλευέμεν|βασίλευε|βασιλεύοι|βασιλεύσει|βασιλευέτω|βασίλευεν
ὁρμάω|ὁρμηθῆναι|ὁρμᾶτο|ὡρμήθησαν|ὁρμᾶτ̓|ὅρμησ̓|ὁρμηθέντε|ὁρμηθέντα|ὁρμηθέντος|ὁρμηθέντες|ὁρμήθησαν|ὡρμᾶτο|ὁρμήσωνται|ὁρμηθεὶς|ὁρμήσῃ|ὁρμηθήτην|ὁρμήθη|ὁρμήσειε|ὁρμηθέντι|ὁρμηθείς|ὁρμῶντ̓|ὁρμήσατ̓
διελαύνω|διήλασεν|διήλασε
εἰσπέτομαι|εἰσέπτατο
ἀμφιθέω|ἀμφιθέουσι
ἀναγνάμπτω|ἀνεγνάμφθη|ἀνέγναμψαν
ἀνανέομαι|ἀννεῖται
πτωχεύω|πτωχεύσων|πτωχεύεσκ̓|πτωχεύω|πτωχεύῃ|πτωχεύειν
ὑποκλοπέομαι|ὑποκλοπέοιτο
καθαιρέω|καθελοῦσα|καθείλομεν|καθέλῃσι|καθαιρήσουσι
χερνίπτομαι|χερνίψαντο
διαλέγω|διελέξατο
κυβιστάω|κυβίστων|κυβιστᾷ
ἐπιέννυμι|ἐπιειμένε|ἔφεσσαι|ἐπιειμένον|ἐπιειμένοι|ἐπιειμένος|ἐφέσσεσθαι
ἐπεμβαίνω|ἐπεμβεβαὼς
στόρνυμι|στόρεσαν|στορέσαι|ἐστόρεσεν
παίζω|παίζουσι|παίσατε|παιζόντων|παιζούσας|ἔπαιζον
ὀιστεύω|ὀιστεύσας|ὀϊστεύοντα|ὀϊστεύσας|ὀΐστευσον
ταράσσω|ἐτάραξε|ταράξῃ|τετρηχυῖα|τετρήχει
ἄφημαι|ἀφήμενος
ἐπαιτέω|ἐπαιτήσειας
ἰσχάνω|ἴσχανε|ἰσχάνει|ἰσχανέτην
κίω|κιόντι|κιόντες|κιοίτην|κίεν|κίε|ἔκιε|κιών|ἔκιον|κίῃς|κίοι|κί̓|κιόντε|κίοιτε|κιοῦσαι|κιούσῃ|κιὼν|κίον|κίομεν|κιόντα|κιόντας
ὑπερβαίνω|ὑπερβήῃ|ὑπερβαίνειν|ὑπέρβασαν|ὑπέρβη
ἐμπίπτω|ἔμπεσεν|ἐμπέσῃ|ἔμπεσ̓|ἔμπεσε
παραδύομαι|παραδύμεναι
ἐπικρατέω|ἐπικρατέωσιν|ἐπικρατέουσί|ἐπικρατέουσιν
βρύω|βρύει
ἀπονίζω|ἀπονίζουσα|ἀπονίπτεσθαι|ἀπονίψαντες|ἀπονιψάμενοι|ἀπονιψαμένη|ἀπενίζοντο|ἀπονίψατε
ἐπευφημέω|ἐπευφήμησαν
ἐπιγιγνώσκω|ἐπιγνώωσι|ἐπιγνώῃ
καίω|καιέμεν|κήαιεν|καιομένῃσιν|κήαι|ἐκαίετο|καῖ̓|καίοντ̓|κήομεν|κηάμενος|καήμεναι|κῆον|καιομένη|ἐκάη|κήαντες|κήαντο|ἔκηε|ἔκἠ|καίεται|καιομένοιο|κάη|καιόμεναί|κῆαι|ἔκηαν|ἔκηα|καίετο|καιόμενος|κῆεν|καίωσι|καίοντο|καίουσιν|κείατο|ἔκαιον|καίεο|κηαμένω|καῖεν|καίων|ἔκηεν|καῖε|καίωμεν|καιόντων|καιομένης|κηάμενοι
ἀναδέχομαι|ἀνεδέγμεθ̓|ἀνεδέξατο
στείβω|στείβοντες|στεῖβον
ἀποκρίνω|ἀποκρινθέντε
ἐπέχω|ἐπισχών|ἐπισχοίης|ἐπέσχον|ἐπέσχε|ἐπώχατο|ἐπεῖχε|ἐπέχεις|ἔπεχεν
ἐφίημι|ἐφιεμένῃ|ἐφέηκα|ἐφήσει|ἐφήσεις|ἐφείω|ἐφέηκεν|ἐφίετε|ἐφῆκε|ἐφῆκα|ἔφες|ἐφέηκε|ἐφείην|ἐφιεὶς|ἐφῆκεν|ἐφίει|ἐφείη|ἐφιέμενος|ἐφήσομαι|ἐφήσω
ἀπεχθάνομαι|ἀπεχθέσθαι|ἀπεχθομένοισί|ἀπήχθετο|ἀπεχθάνεαι|ἀπέχθηαι
προπίπτω|προπεσόντες
ἱζάνω|ἵζανεν|ἵζανον|ἱζάνει
ὀμόργνυμι|ὀμορξάμενος|ὀμορξαμένην|ὠμόργνυντο|ὀμόργνυ|ὀμορξάμενον
κεντέω|κένσαι
ἀνηκουστέω|ἀνηκούστησεν
ὑποκύομαι|ὑποκυσάμεναι|ὑποκυσαμένη
λακτίζω|λακτίζων
φοιτάω|φοιτήσασα|φοιτήτην|φοιτῶσ̓|φοίτα|ἐφοίτα|ἐφοίτων|φοιτᾷ|φοίτων|φοιτῶντε
μέμαα|μεμαῶτε|μεμαῶτας|μεμαότε|μεμαῶτες|μεμαυῖαι|μέμασαν|μεμαῶσιν|μεμαώς|μεμαυῖ̓|μεμαῶτος|μεμάασί|μεμαῶτα|μεμαυῖαν|μεμάασιν|μεμαυῖα|μέμαθ̓|μεμαὼς|μέματον|μεμαότες|μεμάτω|μέμαμεν|μεμάασι|μεμαῶτ̓|μεμαῶτι
ἐπιμάσσομαι|ἐπιμάσσεται
σκιρτάω|σκιρτῷεν
σπέρχω|σπέρχοιεν|σπερχοίατ̓|σπερχομένη|σπερχόμενος|σπερχομένους|σπερχόμενός|σπέρχωσιν|σπερχομένοιο
κολούω|κολούετε|κολούει
μεγαλίζομαι|μεγαλίζεο|μεγαλίζομαι
ἐνδουπέω|ἐνδούπησα|ἐνδούπησε
ἀποτέμνω|ἀποταμνόμενον|ἀπέταμνε
περισαίνω|περισσαίνουσι|περισσαίνοντες|περίσσαινον
κατακοιμάω|κατακοιμηθήτω|κατεκοιμήθημεν|κατακοιμηθῆναι
στενάχω|στενάχεσχ̓|στενάχοντι|στενάχων|στενάχοντα|στενάχοντος|στενάχω|στενάχουσι|στενάχοντες|στενάχοντο
ἀποκρύπτω|ἀποκρύψαι|ἀπέκρυψεν
ἀεικίζω|ἀεικίζει|ἀεικισθήμεναι|ἀεικισσαίμεθ̓|ἀείκιζεν|ἀεικίσσωσι|ἀεικίσσασθαι|ἀεικιῶ
ὑπαντιάζω|ὑπαντιάσας
ποιμαίνω|ποιμαίνοντο|ποιμαίνεσκεν|ποιμαίνων|ποιμαίνοντ̓
λαμβάνω|λάβεν|λάβῃσι|λαβὲ|λαβέτω|ἔλαβε|λάβωμεν|λαβών|λαβὼν|λάβ̓|λάβε|λαβόντες|λάβοιμεν|ἐλλάβετ̓|λάβῃ|ἔλαβ̓|λελαβέσθαι|ἔλαβεν|ἔλλαβ̓|λάβετον|λάβοιμι|λαβόντι|λάβητε|ἔλλαβεν|λαβέτην|λάβῃσιν|λάβοι|λαβοῦσα|ἔλλαβε|λάβον
ὀνομαίνω|ὀνομήνῃς|ὀνόμηνας|ὀνομήνω|ὀνόμηνεν
ὑδραίνω|ὑδρηναμένη
καταδεύω|κατέδευσας
παραπαφίσκω|παρήπαφεν
ζεύγνυμι|ἔζευξαν|ζεῦξεν|ζεῦξον|ζεύγνυντ̓|ζευγνῦμεν|ζευγνύμεναι|ζεύξειεν|ζεῦξάν|ζεῦξαι|ζεύγνυσθ̓|ζεύγνυον|ζεῦξ̓|ἐζευγμέναι|ζευγνύσθην|ζεύξαθ̓|ζευγνύμεν|ζεύξασ̓|ζεύγνυσαν|ζεῦξαν|ζεύξῃ
καταχέω|κατέχευε
ἀγαίομαι|ἀγαιομένου
εἰσδέρκομαι|ἐσέδρακον|ἐσέδρακεν
νάω|νάει|νάουσιν
πεμπάζω|πεμπάσσεται
ἀνέλκω|ἀνέλκει|ἀνέλκων|ἄνελκε|ἀνελκόμενον
ὑποφεύγω|ὑποφεύγειν
ἁμαρτάνω|ἁμαρτὼν|ἁμαρτεῖν|ἅμαρτε|ἁμάρτῃ|ἤμβροτες|ἤμβροτε|ἁμαρτήσεσθαι|ἅμαρθ̓|ἅμαρτεν|ἡμάρτανε|ἤμβροτον|ἤμβροτεν|ἁμαρτών
προσαλείφω|προσάλειφεν
δαρδάπτω|δαρδάπτουσιν
ἔφημαι|ἐφήμενοι|ἐφήμενος
ἀκαχίζω|ἀκαχίζεις|ἀκαχίζευ
προεέργω|προέεργε
πεδάω|πεδάασκον|πεδῆσαι|ἐπέδησ̓|πέδησε|πέδησεν|πεδάᾳ
ἔχθω|ἤχθεθ̓|ἔχθεσθ̓|ἐχθόμενός|ἤχθετο
προσφύω|προσφὺς|προσφῦσα
ἄγχω|ἄγχε
μηνίω|μηνίει|ἐμήνιε|μηνίσας|μήνιεν|μήνιε|μήνἰ
νίζω|νιψάμενος|νένιπται|νίζετο|ἔνιψ̓|νίζον|νίψον|νίψει|νίζε|νίζ̓|νίψω|νίψασθαι|νίψεν|νίζειν|νίζοντες|νίψατο|νιψάμενοι
ἐπεύχομαι|ἐπευχόμενος|ἐπεύξεαι|ἐπευχομένη|ἐπεύχεται|ἐπεύξατο|ἐπεύξασθαι|ἐπεύχεο|ἐπεύχετο|ἐπευξάμενος
περιτρομέω|περιτρομέοντο
ἑτοιμάζω|ἑτοιμάσατ̓|ἑτοιμάσσαντο|ἑτοιμασάτω|ἑτοιμασσαίατ̓
ἐρέθω|ἐρέθουσι|ἐρέθῃσιν|ἔρεθε|ἐρέθουσιν
σφάζω|σφαζόμενοι|ἐσφαγμένα|σφάξεν|ἔσφαζον|ἔσφαξάν|σφαζομένων|σφάζουσι|ἔσφαξαν|σφάξ̓
μεθομιλέω|μεθομίλεον
ἀνάγω|ἀνάγοντο|ἀνήγαγε|ἀνῆγες|ἀνήγαγον|ἄναγον|ἀνάγουσι|ἀνάγοντες|ἀνήγαγεν
ὄσσομαι|ὄσσοντο|ὀσσόμενος|ὄσσετο|ὀσσομένη|ὀσσόμενον
ἐπιτέρπομαι|ἐπιτέρπεται
στοναχέω|στοναχῆσαι
δαίζω|δεδαϊγμένῳ|δαΐξαι|ἐδαΐζετο|δεδαϊγμένοι|δεδαϊγμένος|δαϊζέμεναι|ἐδάϊζε|δαΐζων|δεδαϊγμένον|δαϊζόμενος
ἐλεφαίρομαι|ἐλεφηράμενος|ἐλεφαίρονται
φορύσσω|φορύξας
ἀμφικαλύπτω|ἀμφικαλύπτει|ἀμφικαλύψειν|ἀμφικαλύψῃ|ἀμφικαλύψω|ἀμφεκάλυψεν|ἀμφεκάλυψε|ἀμφικαλύπτοι|ἀμφικαλύψας|ἀμφικαλύψαι
τεταγών|τεταγὼν
ἔρχομαι|ἐλθοῦσ̓|ἔρχεαι|ἐρχομένοιο|ἐρχομένη|ἔλθητε|εἰλήλουθε|ἐλεύσομαι|ἐλεύσονται|ἐλευσόμεθ̓|ἤλθετε|ἐρχομένω|ἐλεύσεται|ἐλθόντες|ἔλθῃσ̓|ἤλθεθ̓|ἦλθες|ἐρχομένων|ἔλθωσ̓|ἐλεύσεσθαι|ἔλθῃσιν|ἔρχεσθ̓|ἐλθέ|ἔρχομ̓|ἐλθεῖν|ἐρχόμενον|ἐλθόντα|εἰλήλουθα|ἔλθωμεν|ἐλθόνθ̓|ἐλθέμεναι|ἔρχεό|ἔλθοι|ἔλθω|ἦλθ̓|ἔρχεται|ἐρχόμεθ̓|ἔλθῃς|ἐρχομενάων|ἔρχεσθον|ἦλθε|ἔρχηται|ἐλθοῦσιν|ἔρχονται|ἦλθον|ἔλθωσι|ἔρχησθον|ἦλθεν|ἤλυθον|εἰληλούθει|ἤλυθ̓|ἔρχευ|ἐλεύσεαι|ἤλυθες|ἐρχομένην|ἔρχομαι|ἔλθοις|εἰλήλουθεν|ἐλθοῦσα|ἐρχομένοισι|ἤλθομεν|ἐλθόντ̓|ἐλθόντι|ἔλθῃ|ἐλθοῦσαν|ἐρχομένῳ|ἔρχεσθε|ἔνθεο|ἐρχομένοις|ἔρχεο|ἐλθούσας|ἔλθητον|ἔλθοιμι|ἤλυθε|ἐρχόμενος|ἐλθέμεν|εἰλήλουθας|ἤλυθεν|ἐλθών|ἔλθετ̓|ἐλθόντε|ἔλθῃσι|εἰλήλουθμεν|ἐρχομένοισιν|ἐλθὼν|ἔρχεσθαι|ἐρχόμενοι|ἐληλουθὼς|εἰληλουθώς|ἐλθὲ
ἐξοιχνέω|ἐξοιχνεῦσι
ἀποκρεμάννυμι|ἀπεκρέμασεν
καταπίπτω|κάππεσεν|κάππεσε|κάππεσον|κάππεσ̓|καππεσέτην
ὑπέρχομαι|ὑπέλθῃ|ὑπήλθετε|ὑπήλυθε
ἐπερείδω|ἐπέρεισε
διασεύομαι|διέσσυτο
ἐκπαιφάσσω|ἐκπαιφάσσειν
βομβέω|βόμβησε|βόμβησεν|βόμβησαν
ἀμφιμαίομαι|ἀμφιμάσασθε
αἱρέω|ἑλέειν|εἷλ̓|ἑλέτω|ἑλών|ἑλέσθαι|ἕλοιμεν|ἕλῃσι|ἑλόμην|ἑλοῦσ̓|ἑλοίατο|ἕλῃσιν|ἕλοιο|αἱρεῖ|ἑλὼν|ᾕρεον|ἕλ̓|ἕλε|ἑλοῦσα|ἕλετ̓|ἑλόμεσθα|ἑλόντε|ἑλέτην|αἱρησέμεν|ἕλοι|ἕλεν|εἱλόμεθ̓|εἵλομεν|ἕλετο|εἷλε|εἵλευ|ἕλον|εἵλοντο|εἷλον|ἑλοίμην|αἱρείτω|ἕλοιτο|ἕλοιμί|ἕλωσί|ἕλοιεν|ἑλοῦσαι|ἕλητε|ἑλέσθω|εἵλετ̓|εἵλετο|αἱρήσειν|αἱρεύμενοι|ἕλεσθε|ἕλωμεν|ᾕρεε|ἕλες|ἕλεθ̓|ᾕρει|ἕλῃσί|αἱρήσει|ἕλω|ἑλεῖν|αἱρήσομεν|ἕληται|αἱρήσεαι|ἕλωσι|ἑλοίμεθα|εἷλες|αἱρήσομαι|ἕλοις|ἕλεσκε|ἕλευ|ἕλοντο|ἕλωμαι|ἕλῃς|ἑλόντες|εἷλεν|ἕλῃ|ἑλόντ̓|ᾑρεῖτ̓|ἕλωνται|ἕλεσκον
ἀπαίνυμαι|ἀποαίνυτο|ἀπαινύμενον|ἀποαίνυμαι|ἀποαίνυται|ἀπαίνυτο
ἀναστρωφάω|ἀναστρωφῶν
ναίω|ναιομενάων|ναίων|ναιέμεν|ναίοιμεν|ναιόμενα|ναίοιτε|ναίεις|ναῖε|ναιόμενον|ἔναιε|νάσθη|ἔναἰ|ναίουσι|ναίεσκον|ἔναιον|ναίειν|ναίει|ναιομένῳ|ναιομένην|ναίεσκε|ἔναιεν|ναῖ̓|ναῖον|ναῖεν|ναιέμεναι|ναίω|ναίοντες|νάσσα|ναιομένη|ναίουσ̓
ἀπαίσσω|ἀπαΐξας
ἐγγυαλίζω|ἐγγυαλίξῃ|ἐγγυαλίξει|ἐγγυάλιξε|ἐγγυάλιξεν|ἐγγυαλίξαι|ἐγγυάλιξα|ἐγγυαλίζει|ἐγγυαλίξω
ἐπάρχω|ἐπαρξάμενος|ἐπαρξάσθω|ἐπαρξάμενοι
μετασεύομαι|μετέσσυτο
τέμνω|ταμέειν|τάμνετο|τάμῃ|ἔταμνον|ταμέσθαι|τάμοι|τάμῃσιν|τάμητε|τάμνῃ|ταμὼν|τάμον|τάμνετε|ἔταμνεν|ταμνομένους|τάμνον|τάμωμεν|τάμνεν|τάμνων|ταμόντες|ταμόνθ̓|τάμῃσι|τάμε|τέμνειν|τετμημένον|τάμνε|ταμνομένη|τάμνοντ̓
παραπείθω|παραιπεπίθῃσιν|παρπεπιθόντες|παρπεπιθὼν|παραιπεπιθοῦσα|παρέπεισεν
εἰσανάγω|εἰσανάγουσι
θηλέω|θήλεον
ἁλιόω|ἁλιῶσαι|ἁλίωσε
ἐκσῴζω|ἐξεσάωσε|ἐξεσάωσεν
μεταπρέπω|μετέπρεπον|μεταπρέπω|μεταπρέπει|μετέρεπον|μετέπρεπε|μετέπρεπεν
ἀποτίθημι|ἀποθέσθαι|ἀπέθηκ̓|ἀποθείομαι
ζητέω|ζήτει
ἀναξηραίνω|ἀγξηράνῃ
πορσύνω|πορσανέουσα|πόρσυνε
διαδέρκομαι|διαδράκοι
ὑπισχνέομαι|ὑπόσχηται|ὑποσχέσθαι|ὑπόσχωμαι|ὑπίσχεται|ὑποσχόμενος|ὑπόσχωνται|ὑποσχόμενοι|ὑπίσχετο|ὑπόσχεο|ὑπίσχομαι|ὑπέσχεο
ἀπεκλανθάνομαι|ἀπεκλελάθεσθε
θέρμω|θέρμετο|θέρμετε|θέρμετ̓
δουπέω|δούπησεν|ἐγδούπησαν|δουπῆσαι|δεδουπότος
πειρητίζω|πειρήτιζον|πειρητίζων|πειρήτιζεν|πειρήτιζε
παρατρωπάω|παρατρωπῶσ̓
πλάζω|πλάζουσι|πλάζ̓|πλαζόμενος|πλάγξομαι|πλάζομαι|πλαγχθείς|πλάγξ̓|πλάζετο|πλάγχθη|πλαζόμενοι|πλαγχθέντα|πλάζετ̓|πλάζεσθαι|πλαγχθέντες|πλάζε|πλάζων|πλαζομένου|πλάζει
μηκάομαι|μεμακυῖαι|μέμηκον|μακών|μεμηκώς
συνίστημι|συνεσταότος
διαπορθέω|διαπορθήσας
περιχέω|περιχεύῃ|περίχευεν|περιχεύας|περίχευε|περιχεύεται
ἐπαγείρω|ἐπαγείρειν
εἰσακούω|ἐσάκουσε
πυρακτέω|ἐπυράκτεον
λείπω|ἐλείπετε|λείψειν|λείπεις|λιπόντε|λίπετ̓|λιπέτην|ἔλειπεν|λιπόντα|ἔλειπε|λίπον|λίποιτε|λείψω|ἔλειπον|λεῖπ̓|ἔλειπες|λεῖπε|λείπετ̓|λίπησθον|λιποῦσα|λιπόμην|λείπεσθ̓|λιποῦσαν|λιπέσθαι|ἐλείπομεν|λεῖπεν|ἔλιπον|λελειμμένος|λίποιεν|λίπ̓|λείψει|λείπει|ἔλιπεν|λελειμμένοι|λίπωνται|λίπω|λείπεσθε|λελεῖφθαι|ἐλίποντο|λέλοιπεν|λίπεν|λίποντο|ἐλέλειπτο|λελείμμην|λίπε|λελείψεται|λιπὼν|λιποίμην|λείπονται|λίποιτο|λίπομεν|λέλειπτο|λίπες|λιπέτω|ἔλιπε|λίπηται|λέλειπται|λίπῃ|λίπησθε|λείψετέ|λίπεθ̓|λιποῦσ̓|λίποι
ποθέω|ποθέω|ποθέων|ποθέσαι|ποθέουσα|πόθεον|ποθήμεναι|ποθέοντες|πόθει|πόθεόν|πόθεσαν|ποθέοντε|ποθέεις|ποθέεσκε
ὑποταρβέω|ὑποταρβήσαντες
ῥίπτω|ἔρριψε|ῥίπτασκε|ῥίψω|ῥῖψ̓|ἔρριψεν|ῥίψει|ῥῖψε|ῥίπτασκον
ἀποδιδράσκω|ἀποδράς|ἀποδρὰς
ἀναπλέω|ἀνεπλέομεν|ἀναπλεύσεσθαι
ὑποστεναχίζω|ὑπεστενάχιζε
ὑποσχέθω|ὑπέσχεθε
ὀνομάζω|ὀνομάζειν|ὀνόμαξε|ὠνόμασας|ὀνόμαζες|ὀνομάζοι|ὀνόμαζε|ὀνομάζων|ὀνόμαζον|ὀνόμαζεν
μέλλω|μέλλουσιν|μέλλε|μέλλεις|μέλλον|μέλλεν|ἔμελλε|μέλλω|ἔμελλες|μέλλει|μέλλοιμεν|μέλλοι|μέλλουσι|ἔμελλ̓|ἐμέλλετε|ἔμελλεν|μέλλετ̓|ἔμελλον
ἁνδάνω|ἁδηκότας|ἅδε|ἑαδότα|εὔαδεν|ἥνδανεν|ἑήνδανε|ἁνδάνει|ἅδοι|ἑήνδανεν|ἥνδανε|εὔαδε|ἁδεῖν
ἰαύω|ἰαύειν|ἰαύων|ἰαύεις|ἰαύεσκεν|ἰαῦσαι|ἰαύεσκον|ἴαυον
συμπλαταγέω|συμπλατάγησεν
ἀνορούω|ἀνορούσας|ἀνόρουσε|ἀνόρουσαν|ἀνόρουσεν
τανύω|τάνυσεν|τάνυσσαν|τάνυσθεν|τανύσσαι|τανύω|τανύσσῃ|τανυσθείς|ἐτάνυσσεν|τανύειν|τανύοντο|ἐτάνυσσε|τανύσῃ|τανυσσάμενος|τετάνυσται|τάνυσε|τανυσθεὶς|τάνυσσεν|τανύσσας|τανύων|ἐτάνυσσα|τανύουσι|τετάνυστο|τανύσσειέν|τάνυσσε
ἀμφιπολεύω|ἀμφιπολεύοι|ἀμφιπολεύεις|ἀμφιπολεύειν
ἐρέχθω|ἐρέχθων|ἐρεχθομένην
κρύπτω|κρύψω|κρύψαντες|κεκρυμμένα|κρύψαι|κρύπτασκε|κεκρυμμένον|κρύψεν|ἔκρυψαν|κρύπτων|κρύφθη
τέθηπα|τεθηπὼς|τέθηπά|ἐτεθήπεα|ταφὼν|τεθηπότες|ταφών|τέθηπεν|τεθηπότας
ἀποκοσμέω|ἀπεκόσμεον
τλάω|ἐτάλασσας|τλῆτε|τλήσομαι|τλῆμεν|τετληότες|τλαῖεν|τετλαίη|ἔτλην|ἔτλητε|ἔτλαν|τετληότι|τλαίης|τετλάτω|τετληυῖα|ἔτλης|τέτληκε|τέτληκας|ταλάσσῃς|τετλάμεν|τλαίην|ταλάσσῃ|ἔτλη|τέτλαμεν|τλῆ|τλαίη|τέτλαθι|τλήσομ̓|τλήτω|τετλάμεναι
βλάπτω|βλάβεν|βλάψας|βλαφθέντε|βλάπτουσ̓|βλαφθεὶς|ἔβλαψε|ἔβλαβεν|βλάπτε|βλάπτουσι|βλάψεν|βεβλαμμένον|βλάπτει|ἐβλάφθησαν|ἔβλαψάς|ἔβλαψαν|βλάψε|βλαφθέντα|βλάπτοι|βλάβεται
ἐξαπατάω|ἐξαπατήσειν|ἐξαπάτησεν|ἐξαπατῆσαι
κατανεύω|κατάνευσον|κατανεύσω|κατένευσας|κατανεύων|καννεύσας|κατένευσεν|κατανεύσομαι|κατένευσα|κατένευσε|κατανεῦσαι
ἱμείρω|ἱμείρεται|ἱμειρόμενός|ἱμείρετε|ἱμείρων|ἱμείραιτο
κερτομέω|κερτομέοντες|κερτομέοι|κερτομέων|κερτομέωσιν|κερτομέουσαν|ἐκερτόμεον
προσβάλλω|προσέβαλλεν|προτιβάλλεαι
παρασφάλλω|παρέσφηλεν
ὑπερέπτω|ὑπέρεπτε
ὀλισθάνω|ὄλισθεν|ὄλισθε
πλανάω|πλανόωνται
ὑποδάμναμαι|ὑποδάμνασαι
ἀποτρίβω|ἀποτρίψουσι
σβέννυμι|σβέσσαι|ἔσβη|ἔσβεσεν|σβέσαν|σβέσατ̓
πάομαι|πέπασθε
πίτνημι|πίτναντο|πίτνα|πιτνὰς
παρεξελαύνω|παρεξελάαν|παρεξελάσῃσθα
ἐπιτρέχω|ἐπέδραμεν|ἐπεδραμέτην|ἐπέδραμον|ἐπιδέδρομεν|ἐπέτρεχον|ἐπιδραμέτην|ἐπιθρέξαντος|ἐπέδραμε
περιφαίνομαι|περιφαινομένοιο|περιφαινομένῳ
ἐπιστρέφω|ἐπιστρέψας
ἐγκλίνω|ἐγκέκλιται
πλήσσω|πεπλήγων|πλήγη|πλῆξα|πλήσσουσι|πλήξαντε|πλήξῃ|πλήξας|πέπληγον|πεπληγέμεν|πληγεὶς|πληγέντα|πληγεῖσα|ἐπέπληγον|πεπληγυῖα|πληξάμενος|πέπληγόν|πλῆξεν|πλῆξ̓|πεπλήγοντο|πεπλήγετο|πληγέντι|πλήξειε|πληγέντε|πλῆξε|πληγεῖσ̓
φάω|φάε
ἰάπτω|ἰάπτῃ|ἰάπτῃς
μέλω|μέλω|μελέτω|μεμήλῃ|μελήσει|μέμηλεν|μελησέμεν|μελήσουσιν|μέλουσα|μελέμεν|μέμβλετο|μέλειν|μέλει|ἔμελέν|μέμηλε|μελέσθω|μελόντων|μέλε|μέλουσί|μεμηλώς|μελήσῃ|μέμβλετ̓|μεμήλει|μελήσεται
ἐμπίπλημι|ἐνέπλησθεν|ἐμπλήσατο|ἐνιπλήσωσιν|ἔμπληντο|ἐνέπλησάν|ἔμπλητο|ἐμπλησάμενος|ἐμπλήσαντες|ἐμπλήσας|ἐνιπλησθῆναι|ἐμπίπληθι|ἐνιπλήσῃς|ἐνέπλησεν|ἔμπλησον|ἐμπλησέμεν
ἀκροκελαινιάω|ἀκροκελαινιόων
ἀπερωέω|ἀπερωήσειας
περιίστημι|περίστησαν|περιίσταθ̓|περισταῖεν|περιστήωσ̓|περιστάθη|περιστήσαντο|περίστησάν
ἀναμίγνυμι|ἀνέμισγε|ἀμμίξας
ἔσθω|ἔσθουσ̓|ἔσθων|ἔσθουσαι|ἦσθ̓|ἦσθε|ἔσθειν|ἔσθοντες|ἐσθέμεναι
εἰμί|ἐστὶν|ἐστὶ|εἶτ̓|ἐστε|ἰόντος|ἔσσ̓|ἐὸν|ἔστι|ἐσσὶ|εἰσι|ἔσῃ|εἶεν|ἐστὲ|εἰμι|ἐσσι|ἐστι|ἐσσομένῃσιν|ἔσται|ἐσσ̓|ἦσθα|ἐσσομένοισιν|ἔμμεναι|ἐσόμεσθα|ἔασι|ἐστέ|εἴη|ἔσσονται|ἐσσί|ἔσσοντ̓|ἔσομαι|ἔσεαι|ἤστην|ἔον|εἲς|ἔστί|ἔασ̓|εἶναι|εἴς|ἦμεν|εἰμί|ἐστον|ἐὼν|ἔσκε|ἔστιν|ἐόν|ἐοῦσι|ἔσσεαι|ἔσσεται|εἴσ̓|εἰσιν|ἔῃ|εἴης|ὄντας|ἐσσόμενα|ᾖσιν|ἔσεσθε|ἐστιν|ἐστίν|ἔμεν|ἔσαν|ἰόντα|ὦσ̓|εἰμὶ|ἔσχ̓|ἔσσεσθαι|ἔσονται|ἐστόν|ἔσθ̓|εἰσίν|ἰοῦσαν|ἔμμεν|ἔῃσι|ἐών|ἔστω|ἐόντε|ἦν|εἰμὲν|εἶς|ἔσάν|εἰσὶν|ἔστε|ἐόντος|ἔσεσθαι|ἔην|ἔοι|ἐούσης|εἰσ̓|ἔῃσιν|ἴωσι|εἰμέν|εἰμ̓|ἦα|εἴατο|ἰοῦσαι|ἔσσετ̓|ἔμεναι|ᾖσι|ἔσοντ̓|ὦσι|ἔασιν|εἰσί|ἔησθα|ἔσσομαι|ἐοῦσαν|ἐσθ̓|εἰμεν|ἔστων|ἐστ̓|ἤην|οὔσης|ἔσεται|ἔσκεν|ἦτε|εἴμ̓|ἐούσῃ|εἰσὶ|ἔωσι|ἐσσόμεθ̓|ἐοῦσ̓|ἐόντες|εἴην|ἔσεσθον|ἐόνθ̓|ἐσσεῖται|ἔσομ̓|ἐόντ̓|ἐόντας|ἔωσιν|ἰόντας|ἔα|ἔσκον|ἐσσομένοισι|ἔσσεσθ̓|ἐστὸν|ἐόντων|ἦεν|ἐόντα|ἐόντι|ἔσεταί|ἐοῦσα|ἔω|ἐστί|ἔστ̓|ἦσαν|ἔοις
ἀποκινέω|ἀποκινήσωσι|ἀποκινήσασκε
ἀρχεύω|ἀρχεύειν|ἄρχεὐ
θέρω|θερσόμενος|θέρεσθαι|θέρηται|θέρωνται|θερέω
τρέφω|τέτροφεν|θρέψαν|ἔτραφέ|θρέψαιό|θρέψεν|ἐτραφέτην|τράφ̓|ἔτρεφον|τράφη|ἔτρεφες|θρέψας|ἔτρεφεν|τραφέμεν|θρέψε|θρέψ̓|θρέψασα|ἐτράφημεν|τροφέοντο|ἔτραφεν|τρέφον|τράφεν|θρέψά|ἔτραφ̓|ἔτρεφε|τρέφεται|ἔθρεψε|τρέφεν|τρέφε|ἐτρεφόμην|τρέφει
ῥέπω|ῥέπε
ἐξερωέω|ἐξηρώησαν
ἅζομαι|ἅζομαι|ἅζευ|ἅζετο|ἁζόμενοι|ἅζεο
οἰκτείρω|οἰκτίρεις|οἰκτίρων|ᾤκτειρε|ᾤκτιρε
ἐκμυζάω|ἐκμυζήσας
μακαρίζω|μακαρίζοι
κοναβέω|κονάβησε|κονάβησαν
προτέμνω|προταμοίμην|προταμὼν
ἐφάλλομαι|ἐπάλμενοι|ἐπιάλμενον|ἐπάλμενος|ἐπιάλμενος|ἐπᾶλτο
ἀίσθω|ἀΐσθων|ἄϊσθε
ἄγνυμι|ἔαξε|ἐάγη|ἆξον|ἔαξεν|ἆξαι|ἐάγῃ|ἄξαντ̓|ἦξε|ἀγνυμενάων|ἄγνυτον|ἔαξαν|ἄξῃ|ἄξῃς|ἄγη
πεύθομαι|ἐπεύθετο|ἐπευθόμεθα|πευθόμεθ̓|πευθέσθω|πευθοίαθ̓|πεύθετ̓|πεύθετο|πεύθεσθαι|πεύθομαι|πευθόμενος
ὀλιγοδρανέων|ὀλιγοδρανέων
δειπνέω|ἐδείπνεε|δειπνήσαντας|δειπνήσειαν|δειπνήσας|δείπνησε|δειπνῆσαι|δεδειπνήκειν
ἀπαλέξω|ἀπαλεξήσαιμι|ἀπαλεξήσειν
σκύζομαι|σκυζομένη|σκυζομένῳ|σκύζεσθαί|σκύζεσθαι|σκυζομένης|σκύζευ
γεύω|γεύσεσθαι|γευσόμεθ̓|γεύσεται|γεύσασθαι
οἴγω|ὠΐγνυντο|ὤϊξαν|οἴξασα|ᾦξε|ὤϊξάν|ὤιξεν|ὤϊξεν|ὤϊξε|ὤιξε
ἱλάσκομαι|ἱλάσκεσθαι|ἱλάσκοντο|ἱλάσσεαι|ἱλάσκονται|ἱλάσσομ̓|ἱλασόμεσθα
ἀνατρέπω|ἀνετράπετ̓
ἐγκονέω|ἐγκονέουσαι
διαμετρέω|διεμέτρεον
μοχλέω|ἐμόχλεον
ἀραρίσκω|ἀραρυίῃ|ἀρηρότος|ἀρηρότι|ἄρμενον|ἀράρισκε|ἀραρὼν|ἀρηρότες|ἀραρυῖαι|ἀρηρώς|ἄρσε|ἀρήρει|ἤραρε|ἄρσας|ἄρθεν|ἄρσον|ἄραρον|ἄρσαντες|ἀραρυῖαν|ἀραρόντε|ἀρηρός|ἀραρυίας|ἠρήρει|ἀράρῃ|ἤραρεν|ἀραρυῖα|ἀρήρῃ|ἀρηρότα
κείω|κείουσα|κείοντες|κειέμεν|κείω|κείων
ἐπισσεύω|ἐπεσσεύοντο
ἀποπέμπω|ἀποπέμπειν|ἀποπέμπω|ἀπέπεμψε|ἀποπέμψῃ|ἀποπέμπετε|ἀπόπεμψον|ἀπέπεμπε|ἀπόπεμπε|ἀππέμψει|ἀπέπεμπον|ἀπέπεμπεν|ἀποπεμπέμεν|ἀπέπεμψα|ἀποπέμψω|ἀποπέμπει|ἀπεπέμπομεν
ἰδυῖα|ἰδυίῃσι|ἰδυῖα
μετακλίνομαι|μετακλινθέντος
ἡνιοχεύω|ἡνιόχευεν|ἡνιόχεὐ
ἐξόλλυμι|ἐξολέσειε
ἐκμολεῖν|ἔκμολεν
ἔδω|ἔδεσκε|ἔδωμεν|ἔδοιεν|ἔδουσ̓|ἐδηδώς|ἔδων|ἔδοντες|ἔδεαι|ἔδομαι|ἔδει|ἐδήδοται|ἔδονται|ἔδεις|ἔδοι|ἔδουσί|ἔδοντας|ἔδουσι|ἔδμεναι|ἔδον|ἔδουσιν
ὁράω|ὄπωπα|ὁρᾶσθαι|ὄψει|ὅρηαι|ὁρώμενος|ὄψῃ|ὁρῶντες|ὄπωπας|ὀψόμεναί|ὁρῶντο|ὁρῷτο|ὁρᾶται|ὄψεσθαι|ὁρῶμεν|ὄψεται|ὄψεσθ̓|ὁράασθαι|ὀψόμενος|ὁρῶν|ὄψεσθε|ὁρῶμαι|ὁρᾶν|ὄψεαι|ὁρᾶτο|ὁρόωντες|ὁράᾳς|ὀψομένη|ὁρόων|ὀπώπει|ὁρῶσα|ὁρόωσα|ὅρα|ὁρᾷς|ὁρόω|ὁρῶ|ὁρᾷ|ὁρόῳτε|ὁρώμενοι
ἱδρόω|ἱδρώσει|ἱδρώουσα|ἱδρώοντα|ἱδρώοντας|ἵδρωσα|ἱδρῶσαι
ἐπορέγω|ἐπορεξάμενος
νύσσω|νυσσομένων|νύσσων|νύξε|νύξας|νύξ̓|νύσσοντες|νύξεν
κομίζω|κομιζέμεν|κόμισαν|κομίζῃ|κόμισαί|ἐκόμισσε|κόμισσα|κόμισσον|κομίσσῃ|κομιζόμενός|κομίζει|κόμισε|ἐκομίσσατο|κόμιζε|κόμισσε|κομιῶ|κομίσαντο|κομίζειν|ἐκόμιζε|κόμισεν|κομίσσατο|κομίζω|κομίσαιο
ἐξερείπω|ἐξεριποῦσα|ἐξερίπῃ
ἐφυβρίζω|ἐφυβρίζων
παρατίθημι|παρτιθεῖ|παρέθηκεν|παρέθηκε|παραθήσομεν|παραθείμην|παρέθηχ̓|παρέθηκ̓|παραθεῖτο|παρθέμενοι|πάρθεσαν|παράθες
ἐμπάζομαι|ἐμπάζομαι|ἐμπάξομαι|ἐμπάζεο|ἐμπάζετο|ἐμπάζεαι|ἐμπαζόμεθ̓
ἐκκαταπάλλομαι|ἐκκατεπᾶλτο
ἀολλίζω|ἀολλίσσασα|ἀόλλισσαν|ἀολλισθήμεναι|ἀολλίσθησαν
παρατεκταίνομαι|παρατεκτήναιο|παρατεκτήναιτο
ἀλεόμαι|ἀλέασθαι
ἔοικα|ἐοικώς|ἐοικὼς|ἔοικα|ἤϊκτο|ἐοικότα|ἔοικέ|ἤικτο|ἐοικότες|ἔοικ̓|ἔϊκτο|ἔοικε|ἔοικεν|ἐῴκει|ἔοικας|ἐοικότι|ἐοίκεσαν|ἔικτον|ἐίκτην|ἐοικότας|ἐοικότε|εἶκε|ἐΐκτην|εἰοικυῖαι
καταφθίω|καταφθίσει|καταφθίσθαι|κατέφθιτο|καταφθιμένοιο|καταφθιμένοισιν
περίειμι|περίειμι|περίεσσι
δέατο|δέατ̓
ὕπειμι|ὑπέασι|ὑπῆσαν
ἀποδίδωμι|ἀποδώσομεν|ἀποδώσω|ἀποδῷσιν|ἀπέδωκε|ἀποδοῖτε|ἀποδοῦναι|ἀπέδωχ̓
διασκοπιάομαι|διασκοπιᾶσθαι
ἀχεύω|ἀχνυμένη|ἄχνυτο|ἀκηχέδατ̓|ἀκαχήμενος|ἀχνύμενοι|ἀχεύων|ἀκαχήμενον|ἀκάχηται|ἀκηχεμένη|ἀκάχοντο|ἀκάχησθαι|ἀχνυμένω|ἀχέουσ̓|ἀχνύμενός|ἀχέουσά|ἀκαχοίμεθα|ἀκαχίζεο|ἄχνυνται|ἄχνυται|ἀκάχημαι|ἀκαχήμενοι|ἀχνύμενοί|ἀχνύμενος|ἀκηχέμεναι|ἀχέων|ἀκάχησε|ἀκαχοίμην|ἄχομαι|ἀχνυμένῳ|ἀχνύμεθα|ἤκαχε|ἤκαχ̓|ἀχνυμένῃ|ἀχνύμενον|ἀχνύμεναι|ἀκάχοιτο|ἀκαχήατο|ἀχνυμένοις
ἐπικεράννυμι|ἐπικρῆσαι
δίεμαι|δίεσθαι|δίενται
ἔξεστι|ἐξέμεναι|ἐξέμμεναι
ἐφάπτω|ἐφῆπται|ἐφῆπτο|ἐφάψεαι
ἱκάνω|ἱκάνετον|ἱκάνω|ἱκάνομαι|ἱκάνεται|ἱκάνει|ἱκάνεις|ἱκάνοι|ἵκανε|ἵκανον|ἱκανέμεν|ἱκάνομεν|ἵκανεν
μορύσσω|μεμορυγμένα
ὀαρίζω|ὀαριζέμεναι|ὀαρίζετον|ὀάριζε
ἐπιθρῴσκω|ἐπιθρῴσκων
ἀναμάσσω|ἀναμάξεις
δίζω|δίζε
οἰδέω|ᾤδεε
ἄλθομαι|ἄλθετο
κλέπτω|ἔκλεψεν|κλέπτε|κλέψαι|ἔκλεψε
ἐπικείρω|ἐπέκερσε
μειδιάω|μειδιόωσα|μειδιόων
κέλομαι|ἐκέκλετο|κέλετ̓|κέλεται|κέλεαι|κέλεταί|κελήσεται|κελοίμην|κελόμην|κελέσθω|κέλονται|κέλεσθε|κέκλοντο|κέλεαί|κεκλόμενος|κεκλόμενοι|κέλῃ|κέκλετο|κέλομαι|κέλεσθαί|κέκλετ̓|κέκλεθ̓|κέλετο
διαφαίνω|διεφαίνετο
ὁπλέω|ὥπλεον
ἀράομαι|ἀρησόμεθ̓|ἀρώμενος|ἠρώμην|ἠρήσαντο|ἀρήσετ̓|ἠρήσατο|ἠρᾶτ̓|ἠρῶ|ἀρήμεναι|ἀρήσῃ|ἀρησαίατ̓|ἀρήσασθαι|ἀρᾶται|ἠρᾶτο|ἠρᾶθ̓
ἀνερείπομαι|ἀνηρείψαντο
ἐπίκειμαι|ἐπέκειντο|ἐπικείσετ̓
χανδάνω|κεχανδότα|χείσεται|χάνδανεν|χαδέειν|ἔχαδε|ἐχάνδανον|κεχάνδει|χάδε
διψάω|διψάων
ὀλιγηπελέων|ὀλιγηπελέων|ὀλιγηπελέουσά
βρίθω|βριθομένη|ἔβρισαν|βρίθῃσι|βρίσαντες|βεβριθυῖα|βέβριθε|βρίθουσαν|βεβρίθει|βεβρίθασιν|βρίσας|βρῖθον
ὑποδρώω|ὑποδρώωσιν
ὑπομνάομαι|ὑπεμνάασθε
προσαραρίσκω|προσαρηρότα
σχίζω|ἔσχισεν
καταλέγω|κατέλεκτ̓|καταλέγμενος|κατάλεξαι|κατάλεξον|κατέλεξε|καταλέξεται|καταλέξω|καταλέξαι|κατέλεξας|κατελέξατο|κατέλεκτο|κατέλεξα|καταλέξῃ|καταλέξῃς|κατέλεξεν|καταλέξομεν|καταλέχθαι
διαθειόω|διεθείωσεν
καταθέλγω|κατέθελξεν
ἕλκω|ἕλκητον|ἕλκωσ̓|ἑλκέμεν|ἑλκόντων|ἕλκετ̓|ἕλκεσθαι|ἕλκον|ἑλκόμενα|ἕλκομεν|ἑλκόμενον|ἕλκει|ἕλκεται|ἕλκῃσιν|ἑλκομενάων|ἕλχ̓|ἕλκων|ἕλκεν|ἕλκ̓|ἑλκομένας|ἕλκοντ̓|ἕλκεο|ἕλκωσι|ἕλκε|ἕλκωμεν|ἑλκόμενος|ἕλκῃ|ἑλκομένοιο|ἑλκέμεναι|ἕλκετο
κραίνω|κρῆνον|κεκράανται|κρανέεσθαι|κραίνουσι|κρηῆναι|κρῆναί|κρηήνατ̓|κρήηνον|ἐκραίαινεν
στρέφω|ἔστρεφε|στρέψαι|στρέφει|στρεφθεὶς|στρέψαν|στρεφθέντι|ἔστρεφον|στρέψαντα|στρέψας|στρεφθέντος|στρέψ̓|στρέψασκον|ἐστρέφετ̓|στρέψεσθ̓|στρεφθέντε|στρέψαντες|στρεφθεῖσ̓|στρέφεται
φέρω|ἐνείκας|οἴσομεν|φέροντας|φέρων|φέρουσιν|οἴσουσιν|οἰσέτω|ἐνείκατε|ἤνεικαν|φέρεις|ἔνεικεν|οἰσομένη|οἴσετον|οἴσει|οἴσουσ̓|οἴσων|φέρε|φέρεσκον|ἔνεικε|φέρωμαι|ἐφέροντο|ἐνείκῃ|φερέσθων|ἐφέροντ̓|οἶσε|φεροίμην|φερέμεν|φέρῃ|οἰσόμενος|φέρῃσι|φέροι|φέροιεν|φέροντο|φέρονται|ἔφερον|οἴσεται|οἴσεσθαι|φέροις|ἐνείκαι|φέρητον|φέρειν|φερέτην|φερόμην|φέροντα|φέρηται|φερώμεθα|ἐνεῖκαι|φέρομεν|πέροντες|φερέτω|φέρουσαι|ἔνεικαν|φέρεσθαι|οἴσω|ἔφερεν|οἴσουσι|φέρεται|φέροιτο|φέρωμεν|ἐνείκω|φέρεν|φέρον|ἤνεικεν|φέροιο|ἠνείκαντο|φέρω|φέρετ̓|φέρτε|φέῤ|φέρουσα|φέροντες|φέρῃσιν|ἐνείκαμεν|φέρει|φέρεσκε|οἴσετε|φερέσθω|οἴσῃ|οἰσέμεν|οἰσέμεναι
ἐπιπέλομαι|ἐπιπλόμενον
πυρπολέω|πυρπολέοντας
περίκειμαι|περίκειτο|περίκειται|περικείμενον
ἐπιβρίθω|ἐπιβρίσῃ|ἐπιβρίσειαν|ἐπέβρισαν
ὀκνέω|ὀκνείω|ὄκνεον
ποντοπορέω|ποντοπορούσης
ἐπαμείβω|ἐπαμείψομεν|ἐπαμείβεται
ἀρόω|ἀρηρομένῃ|ἀρόωσιν
ἀφαμαρτάνω|ἀφαμαρτούσῃ|ἀπήμβροτεν|ἀφάμαρθ̓|ἀφάμαρτε|ἀφάμαρτεν|ἀπήμβροτε
ὑποπίπτω|ὑποπεπτηῶτες
ἐξαγορεύω|ἐξαγόρευεν
ἐπικέλλω|ἐπικέλσαι|ἐπικέλσαντας|ἐπέκελσεν
δρέπω|δρεψάμενοι
ἐπιπωλέομαι|ἐπεπωλεῖτο|ἐπιπωλεῖται
κελευτιάω|κελευτιόων|κελευτιόωντ̓
ὑποθερμαίνω|ὑπεθερμάνθη
τιθαιβώσσω|τιθαιβώσσουσι
μιμνήσκω|μέμνηντο|μνήσατο|ἔμνησας|μέμνῃ|μνησαμένοις|μιμνήσκοιτο|μιμνησκόμενος|μνησαμένω|μιμνήσκοντο|μνῆσαι|μεμνημένον|μέμνηται|μνήσασα|μνησώμεθα|μνήσατ̓|μεμνημένοι|μέμνημαι|μέμνησαι|μνήσασθε|μεμνημένος|μιμνήσκεσθαι|μνησαίαθ̓|μεμνέῳτο|μεμνῆσθαι|μνήσονται|μνήσομαι|μνησόμεθ̓|μνησάσκετο|μεμνήσεσθαι|μνησόμεθα|μνήσαιτο|μεμνώμεθα|μνήσει|μνησαμένη|μιμνήσκεται|μνήσεσθαι|μνήσασθαι|μνήσαντο|μνησθῆναι|μεμνήσομ̓|μίμνησκ̓|μεμνημένη|μνησάσθω|μιμνήσκεο|μέμνητ̓|μνήσῃ|μνησαίατο|μνησαμένῳ|μνησάμενος|ἐμνήσατο|μνησάμενοι|μνήσω|μέμνηαι|μεμνῄμην|μιμνησκόμεναι
ἀπορρίπτω|ἀπορρῖψαι|ἀπορρίψαντα
τερσαίνω|τέρσηνε
προθρώσκω|προθορὼν
σαίνω|σαίνοντάς|σαῖνον|ἔσηνε|σαίνωσ̓
ἐπερύω|ἐπέρυσσε
ἐκφύω|ἐκπεφυυῖαι
ἀποφθινύθω|ἀποφθινύθουσι
διατμήγω|διέτμαγεν|διατμήξας|διέτμαγον
χρῄζω|χρηΐζεις|χρηΐζοντα|χρηίζοντι|χρηΐζων
ἀίω|ἀΐοιεν|ἀΐοντι|ἀΐοντες|ἄϊεν|ἀίεις|ἀίοντες|ἄϊε|ἄϊον|ἀΐεις|ἀΐων|ἀΐουσα
χάζω|κεκαδήσει|χάζετ̓|χάσσονται|χαζώμεσθα|χαζώμεθ̓|χάζετο|χάζεσθαι|κεκαδὼν|κεκάδοντο|χάζονθ̓|χασσάμενος|ἐχάζετο|χάσσατ̓|χάζεσθε|χάζεο|χάζοντο|χάσσασθαι
πτύω|πτύοντα
κτερίζω|κτεριοῦσιν|κτεριοῦσί|κτεριῶ|κτερίσειεν|κτερίσαιεν
μύρω|μύρονται|μυρομένη|μύρονθ̓|μυρομένους|μυρομένω|μυρόμενόν|μυρομένοισι|μυρόμενοι|μυρομένοισιν
τέλλω|ἔτελλε|ἐτέταλτο|τελέω|τέταλτο|ἔτελλεν
περιδύω|περίδυσε
ὀπιπτεύω|ὀπιπεύεις|ὀπιπεύσεις|ὀπιπεύσας
σκέπτομαι|σκέπτετ̓|σκεψάμενος|σκέπτεο
προσφωνέω|προσεφώνεεν|προσεφώνεε|προσεφώνεον
ἐρείδω|ἐρειδομένω|ἐρεισθεὶς|ἐρεισθείς|ἐρείσας|ἐρηρέδαται|ἐρειδόμενος|ἐρηρέδατ̓|ἐρεῖσαι|ἔρειδε|ἐρείδοντες|ἐρείσατο|ἠρήρειστο|ἐρείδεσθον|ἐρείδουσαι|ἔρεισε|ἐρείσθη|ἐρειδόμενοι|ἐρεισάμενος
ἐπαλλάσσω|ἐπαλλάξαντες
ὑπεμνήμυκε|ὑπεμνήμυκε
ἐπιτλῆναι|ἐπιτλήτω
εἴλω|εἰλόμενοι|ἀλέντων|εἰλεῦντα|ἀλήμεναι|ἔλσας|ἔλσαι|ἀλὲν|εἰλομένων|εἰλεῦντο|εἰλέωσιν|ἄλεν|ἀλέντες|ἀλείς|εἴλει|ἐέλμεθα|ἐέλσαι|εἴλεον|ἀλεὶς|ἐελμένοι|ἐάλη|ἀλῆναι|ἔλσαν|ἐελμένος
ἐντρέπω|ἐντρέπεται
καταδημοβορέω|καταδημοβορῆσαι
προβλώσκω|προμολὼν|προμολών|προμολοῦσα|προβλώσκειν|πρόμολον|πρόμολ̓|προβλωσκέμεν
διοπτεύω|διοπτεύσων
ἀποτρέπω|ἀπετρωπῶντο|ἀποτρεπέτω|ἀπετράπετ̓|ἀποτρέψεις|ἀπέτραπε
ἐνόρνυμι|ἐνῶρσεν|ἐνῶρσας|ἐνῶρτο|ἐνόρσας
ἀρτύω|ἤρτυε|ἀρτύει|ἤρτυον|ἤρτυεν
ἐνορούω|ἐνορούσῃ|ἐνόρουσ̓|ἐνόρουσε
ἐφοπλίζω|ἐφοπλίσσαντες|ἐφοπλίσσουσιν|ἐφοπλίσαι|ἐφοπλίσσαι|ἐφοπλισόμεσθα|ἐφοπλίζωμεν|ἐφοπλίσσωσι|ἐφοπλίσσαιτε|ἐφοπλίσσειας
ἀποξύνω|ἀποξῦναι|ἀποξύνουσιν
ἐπαμάω|ἐπαμήσατο
ἀπεμέω|ἀπέμεσσεν
ἀτέω|ἀτέοντα
διαχέω|διέχευαν
περιστέφω|περιστέφει
θυόω|τεθυωμένον
ὑποδέχομαι|ὑπεδέξατο|ὑπέδεκτο|ὑποδέχθαι|ὑποδέξομαι|ὑποδέγμενος|ὑπέδεξο|ὑποδέξεαι
διαμάω|διάμησε
παραλέγω|παρελέξατο|παρκατέλεκτο|παραλέξομαι
κατασχεθεῖν|κάσχεθε
κατακτείνω|κατακτείνειε|κατέκτανε|κατακτάμεναι|κατέκτανεν|κατεκτάνομεν|κατακτείνῃ|κατακτανέουσιν|κατακτείνει|κατακτεῖναι|κατακτείνας|κατακτενέεσθε|κατακτάμενος|κατέκταθεν|κατέκταν|κατακτάμεν|κατακτείνωσι|κατακτάς|κατέκτανον|κατακτὰς|κατακτείναντα|κατακτενεῖ|κατακτάνῃ|κατακτείνειεν|κατέκτα|κάκτανε|κατέκτανες|κατακτείνειν|κατάκτανε
ἔρδω|ἕρδομεν|ἔρξω|ἐρξέμεν|ἐοργώς|ἕρδειν|ἔρδουσα|ἕρδοι|ἔρδεσκες|ἕρξῃς|ἔρξον|ἔρδ̓|ἕρδον|ἕρξον|ἔρξαιμι|ἔρξανθ̓|ἔρδειν|ἕρδ̓|ἔρξαι|ἔρξῃς|ἕρδεσκεν|ἔρδοι|ἔοργας|ἔρξασα|ἔρξε|ἐώργει|ἐοργὼς|ἕρξαντα|ἔρδωμεν|ἔοργε|ἔρξ̓|ἔρξασ̓
ὀπτάω|ὤπτησαν|ὤπτησε|ὤπτησάν|ὄπτησάν|ὤπτων|ὀπτήσαντες|ὀπτῆσαι|ὀπτήσας|ὀπτῆσαί|ὀπτηθῆναι
συμπήγνυμι|συνέπηξεν
περιγνάμπτω|περιγνάμπτοντα
ἀμφιπένομαι|ἀμφιπένονται|ἀμφεπένοντο
μεταφράζω|μεταφρασόμεσθα
ἐνδείκνυμι|ἐνδείξομαι
ἀπόμνυμι|ἀπώμνυεν|ἀπώμνυον|ἀπώμνυ|ἀπώμοσα
πέπνυμαι|πεπνυμένω|πεπνυμένε|πεπνυμένον|πεπνυμένα|πεπνυμένῳ|πεπνυμένος|πέπνυσαί|πέπνυσο
λίσσομαι|λισσόμενος|λίσσεσθαι|λίσσηαι|λίσσονθ̓|λίσσεο|ἐλλισάμην|λισσομένη|λίσσεθ̓|λιτέσθαι|λίσσοιτ̓|λίσσομ̓|λισσομένους|λίσσοιτο|λιτοίμην|ἐλλίσσονθ̓|λίσσοντ̓|λίσσομαι|ἐλλίσσεθ̓|λίσσοντο|λισσομένῳ|λίσαι|λίσσεται|λισσομένω|ἐλίσσετο|λίσσετο|λίσσετ̓|λισσόμενοι|ἐλλίσσετο|λισσέσκετο|λίσσεαι|λίσσονται|λίσῃ|λίσσωμαι|λίσσωμ̓|λίσσεσθ̓
ὄρομαι|ὄροιτο|ὄρονται|ὄροντο
ἐπιγνάμπτω|ἐπιγνάμψασα|ἐπιγνάμψας|ἐπιγνάμπτει|ἐπέγναμψεν
μεταβαίνω|μετάβηθι
δίζημαι|διζημένη|διζησόμεθ̓|διζήμενος|δίζηαι
ἕπομαι|ἑπέσθην|ἑπέσθω|ἕποντο|ἑσπομένοιο|ἕπεο|ἕψεται|ἕπεσθον|ἕπονται|σπεῖό|ἕπευ|σπέσθαι|ἕπουσαν|ἑπόμεσθα|ἕσπεο|ἑσπέσθην|εἵπετ̓|σπέσθω|ἑψόμεθ̓|ἕποιθ̓|ἕποιτο|ἑπώμεθ̓|ἕπεσθαι|ἕσπωνται|εἵποντο|ἕπετον|ἕψομαι|ἕπωμαι|ἕψομ̓|ἕπετο|ἕσπετο|εἵπετο|ἕψεαι|ἑπέσθων|ἕπηται|ἕπεται|ἑπόμην|ἑσπόμεθ̓|ἕπετ̓|ἕπἐ|ἕπεθ̓|ἕποιο|ἑσποίμην|ἕψεσθαι|ἕσπετ̓|ἕποντ̓|ἕποιεν|ἑποίατο|ἑσπόμενος|ἕπονθ̓|ἕψονται|ἕπει
ἄγω|ἄξοντ̓|ἄξεσθε|ἠγάγετο|ἄγοντα|ἄγαγον|ἀγοίμεθα|ἄξομαι|ἀγάγω|ἄξεθ̓|ἤγετο|ἀγάγῃ|ἀξέμεναι|ἄγοντι|ἀγάγωμεν|ἄγαγ̓|ἀγαγόντες|ἤγαγεν|ἄγαγε|ἄγαγεν|ἦγε|ἀγέτην|ἄγον|ἄξομεν|ἀξέμεν|ἄγοιμ̓|ἄξει|ἠγάγεθ̓|ἄγηται|ἄγῃσι|ἄγοντε|ἦγον|ἄγω|ἀγαγέσθαι|ἄγειν|ἄγωμεν|ἄγῃ|ἄξετε|ἄγουσι|ἄξοντα|ἄγ̓|ἄγων|ἤγαγον|ἀγάγῃσιν|ἀγάγωμι|ἀγέσθω|ἀγαγόνθ̓|ἄγεται|ἠγαγόμην|ἦγεν|ἄγει|ἄγεις|ἦγ̓|ἄξεσθαι|ἀγαγοῦσα|ἄξεις|ἄγοιμι|ἤγετ̓|ἄξω|ἄγεν|ἀγόμην|ἀγάγοι|ἄγοιεν|ἄξοντο|ἤγαγ̓|ἄγοι|ἀγέμεν|ἄγοιτο|ἄγουσιν|ἄγωνται|ἄγωμαι|ἀγάγηται|ἤγαγε|ἀγέτω|ἄγοντες|ἄγωσι|ἄγουσαι|ἄγεσθαι|ἤγαγες|ἀγαγὼν|ἄγησι|ἤγομεν|ἄξειν
ἐκδέω|ἐκδῆσαι|ἔκδεον
ἐπιμήδομαι|ἐπεμήδετο
ὁμοστιχάω|ὁμοστιχάει
ἀναμετρέω|ἀναμετρήσαιμι
μυθολογεύω|μυθολογεύω|μυθολογεύειν
ὑποχωρέω|ὑπεχώρει|ὑπεχώρησαν
ἐπιπέτομαι|ἐπιπτέσθαι|ἐπέπτατο
καθιζάνω|καθίζανον
βιάζω|βιάζεται|βιάζετε|βιάζετο|βιαζόμενον
πολεμίζω|πολεμίζειν|πτολεμίξω|πολεμίζομεν|πολεμιζέμεναι|πολεμίζοι|πολέμιξον|πτολεμίξων|πολέμιζον|πολεμίζει|πτολεμίξομεν|πολεμίζετε|πολεμιζέμεν|πολέμιζε|πολεμίζῃ|πολεμίζων|πτολεμίζειν|πολεμίξειν|πολεμίξομεν|πολεμίζω|πολεμίξων
κατάγνυμι|κατέαξε|κατεάξαμεν
διωθέω|διῶσεν
βάλλω|βεβλήκοι|ἔβαλε|βαλλομένοισιν|ἐβάλλετο|βάλωμεν|βέβλητο|βαλῶ|βαλέω|ἔβαλ̓|βαλλομένων|βαλοῦσαι|βάλλετ̓|βάλλουσι|βαλλόμεν̓|βεβλήκειν|βαλλόμενος|βάλλει|βαλόντες|βεβλημένος|βέβληαι|βλήμενος|βάλοισθα|βαλοῦσ̓|βαλούσας|ἐβάλοντο|βάλλονθ̓|ἔβαλες|βάλλεαι|βαλεῖν|βλημένου|ἔβαλλον|ἔβαλέν|ἔβαλλε|βλήεται|βάλλ̓|βάλεν|ἔβλητ̓|βάλλομεν|ἔβαλεν|βεβλημένον|ἔβαλλεν|βεβλήκει|βάλλετο|βάλῃ|βάλλουσιν|βαλὼν|βλημένῳ|βάλλευ|βαλόντε|βάλλον|βεβλήαται|βαλλομένοιο|βάλω|ἔβαλόν|βλῆτο|βλεῖο|βάλλετε|βαλλομένη|βάλῃσι|βάλοι|βλήμενον|βάλλειν|βάλετο|βάλλονται|βαλών|βάλοιμι|βέβληται|βάλες|βαλέει|βαλέειν|βάλε|βαλέοντι|βαλόμην|βεβλήατο|βάλῃσθα|βάλλωσι|βαλόντας|βάλετ̓|βάλλων|βάλῃσιν|βαλὸν|βεβλημένοι|βάλον|ἔβαλον|βάλ̓|βαλέτην|βαλλόμενα|βάλλοντες|βάλλε|βάληται|ἔβλητο|βλῆσθαι|βάλλεν|βάλλεο
ὑλάω|ὑλάει|ὕλαον|ὑλάοντο|ὑλάουσιν
ἀποτίνω|ἀποτισέμεν|ἀποτίσεται|ἀπετίνυτο|ἀπέτισεν|ἀποτίσομαι|ἀποτίσῃ|ἀποτινέμεν|ἀπέτισαν|ἀποτίσεις|ἀποτίνετον|ἀποτίσας|ἀποτινύμενοι|ἀποτείσομεν|ἀποτίνειν|ἀποτῖσαι|ἀπετίσατο|ἀποτίνων|ἀποτίσεαι
διασχίζω|διέσχισεν|διεσχίσθη
τύφω|τύψεν
ἰθύνω|ἰθυνθήτην|ἴθυνε|ἰθύνοι|ἰθύνετο|ἰθυνομένων|ἰθύνει|ἰθύνετε|ἰθύνομεν|ἰθύνεις|ἴθυνον|ἴθυνα|ἴθυνεν
ἐξικνέομαι|ἐξικόμην|ἐξίκετο
ἐπιθρώσκω|ἐπιθρῴσκουσι
ὑπεκπρορέω|ὑπεκπρόρεεν
προσαυδάω|προσηύδα|προσηύδων|προσαυδάτω|προσαυδήτην
ἀποβρίζω|ἀποβρίξαντες
προκαθίζω|προκαθιζόντων
φυλάζω|φυλάξομεν
λάζομαι|λαζοίατο|λέλασται|λελασμένος|λελασμένον|λελάσμεθα|ἐλάζετο|λάζετο
ἐπικεύθω|ἐπίκευθε|ἐπικεύσω|ἐπικεύσῃς
κατερύω|κατειρύσθαι|κατείρυσεν|κατείρυσται
κοναβίζω|κονάβιζεν|κονάβιζε
γαίω|γαίων
ἀμάω|ἀμῷεν|ἤμων|ἀμήσαντες|ἀμησάμενος
περικήδομαι|περικήδετο
ναρκάω|νάρκησε
ἀλαλύκτημαι|ἀλαλύκτημαι
παιφάσσω|παιφάσσουσα
ἔλδομαι|ἔλδεται|ἐελδόμενός|ἐελδέσθω|ἐελδομένοισι|ἐελδομένῳ|ἐέλδετο|ἔλδεαι|ἐελδόμενος|ἐελδομένοισιν|ἐέλδεται|ἐλδόμεναι|ἐέλδεαι|ἐέλδομαι
ταρχύω|ταρχύσωσι|ταρχύσουσι
κάμπτω|ἔκαμψε|κάμψῃ|κάμψειν|ἔκαμψαν
σώζω|σαωσέμεν|σαώσῃ|ἐσάωσαν|σαώσει|σαώσομεν|σαώσατε|σαῶσι|ἐσάωθεν|σαώσω|ἐσάωσ̓|σαώσειαν|σάωσε|σαώσεις|σαώσετε|σαῶσαι|σαώσῃς|ἐσάωσε|σαωθήτω|σώζων|σάωσας|σάωσον|σαωσέμεναι|σαώσειας|σαωθῆναι|ἐσάωσεν|ἐσάωσα|σαῷ|σαώσετον|σαώσαι|σαώσεαι|σάω|σαῷς
μεθορμάομαι|μεθορμηθεὶς
ἀποψύχω|ἀποψυχθεὶς|ἀπεψύχοντο|ἀποψύχοντα
ἐρεείνω|ἐρεείνεις|ἐρεείνετο|ἐρέειν̓|ἐρέεινον|ἐρέεινεν|ἐρέεινε
ἄγαμαι|ἀγασσάμενος|ἄγασθε|ἀγάσαντο|ἀγάσησθε|ἀγασσάμεθ̓|ἀγάασθε|ἠγάσσατο|ἀγάασθαι|ἄγαμαι|ἠγάασθε|ἀγάσσατο|ἀγάσασθαι|ἀγάσσεσθαι|ἀγασσάμενοι|ἄγαμαί
ἐντανύω|ἐντάνυσε|ἐντανύσαι|ἐντανύειν|ἐντανύσειεν|ἐντανύουσιν|ἐντανύσῃ|ἐντανύσειν|ἐντανύεσθαι|ἐντανύσασθαι|ἐντανύσῃς
ὁρμαίνω|ὅρμηνεν|ὥρμαιν̓|ὁρμαίνοντα|ὁρμαίνων|ὁρμαίνοντας|ὁρμαίνουσαν|ὥρμηναν|ὁρμαίνοντες|ὁρμαίνουσ̓|ὁρμαίνοντι|ὥρμαινε|ὅρμαινε|ὁρμαίνοντ̓
ἡβάω|ἡβήσῃ|ἡβήσαντε|ἡβῶν|ἡβώωσα|ἡβώοντα|ἡβῷμ̓|ἡβώοιμι|ἡβήσας|ἡβώοντες
βράσσω|ἔβραχε
ἡγεμονεύω|ἡγεμονεύῃς|ἡγεμονεύειν|ἡγεμόνευεν|ἡγεμονεύσει|ἡγεμονεύσω|ἡγεμόνευε|ἡγεμονεύῃ|ἡγεμόνεὐ|ἡγεμονεύει
ἀναπρήθω|ἀναπρήσας
ὑποφαίνω|ὑπέφηνε
σκιάω|σκιόωντό
δείλομαι|δείλετό
ἀπανύω|ἀπήνυσαν
ἀπογυιόω|ἀπογυιώσῃς
μετοίχομαι|μετῴχετο|μετοιχόμενος|μετοιχομένη
κελεύω|ἐκέλευσαν|κελεύοι|κελεύῃς|ἐκέλευες|κέλευεν|κελεύσας|κελεύοντος|ἐκέλευον|κέλευσον|κελεύω|κέλευε|κέλευσε|κελεύετε|κελεύετέ|κελευσέμεναι|ἐκέλευσα|ἐκέλευσεν|κελεύων|κελεύει|κέλευσεν|κελεύσω|κέλευον|κέλευσέ|ἐκέλευσε|κελεύομεν|ἐκέλευεν|ἐκέλευσ̓|κέλευέ|κελεύεις|ἐκέλευε|κέλευσαν|κέλευσας
πενθέω|πενθῆσαι|πενθήμεναι|πενθείετον
ἐκπροκαλέομαι|ἐκπροκαλεσσαμένη
ἰαίνω|ἰαίνει|ἰαίνετο|ἰήνατε|ἰάνθη|ἰαίνομαι|ἰανθῇ|ἰάνθης|ἰήνῃ|ἰανθῇς|ἰαίνεται
ἐπιρρέζω|ἐπιρρέζεσκον
ἐπιμίσγω|ἐπιμισγομένων|ἐπιμίσγεται|ἐπιμίσγομαι
ἐπισείω|ἐπισσείῃσιν|ἐπισσείων
περιπροχέομαι|περιπροχυθεὶς
πίνω|πίνειν|πίνετο|πιόμεν̓|πίνουσιν|πίνοντέ|πίνῃ|ἔπινον|πῖνέ|πίον|πίνετε|πινόντων|πίνοντ̓|πίεν|πίνουσαι|πίνοιεν|πίοιμι|ἔπινεν|πίνοντας|πίνετ̓|πινέμεναι|πιέειν|πίνουσ̓|πίε|πῖνε|πιόμενος|πίνουσί|πίοι|πιόντες|πίοιεν|πινομένοιο|πιὼν|ἔπιόν|ἔπιον|πίνοντά|πινέμεν|πίῃσθα|πιοῦσα|πίνοντες|πίῃ|πίω|πίνων|πίνεσκεν|πίνωσιν|πιέμεν|πιεῖν|ἔπιεν
καταχεύω|κατέχευε|καταχεύῃ|κατέχυνθ̓|κατέχευαν|κατέχευεν|κατέχευας|καταχεῦαι
στίλβω|στίλβων|στίλβοντας
ταρβέω|ταρβεῖ|τάρβει|ταρβήσαντε|ταρβήσειεν|ταρβεῖς|τάρβησέν|ταρβήσας|τάρβησαν
παραπνέω|παραπνεύσῃ
μιστύλλω|μίστυλλε|μίστυλλόν|μίστυλλέν
σμύχω|σμῦξαι|σμύχοιτο
γλαυκιάω|γλαυκιόων
κήδω|κηδέσκετο|κήδειν|κήδονται|κήδετο|κηδόμενός|κήδει|κῆδε|κηδήσοντες|κηδομένῳ|κήδεαι|κήδων|κηδομένη|κήδεται|κηδόμενόν|κήδεσκον|κήδοι|κήδεσθαι|κήδοιτό|κηδόμενοί|ἔκηδε|κήδοντο|κήδῃ|κεκαδησόμεθ̓
παρέρχομαι|παρέλθῃ|παρελθέμεν|παρέλθοι|παρερχομένην|παρέρχεται|παρελεύσεαι|παρῆλθε
ἀπογυμνόω|ἀπογυμνωθέντα
ἥδομαι|ἥσατο
ἐράω|ἐράασθε
διαίνω|ἐδίην̓|δίαινε|διαίνετο|ἐδίηνε
παπταίνω|παπταίνοντι|παπταίνων|παπτήνασ̓|παπταίνετον|παπτήναντα|παπταίνοντε|παπτήνας|παπτήνασα|παπταίνοντες|πάπτηνεν
ὑφίστημι|ὑπέστης|ὑποστὰς|ὑποστήτω|ὑπέσταν|ὑποσταίη|ὑπέστη|ὑπέστημεν|ὑπέστην
ζώω|ζώεις|ζώουσ̓|ἔζωον|ζώουσι|ζωέμεναι|ζώοντε|ζώει|ζώοντος|ζωόντων|ζωέμεν|ζώοντες|ζώουσιν|ζώω|ζώειν|ζώοντός|ζώοντας
ἐκπρολείπω|ἐκπρολιπόντες
ἀναθηλέω|ἀναθηλήσει
ἀμφιέπω|ἄμφεπεν|ἄμφεπε|ἄμφεπον|ἀμφιέποντες|ἀμφίεπον
ἀμφιάχω|ἀμφιαχυῖαν
ἀγοράομαι|ἀγορήσατο|ἠγορόωντο|ἀγοράασθε|ἠγοράασθε
ἐπιλήθω|ἐπελήθετο|ἐπέλησεν|ἐπιλήσονται|ἐπιλήσεται|ἐπιλήσομαι
ἀναφέρω|ἀνένεικα|ἀνενείκατο
λούω|λόεον|λοεσσάμεναι|λοεσσάμενος|λοῦσαν|λοέσσας|λοεσσάμενός|λό̓|λούεσθαι|λοῦσον|λούσαντο|λοῦσάν|λούσασθαι|λοῦσ̓|λοῦσαι|λούσασα|λούσαιτο|λοῦσέν|λοέσσατο|λελουμένος|λοέσσαι|λούσασθε|λοῦσεν|λοῦσθαι|λούσατέ|λοεσσαμένω|λούσῃ|λούσειαν|λοέσσομαι
ὑπαίσσω|ὑπαΐξει|ὑπαΐξας
ἐρύκω|ἐρύκεται|ἔρυξον|ἐρύκων|ἔρυξαν|ἔρυκε|ἐρύκεαι|ἐρυκάκοι|ἐρύκακεν|ἐρύκει|ἐρύξομεν|ἔρυξα|ἔρυκεν|ἠρύκακε|ἐρύξω|ἐρύκομαι|ἐρύξει|ἐρυκάκετε|ἐρύκοι|ἐρυκόντων|ἐρύκακε|ἐρύκεις|ἐρύκεσθαι|ἐρύξας|ἔρυξε|ἐρύκω|ἐρυκακέειν|ἐρύκεσθον|ἐρυκέμεν
κυδοιμέω|κυδοίμεον|κυδοιμήσων
χρεμετίζω|χρεμέτιζον
ἐκλύω|ἐξελύθη|ἐκλύσομαι
κονίω|ἐκόνισε|κεκόνιτο|κονίσουσιν|κεκονιμένοι
ἐπαφύσσω|ἐπήφυσεν
κατευνάω|κατευνήσαιμι|κατευνηθέντα|κατευνήσαιμ̓
ὑποτίθημι|ὑποθήσεται|ὑποθήσομαι|ὑποθέσθαι|ὑποθησόμεθ̓|ὑποθήσεαι|ὑπόθευ
καίνυμαι|κέκαστο|κέκασται|κεκάσθαι|κεκάσμεθα|ἐκέκαστο|κεκασμένε|κεκασμένον|ἐκαίνυτο|κέκασσαι
ἰνδάλλομαι|ἰνδάλλεται|ἰνδάλλετο
κιρνάω|κιρνὰς|ἐκίρνα|κίρνη
καταγινέω|καταγίνεον
λελίημαι|λελιημένοι|λελιημένος
αὐχμέω|αὐχμεῖς
ἐρυκανάω|ἐρύκανε|ἐρυκανόωσ̓
ἀπείργω|ἀποέργει|ἀπέεργεν
κατίσχω|κατισχέμεναι|κατίσχεαι|κατίσχει|καταΐσχεται
ἐπικόπτω|ἐπικόψων
εἰλαπινάζω|εἰλαπινάζων|εἰλαπινάζουσιν
σιφλόω|σιφλώσειε
παραμίμνω|παραμίμνων|παρέμιμνεν
καταθάπτω|καταθάπτειν|κατθάψαι
μέλδομαι|μελδόμενος
βαρέω|βεβαρηότα|βεβαρηότες
στροφαλίζω|στροφαλίζετε
ἀπολυμαίνομαι|ἀπολυμαίνεσθαι|ἀπελυμαίνοντο
ἐξεῖπον|ἐξείποι|ἐξείπω|ἐξείπῃ
συνθέω|συνθεύσεται
ἀποπτύω|ἀποπτύει|ἀποπτύων
ἐκβαίνω|ἔκβητ̓|ἐκβήσαντες|ἐκβὰς|ἐκβάντες|ἐκβαίνοντα
νέω|ἔννεον|νήσαντο
δακρύω|δεδάκρυσαι|δάκρυσα|δακρύσαντας|δεδάκρυνται|δακρύσας|δακρύσασα
ἐχθαίρω|ἐχθήρειε|ἐχθαίρουσ̓|ἐχθαίρῃσιν|ἤχθηρε|ἐχθαίρῃσι|ἔχθηρε|ἔχθαιρε
κτερείζω|κτερεΐξω|κτερεϊζέμεν|κτερέϊζε
ὀρέγω|ὀρεξάσθω|ὀρέγων|ὀρέξειν|ὀρωρέχατο|ὀρωρέχαται|ὀρέξῃς|ὠρέξαθ̓|ὀρέγοντας|ὀρέξειαν|ὀρέξῃ|ὤρεξε|ὀρέξω|ὀρεξαμένη|ὠρέξατο|ὀρέξατο|ὀρεξάμενος|ὀρέξατ̓|ὀρέξομεν|ὀρέξασθαι|ὀρέξαι|ὀρέγεσθαι|ὄρεξας
συναιρέω|σύνελεν|συνελὼν
ἐπαρήγω|ἐπαρήγειν|ἐπαρήγοις|ἐπαρήγει
δάκνω|δάκε|δακέειν
κλύω|ἔκλυεν|κέκλυτέ|κλῦθί|ἔκλυε|κέκλυτε|ἔκλυες|κλῦτε|ἔκλυον|κλῦθι|κλύον|κέκλυθι|κλῦτέ
προτύπτω|προὔτυψαν|προὔτυψε
δέψω|δεψήσας
ὑπερωέω|ὑπερώησαν
ἐξαναβαίνω|ἐξαναβᾶσαι
μεθύω|μεθύουσαν|μεθύοντι
γανόω|γανόωντες
κοιρανέω|κοιρανέοντα|κοιρανέουσι|κοιρανέων|κοιρανέουσιν
σκάλλω|σκήλεἰ
ὀδύρομαι|ὀδυρομένοισι|ὀδύρομαι|ὀδυρομένη|ὀδύρεται|ὀδύρετο|ὀδυρομένοισιν|ὀδυρομένην|ὀδυράμενος|ὀδυρομένῃ|ὀδύρονταί|ὀδύρεο|ὀδύροντο|ὀδύρονται|ὠδύροντο|ὀδύρεαι|ὀδυρομένῳ|ὀδυρόμενοι|ὀδυρόμενον|ὀδυρόμενος
κουρίζω|κουρίζων
ἐπιλεύσσω|ἐπιλεύσσει
παρανήχομαι|παρανήξομαι
βαίνω|ἔβημεν|βάντες|βαῖνε|βέβασαν|βαῖνον|βήσεται|ἔβη|βαῖν̓|βήσομεν|βαίνων|βέβηκας|ἔβαινε|βήμεναι|βεβάασι|βῆ|βῶσιν|βεβαώς|βέβηκε|βεβήκει|βῆσεν|ἐβήσαμεν|ἐβήσετο|βάν|βὰν|βαίνομεν|βείω|βάντα|ἐβεβήκει|ἔβησαν|βαινέτω|βήσαμεν|ἔβαιν̓|βάτην|βήτην|βῆναι|βαίνοντ̓|βῆν|βῆσε|βὰς|ἔβαινεν|βάντε|βεβαῶτα|ἐβήτην|ἔβης|βῆμεν|ἔβαινον|βαίην|βεβάμεν|βῆσαν|βάνθ̓|βήσετο|βαίνει|ἔβην|βεβῶσα|ἔβαν
ἑλίσσω|ἑλιξάμενος|ἑλίσσετο|ἑλίξας|ἑλισσόμενος|ἑλίξεται|ἑλισσόμενόν|ἑλιχθέντων|ἑλίσσεται|ἑλισσόμενον|ἑλισσομένη|ἑλισσόμενοι|ἑλισσέμεν
δειπνίζω|δειπνίσσας
ἀλεγίζω|ἀλεγίζω|ἀλεγίζει|ἀλεγίζεις|ἀλέγιζε
ἐκπτύω|ἐξέπτυσεν
στηρίζω|στηρίξασθαι|στήριξε|ἐστήριξε|στηρίξαι|ἐστήρικτο
ὑπάγω|ὕπαγον|ὕπαγε
μιαίνω|μιάνθησαν|μιάνθην|ἐμιαίνετο|μιήνῃ|μιαίνεσθαι
ἀνέζω|ἀνέσαιμι|ἀνέσαντες
δειροτομέω|δειροτομήσεις|δειροτομήσας|δειροτομῆσαι|δειροτομήσει
ῥυστάζω|ῥυστάζοντας|ῥυστάζεσκεν
δίδημι|δίδη|διδέντων
μαντεύομαι|μαντεύεο|μαντεύετο|μαντεύομαι|μαντεύεαι|μαντεύεται|μαντεύσομαι|μαντεύσατο|μαντευόμενος|μαντεύεσθαι
περονάω|περόνησεν|περονᾶτο|περονήσατο|περόνησε
προσαμύνω|προσαμύνομεν|προσαμύνει|προσαμῦναι
ὑπεκπρολύω|ὑπεκπροέλυσαν
ἀποτμήγω|ἀποτμήγουσι|ἀποτμήξαντες|ἀποτμήξας|ἀποτμήξαντε
ἀλείφω|ἀλεῖψαι|ἄλειψ̓|ἀλειψαμένη|ἀλειψαμένω|ἀλείψατο|ἤλειψαν|ἄλειψεν|ἤλειψεν|ἄλειψα
λύω|λύε|ἔλυον|λῦτο|λύσαιτε|λύ̓|λύσασθαί|λύομεν|λῦσεν|λῦσε|λύων|λυσάμενοι|ἐλύσαο|ἔλυεν|λέλυντο|λύθη|λῦσαν|λύσειαν|λυώμεθα|λύσασθ̓|λυόμην|λύμην|λύτο|ἔλυσ̓|λύωμεν|λύον|λύσω|λύθεν|λύντο|ἔλυσαν|λέλυνται|λῦσαι|λέλυται|λύσας|λελῦτο|ἔλυσε|λύσασθαι|ἔλυσα|λυσόμενος|λύσομαι|λύσειεν|λύσῃ|λῦσον|λύσασ̓|λυσόμενός|λῦσαί|λύσει|ἐλύσατο|λύσαθ̓|λύει|λύοντο
ἐξαλαπάζω|ἐξαλαπάξας|ἐξαλαπάξῃ|ἐξαλάπαξε|ἐξαλάπαξαν|ἐξαλαπάξαι|ἐξαλαπάξειν
στέλλω|στείλαντα|στέλλοιμι|στελέω|στεῖλαν|στέλλεσθε|στέλλοντα|στείλαντο|στεῖλα|στέλλοντας
ὑπακούω|ὑπάκουσε|ὑπακοῦσαι|ὑπακούει
φαίνω|φαινομένηφιν|φαινέτω|φανέντα|φανήῃς|φαίνηται|φαίνεις|φαίνεται|φαινομένηφι|φαάνθη|φάνεσκεν|φαῖν̓|φαείνω|φαίνετο|φαίνονθ̓|φάνεν|φανῇ|ἐφαίνετο|φαινομένων|φαίνει|φαῖνε|φαίνοντες|φαίνονται|φάνεσκε|φανεῖσα|φαείνων|φανείη|φαίνετ̓|φανήτω|φάεινε|φανήτην|φάνη|φαίνων|φήνειε|φανεὶς|φανῆναι|ἔφανεν|φάνης|φαίνοντ̓|φάανθεν|φαινέσκετο|φανεῖσθαι|φανήῃ|φαείνοιεν|φήνωσι|ἔφαινον|φαείνοι|ἔφηνε|φαίνεθ̓|φάνημεν|φαινομένη|φανήμεναι|φαινέμεν|πεφήσεται|φάνηθι|ἐφάνη|φαίνεσθαι
θάλπω|θάλπων|θάλποντες
συνάγω|σύναγεν|ξυνάγοντες|ξυνάγωμεν|σύναγον|ξυνάγουσα
πλύνω|πλύνασ̓|πλύνεσκον|πλυνέουσα|πλυνούσῃ|πλῦνάν|πλυνέουσαι
εὐνάζω|εὐνάζοντο|εὐνάζεσθαι|εὐνάζετο|εὐνάσω
ἐξαιρέω|ἐξέλετο|ἔξελε|ἐξέλετ̓|ἐξείλετο|ἐξείλοντο|ἐξέλεθ̓|ἐξελόμην|ἔξελον|ἐξαιρεύμην
ἐγγυάω|ἐγγυάασθαι
ἀτιμάζω|ἀτιμάζοντας|ἀτιμάζοντες|ἀτιμάζεσκε|ἀτιμάζει|ἀτιμάζουσιν|ἀτιμάζουσι|ἠτίμασεν
μετακιάθω|μετεκίαθον|μετεκίαθε
παραείρω|παρηέρθη
ἐπιστέφω|ἐπεστέψαντο
ἀπαίρω|ἀποαίρεο
πάσχω|πάθον|πέποσθε|πάθῃσι|πάσχοντες|πάσχετε|παθέειν|παθών|πάθοι|πάθῃσθα|πάσχουσιν|παθὼν|πάσχειν|πέπονθα|πάθοιεν|πάσχω|πάθωσιν|πάθ̓|πάθῃς|πείσομαι|παθόντα|πάθες|πάσχοντος|πάσχῃ|πεπαθυίῃ|ἔπαθόν|πάθοιμι|παθόντες|πάσχεις|ἐπεπόνθει|πάσχομεν|πέπονθας|πείσεται|πείσεσθαι|παθόντ̓|παθοῦσα|πάθετ̓|πάθομεν|πάθῃ|παθόντε|πάθω|πάσχων|ἔπαθον|πάθοιμεν|πάθῃσιν|πάθωμεν|πάθεν|πάσχωσιν|πάσχει|ἔπασχον
ἀγείρω|ἄγειραν|ἄγειρεν|ἤγειρε|ἄγειρα|ἀγείροντες|ἀγέρθη|ἀγείρω|ἀγέρεσθαι|ἀγρομένῃσι|ἤγερθεν|ἀγέροντο|ἀγείρετο|ἀγειρόντων|ἀγείρων|ἀγηγέραθ̓|ἀγείροι|ἀγείρομεν|ἀγείρας|ἄγερθεν|ἀγειρούσῃ|ἠγείροντο|ἤγειρα|ἀγρόμενοι|ἀγρομένοισι|ἀγρομένων|ἀγρομένοισιν|ἀγρόμεναι|ἀγειρόμενοι|ἀγηγέρατ̓
θεραπεύω|θεράπευον
ἀναχωρέω|ἀναχωρήσουσιν|ἀνεχώρησαν|ἀναχωρήσειν|ἀνεχώρησεν|ἀναχωρείτω|ἀναχωρήσας|ἀναχωρῆσαι|ἀναχωρήσαντα
παππάζω|παππάζουσιν
περιστεναχίζω|περιστεναχίζεται
μεταστένω|μετέστενον
κατασεύομαι|κατέσσυτο
ἴσχω|ἴσχει|ἴσχεσθε|ἴσχεν|ἴσχουσ̓|ἴσχειν|ἴσχε|ἰσχέμεναί|ἰσχέμεν|ἴσχων|ἴσχεο|ἴσχεσθαι|ἴσχον|ἴσχετο|ἴσχωσι|ἴσχεσθ̓
κατακλάω|κατέκλων|κατεκλάσθη
ὑπεκσῴζω|ὑπεξεσάωσεν
τίθημι|ἔθεσαν|θεῖμεν|ἔθηκα|ἐτίθεντο|θέσθαι|τιθεῖσι|θῆκεν|ἔθηχ̓|θέντες|θείην|θήσουσ̓|θέντων|τίθεσθ̓|θέσθω|θήσω|τίθεντο|θήῃ|ἔθηκε|θήῃς|θησέμεναι|θέσθ̓|θήσει|θῇσιν|τίθησι|θῆκαν|τίθησθα|θῆχ̓|θεῖναι|θέσθε|ἔθηκεν|θείης|τίθενται|θείομεν|τιθέντες|τίθει|θέο|θήκατο|θήσειν|θήσετε|θήσονται|ἔθεσθε|τιθέμεσθα|τιθεὶς|θέμενος|θεμένη|θέμεν|θεῖσα|θέσαν|θῆκε|ἔθηκας|θέτ̓|θείῃ|θήσεσθαι|θήσεις|ἔθηκ̓|τιθεῖ|ἔθηκαν|θέωμεν|τίθεσαν|ἔθεμεν|τιθήμενον|θῆκ̓|τιθήμεναι|θεῖεν|θῆαι|ἔθετ̓|ἐτίθει|θεῖτο|θέμεναι|ἔθεντο|θὲς|θείη|θείω|θέτο|τίθεσθε
περιβάλλω|περίβαλλε|περιβάλλει|περιβαλλομένους|περιβάλλετον
προσδέρκομαι|ποτιδέρκεται|προσεδέρκετο
ἀλυσκάζω|ἀλυσκάζων|ἀλυσκάζοντι|ἀλυσκάζω
βρυχάομαι|ἐβεβρύχει|βέβρυχεν|βεβρυχὼς
ἀνώγω|ἠνώγειν
ἐμβασιλεύω|ἐμβασίλευε|ἐμβασίλευεν
σιγάω|σίγα
θάομαι|θησαίατ̓
εἰσείδω|εἰσιδέειν|εἴσιδον|εἰσιδέτην|εἰσίδομεν
ἐξαπόλλυμι|ἐξαπολοίατ̓|ἐξαπόλωλε
ἄχθομαι|ἄχθομαι|ἀχθομένην|ἤχθετο
ἐνικλάω|ἐνικλᾶν
ει´κω|εἴκετε
τροπέω|τρόπεον
μεταφωνέω|μετεφώνει|μετεφώνεε|μετεφώνεεν|μετεφώνεον
ἔλπω|ἔλπετ̓|ἐέλπεται|ἔολπε|ἔλπεται|ἔλποιτο|ἐέλπετο|ἐελποίμην|ἔλπεαι|ἔολπας|ἐώλπει|ἤλπετ̓|ἐλπόμενοι|ἔλπει|ἐλπομένω|ἔλπῃ|ἔολπα|ἐλπόμενος|ἔλποιο|ἔλπομ̓|ἔλπεο|ἐλπόμενον|ἔλπετο|ἔλποντο|ἔλπεσθ̓|ἔλπομαι|ἔλποιτό
εὐφραίνω|εὔφρην̓|εὐφρανέειν|εὐφραίνεσθαι|εὐφρῆναι|ἐϋφρήνῃς|ἐϋφρανέω|ἐϋφραίνοιμι|ἐϋφραίνοιτε
ἀνανεύω|ἀνένευσε|ἀνένευε
μοχθέω|μοχθήσειν
ὀλέκω|ὄλεκον|ὀλέκοντα|ὄλεκεν|ὀλέκουσιν|ὀλέκεσκεν|ὀλέκοντο|ὀλέκοντας|ὀλέκονται|ὀλέκουσι
βιόω|βιῶναι|βιώτω
εἰσθρῴσκω|ἔσθορε
ἡγηλάζω|ἡγηλάζεις|ἡγηλάζει
πομπεύω|πόμπευον
μαίομαι|μαιομένη|μαίεσθαι|μάσσεται
προδαῆναι|προδαεὶς
μερμηρίζω|μερμηρίζει|μερμηρίζω|μερμήριξε|μερμήριζε|μερμήριζεν|μερμηρίζων|μερμηρίζεις|μερμηρίξας|μερμήριξεν|μερμηρίξαι|μερμηρίξω|μερμήριξα|μερμήριζον
ὀιζύω|ὀιζύσας|ὀϊζύσας|ὀΐζυε|ὀϊζύομεν
ἐξαλαόω|ἐξαλάωσε|ἐξαλάωσας|ἐξαλαῶσαι
ἐγκοσμέω|ἐγκοσμεῖτε
θύνω|θύνοντ̓|θῦνον|θυνόντων|θῦνε
προμίγνυμι|προμιγῆναι
λιλαίομαι|λιλαίομαι|λιλαίεο|λιλαιόμενόν|λιλαίεσθαι|λιλαίεται|λιλαιόμενα|λιλαιόμενοι|λιλαίετο|λιλαίεαι|λιλαιομένη
ἀποίχομαι|ἀποιχομένοιο|ἀποίχεται|ἀποίχονται|ἀποιχομένου|ἀποίχεαι
ἐριδαίνω|ἐριδήσασθαι|ἐρίδαινε|ἐριδαίνετον|ἐριδαίνομεν|ἐριδαινέμεν
ληίζομαι|ληίσσατο|ληΐσσατο|ληΐσσομαι
ἐπιρρίπτω|ἐπέρριψαν
ἀνακλίνω|ἀνακλῖναι|ἀνακλίνας|ἀγκλίνας|ἀνακλινθεῖσα|ἀνακλινθεὶς|ἀνακλινθέντες
ὑπόρνυμι|ὑπώρορε
ἐπέοικε|ἐπεῴκει|ἐπέοικεν|ἐπέοικε|ἐπέοιχ̓
ἀπειλέω|ἀπείλεον|ἀπείλησαν|ἀπειλεῖς|ἠπείλει|ἀπειλήτην|ἀπείλησας|ἀπειλήσας|ἀπείλει|ἀπειλεῖτε|ἀπειλήσω|ἠπείλησεν|ἀπειλήσει|ἠπείλησε
ἐπιβαίνω|ἐπίβησον|ἐπιβαινέμεν|ἐπιβῆτον|ἐπιβήμεναι|ἐπιβαίην|ἐπέβησαν|ἐπιβήσεο|ἐπιβησέμεν|ἐπεβήσετ̓|ἐπέβημεν|ἐπιβαίης|ἐπιβήσεαι|ἐπέβησ̓|ἐπιβάντ̓|ἐπιβάντες|ἐπιβᾶσαν|ἐπιβᾶσα|ἐπιβήομεν|ἐπιβείομεν|ἐπέβαν|ἐπιβήσετε|ἐπιβῆναι|ἐπιβὰς|ἐπέβαινον|ἐπέβην|ἐπιβαῖεν|ἐπέβησε|ἐπεβήσετο|ἐπιβαίη|ἐπιβησομένοισιν|ἐπιβησόμενον
γοάω|γοήσεται|γοάοιεν|γοήμεναι|γόων|γοόωσά|γοάοιμεν|γοόωντες|γοόωσαν|γοόωντά|γοῶντες|γοάασκεν|γοόωσα|γοόωντας
διέξειμι|διεξίμεναι
ἄνειμι|ἀνιόντι|ἀνιόντος|ἀνιοῦσαν|ἀνιοῦσ̓|ἀνιόντα|ἄνεισι|ἀνήιον|ἀνιὼν|ἀνιόντες
ἀτίζω|ἀτίζων
χρή|χρή|χρὴ
ἐξαίρω|ἐξήρατο|ἐξήρατ̓
μητίομαι|ἐμητίσαντο|μητίσομαι|μητισαίμην|μητίσασθαι
ἐρείπω|ἐριπὼν|ἔρειπον|ἐριποῦσ̓|ἐρίπῃσιν|ἔριπ̓|ἐριποῦσα|ἐριπών|ἐρέριπτο|ἤριπε|ἔρειπε|ἐρείπων|ἤριπεν
λανθάνω|ἔληθε|λαθών|ἔλαθε|λαθοίμην|λελαθέσθ̓|λήσεις|ἔληθον|ἐλήθομεν|λήθετ̓|λάθοι|λάθωνται|λελασμένος|λήσει|λάθ̓|λαθὼν|λήθεσκεν|ἔλαθεν|λαθέσθαι|ἐλήθετο|λάθετ̓|ἔλαθ̓|λήθεις|λάθεν|λελάθῃ|λήθοντε|λάθωμαι|λανθανόμην|λήσομαι|λήθω|λελάθοντο|ληθάνει|λάθηται|λάθε|λήθετο|ἐλάνθανον|λήσεσθαι|ἐλάνθανε|λαθοίατο|λάθοντο|λήθει|λήθεαι|λελαθέσθω|λαθέτην|λήσειν|λάθῃσι|λήθοντο|λῆθεν|λῆθε|λάθον
ἐνστρέφω|ἐνστρέφεται
ἐξίσχω|ἐξίσχει
θάπτω|θάπτωσιν|θάπτομεν|θάπτέ|θάπτοι|θάψαν|θάπτοιμεν|θάπτον|ἐτέθαπτο
διαδηλέομαι|διεδηλήσαντο
ὑπερκαταβαίνω|ὑπερκατέβησαν
προστέρπω|ποτιτερπέτω
διώκω|διωκέμεν|διωκέμεναι|διώκεις|διώκω|ἐδίωκεν|δίωκε|διώκετον|διώκειν|διωκόμενον|διωκομένη|διώκει|διώκων|διώκετο|διώκοντες|διώκοι
δατέομαι|δάσσασθαι|δασσάμεθ̓|δάσσαντο|δάσονται|δατεῦντο|δασάσκετο|δασσάμενοι|δασαίμεθα|δατεώμεθα|δάσωνται|δέδασται|δατέοντο|ἐδάσσατ̓|δάσσαντό|δατέονται|δάσασθαι
παραβαίνω|παρβεβαῶτε|παρβεβαώς|παρέβασκε
ὀλολύζω|ὀλόλυξε|ὀλόλυζε|ὀλολύξαι|ὀλόλυξαν
ἐναρίζω|ἐνάριζεν|ἐνάριζον|ἐνάριζε|ἐνάριξε|ἐνάριξα|ἐναρίζων|ἐναρίζοι
καναχέω|κανάχησε
διφάω|διφῶν
ἐμβαίνω|ἐμβεβαῶτα|ἐμβαίνων|ἔμβαινον|ἐμβέβασαν|ἔμβη|ἐμβεβαυῖα|ἐμβήῃ|ἔμβητον
ὀρεχθέω|ὀρέχθεον
πρήθω|πρῆσε|ἔπρησεν|πρῆσεν
φύω|φύεν|φύονται|πεφύκασι|πεφυῶτας|ἔφυν|πεφύασι|φῦ|φύντες|ἔφυ|πεφύασιν|πεφυυῖα|φύει|πεφύκει|φύοντο|ἔφυσε
περιδείδω|περιδείσαντες|περιδείσασα|περιδείδια|περίδεισαν|περιδείσασ̓
ἐπιχρίω|ἐπιχρίεσθαι|ἐπιχρίσασα|ἐπιχρίοντες
ὄζω|ὀδώδει
κατατρύχω|κατατρύχῃ|κατατρύχω
ἀμφιπίπτω|ἀμφιπεσοῦσα
ἐπαυρέω|ἐπαυρήσεσθαι|ἐπαύρηαι|ἐπαυρίσκοντ̓|ἐπαύρωνται|ἐπαυρέμεν|ἐπαυρεῖν|ἐπαύρῃ
καταράομαι|κατηρᾶτο|καταρῶνται
ἀρετάω|ἀρετῶσι|ἀρετᾷ
ἀπάρχω|ἀπαρχόμενος
πέτομαι|πέτοντο|πτάτο|ἔπτατ̓|ἔπτατο|πέτεται|πέτεσθαι|πταμένη|πτῆται|πετέσθην|πέτετο|πέτονται|ἐπέτοντο|πέτετ̓
ποτάομαι|πεποτήαται|ποτέονται|ποτῶνται|πεπότηται
ἀγυρτάζω|ἀγυρτάζειν
ἀπινύσσω|ἀπινύσσων|ἀπινύσσειν
κομέω|κομέεσκεν|κομείτων|κομέειν|κομείτην|κομέουσιν|ἐκόμει|κομέουσι
βουκολέω|βουκολέοντι|βουκολέοντο|βουκολέων|βουκολέεσκες
λικμάω|λικμώντων
ἐνίημι|ἐνήκαμεν|ἐνίετε|ἐνεῖσα|ἐνήσει|ἐνῆκεν|ἐνήσομεν|ἐνεικέμεν|ἐνέηκε|ἐνῆκε|ἐνίησι|ἐνῆκας|ἐνήσεις
ὕω|ὑόμενος|ὗε
λωβάομαι|λωβήσασθε|λωβήσαιο
ἐκδιαβαίνω|ἐκδιαβάντες
θητεύω|θητεύσαμεν|θητευέμεν
ἀπάγχω|ἀπάγχων
παρευνάζομαι|παρευνάζεσθε
ἀντιβολέω|ἀντεβόλησαν|ἀντιβολῆσαι|ἀντιβολήσεις|ἀντεβόλησας|ἀντιβολήσει|ἀντιβολήσας|ἀντεβόλησεν|ἀντιβολήσαις|ἀντεβόλησε
ἀναμίμνω|ἀνέμιμνε|ἀνέμιμνον
εὕδω|εὕδοιμι|εὕδῃσι|εὗδε|εὕδων|εὕδοντ̓|εὕδοι|εὕδουσι|εὕδοντας|εὕδεσκ̓|εὕδεις|εὑδέμεναι|εὑδέτω|εὕδει|εὕδουσιν|εὕδειν|εὕδῃσθα|εὕδῃ|εὗδον|εὕδουσ̓|εὗδ̓|εὕδοντες
ναιετάω|ναιετάασκε|ναιετοώσης|ναιετάουσαν|ναιετάοντα|ναιετάω|ναιετάουσιν|ναιεταόντων|ναιετάουσι|ναιετοώσας|ναιετάασκον|ναιετοώσῃ|ναιετάοντας|ναιετάων
ὑπομένω|ὑπέμεινα|ὑπομεῖναι|ὑπέμεινεν|ὑπέμειναν|ὑπέμεινε
προκαλέω|προκάλεσσαι|προκαλέσσεται|προκαλέσσατο
ἐκφορέω|ἐκφόρεον|ἐκφορέοντο
σκίδνημι|σκίδνασθαι|σκίδνασθ̓|σκίδναθ̓|ἐσκίδναντ̓|ἐσκίδναντο|σκίδναται
ἐπιμηνίω|ἐπεμήνιε
ἀπόερσε|ἀπόερσε|ἀποέρσῃ
κομπέω|κόμπει
ἀλητεύω|ἀλητεύοντι|ἀλητεύοντες|ἀλητεύει|ἀλητεύων|ἀλητεύειν
δείδω|δείσεσθαι|ἔδεισας|δείδιας|δείσασ̓|δείσεἰ|ἐδείδισαν|δείδιε|ἐδείδιμεν|δείδοικε|δεῖσαν|δείσαντες|δείσῃ|δείδοικα|δείσαντας|δείσαντε|δειδιότας|δείδισαν|δείσετ̓|ἔδεισε|δειδιότες|ἐδείσατε|δεῖσε|δείσητ̓|δεισάντων|δειδίμεν|δείσας|δείδια|δείδιθι|δείδοικας|ἔδεισαν|δείδιθ̓|ἔδεισεν|δείσειε|δείδιτε|δειδιότων|δείδω|δειδιότα|δεδίασιν|δείδιμεν
ἐπορούω|ἐπόρουσαν|ἐπόρουσεν|ἐπορούσας|ἐπόρουσα|ἐπόρουσε
ἀθλεύω|ἀθλεύων|ἀεθλεύωσιν|ἀεθλεύειν|ἀεθλεύοιμεν
ἐρέω|ἐρείομεν
στεναχίζω|στεναχίζω|στεναχίζετο|στεναχίζων
ἔχω|ἑξέμεν|ἔσχεθε|ἔχοντι|εἶχον|σχέθον|ἔχων|ἔχεσκεν|ἔχεσκον|ἔχεσκ̓|ἔχοις|σχεθέειν|ἔχοντε|ἔσχεν|σχέτο|ἔχες|ἕξουσιν|σχήσεσθ̓|σχέθ̓|ἔχον|σχέο|σχέμεν|σχέσθαι|ἔχοντα|σχέθε|ἔχ̓|σχήσουσιν|ἕξουσι|ἔχεσθαι|ἔχω|ἔχεο|σχομένη|ἔχεαι|ἔχεν|σχήσεις|εἶχε|ἔχεις|ἔχουσ̓|σχήσουσι|ἕξεται|ἔχοντο|ἐχώμεθα|ἔχοι|ἔχετ̓|ἔχῃσιν|ἔσχε|σχήσεσθαι|σχὼν|ἐχόμην|ἔχοντες|ἔχοιεν|ἔσχοντο|ἔχοντ̓|ἕξω|ἔσχ̓|ἔσχον|ἔχεσκες|σχῶνται|ἔχουσαν|ἐχούσῃ|σχήσεσθε|εἴχοντο|ἐχούσας|ἔχουσι|σχήσειν|ἔσχετο|ἔχῃ|σχοίατ̓|ἔχετο|ἔχει|σχήσει|ἔχοιμι|ἔχεθ̓|ἔχωμεν|εἶχεν|σχέθεν|ἐχέμεν|ἐσχεθέτην|ἔχουσα|σχόμενος|ἔχῃσθα|ἔχεσκε|ἔχῃσι|ἔχοντας|ἔχε|ἔχουσαι|σχεῖν|ἕξειν|ἐχέτην|σχέσθε|ἕξει|σχεθέτω|ἔχουσιν|ἔχητον|ἔων|ἔχῃς|ἔσχεθον|σχήσομεν|ἐχέτω|ἐχόντων|ἔχεται|ἔχειν|ἔχοντί|εἶχ̓|σχῶμεν|ἔχομεν|ἔχονται|ἔχομαι|ἔσχες|ἔχοντά|ἔσχεθεν|ἕξομεν|σχήσω
κατακρύπτω|κατακρύψειν|κατακρύπτων|κατακρύψας|κατακρύψασα|κατακρύψασ̓|κατακρύπτουσιν
ἐπιορκέω|ἐπιορκήσω
συνόχωκα|συνοχωκότε|ξυνέχουσι|σύνεχον
δεδοκημένος|δεδοκημένος
ἐφέπω|ἐπισπόμενοι|ἐπίσπῃς|ἔφεπε|ἐφέποντες|ἐφέπειν|ἔφεπ̓|ἐπέσπεν|ἐπισπόμενος|ἐφέπων|ἐφέποι|ἐπίσποι|ἐφέπεσκον|ἐπισπεῖν|ἐπισπόμενον|ἐπίσπῃ|ἐφέψεις|ἐφέψειν|ἐπέσπον|ἐπισπέσθαι
φαέθω|φαέθων
ἐνέπω|ἔνισπες|ἐνίσπω|ἐνέποντε|ἐνίσπες|ἐνίσποις|ἐνισπεῖν|ἐνίσποι|ἐνέποντες|ἐνίψει|ἐνίψω|ἔνισπε|ἐνέπουσα|ἐνέποντα|ἔννεπε|ἐνέποιμι|ἐνίσπῃ|ἐνισπήσω
πτώσσω|πτώσσοντας|πτῶσσον|πτώσσων|πτώσσοιμεν|πτώσσεις|πτώσσειν|πτώσσουσι|πτώσσουσαι
ἀγάλλω|ἀγαλλόμενος|ἀγαλλόμεναι|ἀγάλλεται|ἀγαλλόμενοι|ἀγαλλόμενα
ἐκγίγνομαι|ἐκγεγάμεν|ἐξεγένοντο|ἐκγεγαυῖα|ἐκγεγάτην|ἐκγεγαῶτι
ἀγαπάζω|ἀγαπάζῃ|ἀγαπαζόμενοι|ἀγαπαζέμεν|ἀγαπαζόμεναι|ἀγαπαξόμεναι
ἀνύω|ἀνύσσεσθαι|ἀνύσειε|ἀνύω|ἤνυσεν
διαβαίνω|διαβαινέμεν|διαβήμεναι|διαβάς
σίνομαι|σινέσκοντο|σίνοιτό|σίνηαι|σίνεται
διέχω|διέσχε
ἐξακέομαι|ἐξακέσαιτο|ἐξακέσαιο|ἐξακέονται
εἰσοράω|εἰσορόωσαι|εἴσιδεν|ἐσίδεσκεν|εἴσιδ̓|εἰσορόωντα|ἐσόψεται|εἰσοροώσῃ|ἐσιδέσθην|εἰσορόωσα|εἴσιδε|εἰσορόωσιν|εἰσορόωσαν|εἰσορόωντι|εἰσεῖδε|ἐσορῶν|ἐσόψομαι|εἰσορόων|εἰσορόωντο|εἰσορόωντας|εἰσορόῳτε|εἰσορόωσι|ἐσορᾶν|ἐσιδοῦσα|ἐσορῶσ̓|ἐσορῶντι|εἰσορόωντες|εἰσοράασθαι|εἰσοράασθε
εἰσίζομαι|ἐσίζηται
ῥιγόω|ῥιγωσέμεν
ἐνέζομαι|ἔνεσαν
μινύθω|μινύθεσκον|μινύθῃ|μινύθει|μινύθουσι
νάσσω|ἔναξε
κιχάνω|κιχήσεσθαι|κίχανε|ἐκίχαν̓|κιχεὶς|κιχήσατο|ἐκίχεις|ἐκίχανον|κιχήτην|κίχανον|κίχον|ἐκίχανεν|κίχεν|κιχήμενον|κιχησόμεθα|κιχάνομαι|κιχάνεται|κιχάνω|κίχῃσι|ἐκίχανε|κιχανόμενοι|κιχάνει|ἐκίχημεν|κιχήσομαι|κιχὼν|κιχείομεν|ἔκιχεν|κίχανεν|κιχῆναι|κιχήσεαι|κιχείη|κιχείω|κιχήμεναι|κιχήσεται|κιχάνετε
ἐκκλέπτω|ἐξέκλεψεν
στορέννυμι|στόρεσ̓|στορέσας|ἔστρωτο|στορέσαι|στόρεσον
ἑάφθη|ἑάφθη
δοκεύω|δοκεύσας|δοκεύει
ἐκπάλλω|ἔκπαλθ̓
ἐπαλαστέω|ἐπαλαστήσασα
γάνυμαι|γάνυται|γανύσσεται|γάνυνται
καθέζετο|καθέζετ̓
ἀναμορμύρω|ἀναμορμύρεσκε
εἰσαναβαίνω|εἰσανέβαινον|εἰσαναβῆναι|εἰσανέβησαν|εἰσαναβᾶσα|εἰσαναβᾶσ̓|εἰσαναβαίνοι
ἀποκαίνυμαι|ἀπεκαίνυτο
προσβαίνω|προσέβαν|προσβὰς|προσέβη|προσεβήσετο|προσβάς
ἐπιάλλω|ἐπίηλεν
ἐξερέω|ἐξερέοις|ἐξερέω|ἐξερέοντες|ἐξερέουσα|ἐξερέουσιν
μεταδαίνυμαι|μεταδαίσομαι|μεταδαίνυται|μεταδαίσεται
ἐπιβοάω|ἐπιβώσομαι
ῥοιζέω|ῥοίζησεν
ὀρύσσω|ὀρύξαι|ὄρυξ̓|ὀρύξομεν|ὀρύσσειν|ὄρυξαν|ὀρύξας
ἀναπνέω|ἀμπνύνθη|ἄμπνυτο|ἀνέπνευσαν|ἀνέπνεον|ἀμπνεῦσαι|ἀναπνεύσωσι|ἀναπνεύσωσιν|ἄμπνυε|ἀναπνεύσειε
ἀφορμάω|ἀφορμηθεῖεν|ἀφορμηθέντος
χαλκεύω|χάλκευον
κλοτοπεύω|κλοτοπεύειν
χατέω|χατέοντί|χατέουσί|χατέουσα|χατέουσ̓|χατέουσιν
ἄω|ἄσασθαι|ἄσειν|ἄμεναι|ἄσαιμι|ἄεσα|ἄσῃ|ἄεσαν|ἀέσαμεν|ἆσαι|ἄσεσθε
ἀνέζομαι|ἀνέσει
ὑπερείπω|ὑπήριπε
δειελιάω|δειελιήσας
βουφονέω|βουφόνεον
πιλνάω|πίλναται|πίλνατο
ἐργάζομαι|ἐργάζεσθαι|ἐργάζοιο|εἰργάξετο|ἐργάζοντο
διαγιγνώσκω|διαγιγνώσκω|διαγιγνώσκοντες|διαγνῶναι
ὑπεράλλομαι|ὑπερᾶλτο|ὑπεράλμενον
παρίημι|παρείθη
σφαραγέομαι|σφαραγεῦντο
λαφύσσω|λαφύσσει|λαφύσσετον
ἀνακρεμάννυμι|ἀγκρεμάσασα
ἀποκλίνω|ἀποκλίναντ̓
ὀπαδέω|ὀπηδεῖ|ὀπήδει
ἀποσεύω|ἀπεσσύμενον|ἀπεσσύμεθ̓|ἀπέσσυτο
κατηπιάω|κατηπιόωντο
ἠερέθομαι|ἠερέθονται
θέλγω|ἔθελγεν|ἔθελξε|ἐθέλχθης|θέλγε|ἔθελχθεν|θέλγεσκ̓|θέλξας|θέλγει|θέλγοιτό|θέλξαι|θέλξει|θέλγουσιν|ἔθελγε
ἐπιάχω|ἐπίαχον
νοστέω|νοστήσαντες|νοστήσεις|νοστήσαντ̓|νοστήσομεν|νοστήσῃ|νοστῆσαι|νοστήσεἰ|νοστήσας|νοστήσαντι|νοστήσειεν|νοστήσειν|νοστήσαντά|νοστήσει|νοστήσαιμεν|νοστησέμεν|νοστήσαντα|νοστήσειε|νόστησ̓|νοστήσω|νόστησας
καταπέσσω|καταπέψῃ
παρεῖπον|παρειποῦσ̓|παρειπών|παρείπῃ
ἑλκέω|εἵλκεον|ἑλκήσουσ̓|ἕλκησε|ἑλκήσουσιν|ἑλκηθείσας
ἀκέομαι|ἄκεσσαι|ἀκέσασθε|ἀκειόμενον|ἠκέσατ̓|ἀκέοντό|ἀκεώμεθα|ἀκειόμενοι
θνήσκω|θανεῖν|θανέειν|θάνῃσι|θανέεσθαι|τεθνηῶτος|θνῄσκων|τέθναθι|θανόντος|τεθνηότα|τεθνηῶτά|τεθνηκότος|τεθνάμεν|τεθνᾶσιν|τεθνάτω|θάνοι|τεθνηῶτα|τεθνηῶτι|θάνῃς|τέθνηκεν|θνήσκοντας|τεθνηώτων|τέθνηκε|θνῄσκουσ̓|ἔθανεν|ἔθαν̓|θάνω|τεθνηότας|τεθνᾶσι|θανόντι|θανών|τεθνάμεναι|θνήσκοντες|θανὼν|θάνεν|τεθνεῶτί|τεθνηκυῖαν|θάνῃσιν|θανόντα|τεθνηῶτας|θάνον|τεθναίην|τεθνηότος|θνῇσκον|θανόντων|τεθνηὼς|τεθναίης|θνήσκοντα|τεθναίη|θάνωσι|θάνωμεν|θάνοιεν|θάνε|θάνες
προφεύγω|προφυγόντα|προφυγὼν|προφύγῃ|προφυγεῖν|προφύγοισθα
ἀλαστέω|ἠλάστεον|ἀλαστήσας
ἐκκλύω|ἐξέκλυες
κεκαφηώς|κεκαφηότα
ἐξαπονίζω|ἐξαπένιζεν
ἀφραδέω|ἀφραδέουσιν|ἀφραδέοντι
ἐπιρρώομαι|ἐπερρώοντο|ἐπερρώσαντο
σέβομαι|σέβεσθε
ἐπιρρέπω|ἐπιρρέπῃ
ἐκκαθαίρω|ἐξεκάθαιρον
περιστείχω|περίστειξας
συμμάρπτω|συμμάρψας
ἐλέγχω|ἐλέγξῃς|ἐλέγχει
ἀπονέομαι|ἀπονέοντο|ἀπονέεσθαι|ἀπονεοίμην
ἐχθοδοπέω|ἐχθοδοπῆσαι
ἀμφιξέω|ἀμφέξεσα
μαραίνω|ἐμαραίνετο|ἐμαράνθη
λήγω|λήξω|ληγέμεναι|λήξειν|λῆξαν|λήγεις|λῆγε|λήγοντα|λήξαιμι|λήξειεν|ἔληγε|λῆγ̓
ἐλεαίρω|ἐλεαίροντες|ἐλεαίρεις|ἐλεαίρων|ἐλέαιρον|ἐλεαίρεσκον|ἐλέαιρεν|ἐλεαίρει|ἐλέαιρε
πλήθω|πλήθουσαν|πλήθει|πληθούσας|πλήθωσι|πλήθων|πλήθουσι|πλῆθ̓|πλήθοντι
ἐνδίημι|ἐνδίεσαν
ἐκπλήγνυμι|ἔκπληγεν
προβάλλω|προβαλόντες|προβαλοίμην|προβάλεσκε|προβάλοντο
σμαραγέω|σμαραγεῖ|σμαραγήσῃ
χηρόω|χήρωσε|χήρωσας
γίγνομαι|γένευ|γένοντο|γίγνετο|γένοισθε|ἐγενέσθην|γίγνοντο|γεγάασιν|γενοίατο|γένωμαι|ἐγένοντ̓|γενοίμεθα|γεγόνει|γενέσθην|ἐγένεσθε|γενώμεθα|γίγνονται|γένωνται|γίγνεθ̓|γίγνομαι|γεγαῶτ̓|γενόμεσθα|γεγάασι|γένηαι|γεγαῶτα|γίγνεται|γίγνετ̓|γένησθε|γένοιο|γεγαῶτας|γένοιτ̓|γιγνομένῳ|γενόμην|γένοιθ̓|γίγνοντ̓|γένετ̓|γενοίμην|γενέσκετο|γέγον̓|γένηται|γιγνόμενόν|γιγνομένοισιν|γένοιτό|ἐγένοντο|γενέσθαί|γένοιτο|ἐγίγνετο|γενέσθω|γένεθ̓|γιγνόμενος|γενέσθαι|γένετο
νηκουστέω|νηκούστησε
φάσκω|φάσκεν|ἔφασκε|ἔφασκον|φάσκε|ἔφασκεν|ἐφάσκεθ̓|φάσκ̓|φάσχ̓|ἔφασκες
ἔραμαι|ἠρασάμην|ἠράσσατο|ἠράσσατ̓|ἔραται|ἠράσατ̓|ἔραμαι
ἐγκαταπήγνυμι|ἐγκατέπηξ̓
διίημι|διέσθαι|δίηται
παύω|παῦσε|παυώμεσθα|παύσεσθ̓|παύσωμεν|παυσάμενοι|ἐπαύετο|παῦσ̓|παῦε|παύετ̓|παύσῃ|πεπαυμένοι|παυσαμένους|παυσάμενόν|παυσώμεσθα|παυσάμενον|παύσαμεν|πέπαυμαι|παυέμεναι|παυσάσθην|παυέσθων|ἐπέπαυτ̓|παύσασθε|παύσουσα|παύσειε|παύσασαι|παύομαι|παύσατο|παύσαιτό|πέπαυται|παύσομεν|παύεσθαι|παύἐ|παύεσθον|ἐπαυσάμεθα|ἐπαύσατο|παύειν|παύω|παῦσεν|παυομένῳ|παύεσκον|παύσαντο|παῦσαν|παυσάμεθα|ἔπαυσε|παυέσκετο|παύσασθαι|παῦσαι|παύσῃσι|παύσατ̓|παύσειεν|παύσεσθαι|παυέσθω|ἔπαυσας
ἐνδύω|ἔνδυνε|ἐνδῦσα
ὑποκρίνομαι|ὑποκρίνασθαι|ὑποκρίνονται|ὑπόκριναι|ὑποκρίναιτο
ἀπολείβω|ἀπολείβεται
ἐπιστοναχέω|ἐπεστονάχησε
θαμίζω|θαμίζων|θαμίζεις|θάμιζεν
μνηστεύω|μνηστεύειν|μνηστεύσαντες
ἐρίζω|ἐρίσσεται|ἐριζέμεναι|ἐρίσσειαν|ἐρίζετον|ἐρίσειε|ἐριζέμεν|ἐρίσσειε|ἐρίζεται|ἐρίσωσιν|ἐρίζεσκον|ἐρίσαντε|ἐρίζητον|ἐρίζοι|ἔριζεν|ἤρικε|ἐρίσαντες|ἐρίζειν
ὠχράω|ὠχρήσαντα
χέω|χυμένη|κέχυθ̓|κέχυτο|χεῦον|χέοντας|ἔχεαν|χέοντες|χέει|χύτο|χέουσαι|ἐχέοντο|ἔχευεν|χέοντο|χεύῃ|χεύαντες|χέον|χεῖσθαι|κέχυντο|χέοντ̓|ἐκέχυντο|χέουσα|χεῦεν|ἔχευε|χεούσῃ|χεούσης|χέε|χεῦαι|χέ̓|χεῦε|χυθείη|ἔχεεν|χεύομεν|χεύαμεν|χευάντων|ἔχυτ̓|χύντο|ἔχυντο|χεύωσιν|χεῦ̓|χέοντα|κέχυτ̓|κέχυνται|κέχυται|χεόμην|χεύω|χεύατο|χέων|χεῦαν|χέουσαν|χέεν|χέουσ̓|χέοντος|ἔχευαν|ἐχεύατο
ἐφανδάνω|ἐπιήνδανε|ἐπιὴνδανε|ἐφήνδανε|ἐπιανδάνει
παρίζω|παρῖζεν
λάπτω|λάψοντες
παρανηνέω|παρενήνεεν|παρενήνεον
κατακύπτω|κατέκυψε
τινάσσω|ἐτίναξε|τινάσσων|τινάξῃ|ἐτίναχθεν|ἐτίναξεν|τιναξάσθην|τίνασσε|τίναξε|ἐτίνασσε|τινάσσεται|τινάσσοντας|τινάσσετο
ἀνατλῆναι|ἀνέτλη|ἀνέτλης|ἀνέτλημεν
ἀρέσκω|ἀρεσσάσθω|ἀρέσσομαι|ἀρεσσόμεθ̓|ἀρέσαι|ἀρεσάσθω|ἀρεσσάμενοι|ἀρεσσάμενος
πεινάω|πεινήμεναι|πεινάων|πεινάοντα|πεινάοντε
καταπέτομαι|καταπτήτην
ἐπιμαίομαι|ἐπεμαίετ̓|ἐπεμαίετο|ἐπιμασσάμενος|ἐπιμασσαμένη|ἐπιμαίεο|ἐπεμάσσατ̓
ἐπαραρίσκω|ἐπῆρσεν|ἐπαρήρει|ἐπῆρσε
ἐντύνω|ἐντυνόμενοι|ἐντυνώμεθα|ἔντυνον|ἐντύνεαι|ἐντύνασαν|ἐντυναμένη|ἐντύνοντο
διίστημι|διαστήτην|διέστησαν|διαστάντες|διίστατο|διέσταμεν
ἐκσπάω|ἐξέσπασε|ἐκσπασσαμένω
ἄημι|ἄητο|ἀῆναι|ἄη|ἀέντες|ἀήμενος|ἀήμεναι|ἀέντων
ἀφανδάνω|ἀφανδάνει
ἐμφύω|ἐνέφυσεν|ἐμπεφύασι|ἐμπεφυυῖα
ὑπερέχω|ὑπέρσχῃ|ὑπερέσχεθε|ὑπείρεχε|ὑπείρεχεν|ὑπερέσχε|ὑπείρεχον
κακίζω|κακιζόμενόν
ἐρέσσω|ἔρεξας|ἐρεσσέμεναι|ἔρεσσον
ὑπερθρώσκω|ὑπερθορέειν|ὑπέρθορον
μισέω|μίσησεν
δράσσομαι|δεδραγμένος
ἐπιφράζω|ἐπιφρασσαίατο|ἐπεφράσω|ἐπιφράσσετ̓|ἐπιφρασσαίμεθα|ἐπεφράσθης|ἐπιφρασσαίατ̓|ἐπεφράσατ̓
παρελαύνω|παρήλασε|παρελάσσαι|παρέλασσ̓|παρήλασαν
διαθρύπτω|διατρυφὲν
χωρέω|ἐχώρησαν|χωρήσαντες|χώρησεν|χωρήσουσι|χωρήσειεν|χώρησαν|χωρήσαντ̓
ῥήγνυμι|ῥήγνυσθε|ῥήξαντο|ῥῆξαι|ῥήσσοντες|ἐρρήξαντο|ῥῆξεν|ῥηξαμένῳ|ἔρρηξ̓|ῥήγνυτο|ῥήξαντες|ῥήξας|ῥηξόμεθα|ῥήγνυσκε|ῥηγνῦσι|ῥήγνυσθαι|ῥηγνύμενον|ῥήξω|ῥήγνυντο|ῥηξάμενος|ῥῆξαί|ῥήξειν|ῥῆξε|ῥηξάμενοι|ῥήξασθαι|ῥῆξ̓|ἔρρηξεν
φύρω|ἔφυρον|φύρσω|πεφυρμένη|πεφυρμένον
τρέω|τρέε|ἔτρεσε|τρέσσε|τρεῖν|τρέσε|ἔτρεσαν|τρέσσαν|τρέσσαι|τρεῖ|τρεσσάντων|τρεῖτ̓
ὑβρίζω|ὑβρίξεις|ὑβρίζοντες|ὑβρίζων
σκοπιάζω|σκοπιαζέμεν|ἐσκοπίαζον|σκοπιάζων
ὑποστρέφω|ὑποστρέψωσι|ὑπέστρεφε|ὑποστρέψας|ὑποστρεφθείς|ὑποστρέψεσθαι|ὑποστρέψειας
δονέω|δονήσας|ἐδόνησεν|δονέουσι
ἐπιγίγνομαι|ἐπιγίγνεται
ματάω|ματήσετον|μάτησεν|ἐμάτησε
ἀναείρω|ἀναεῖραι|ἀνάειρε|ἀνάειῤ
ἕζομαι|ἕζεθ̓|ἕζετ̓|ἑζόμενος|ἑζόμενοι|ἕζεσθαι|ἕζεο|ἑζόμεθ̓|ἑζομένη|ἑζομένω|ἕζεσθε|ἕζοντο|ἕζεαι|ἐέσσατο|ἕσασθαι|ἑζέσθην|ἕζευ|εἷσαν|ἕζετο
ἀτασθάλλω|ἀτασθάλλουσ̓|ἀτασθάλλων
βοάω|βοάᾳ|βοήσας|βοόων|βώσαντι|βοόωντες|βοόωντά|ἐβόησα|βοόωσιν|βόησαν|ἐβόησε|ἐβόησας|ἐβόησεν|βοᾶν
ἐπιβάλλω|ἐπιβαλλόμενος|ἐπέβαλλον|ἐπέβαλλεν
συναγείρω|συναγείρων|ξυνάγειρα|συναγειρόμενοι|συναγρόμενοι|ξυναγείρατ̓
τολυπεύω|τολύπευσεν|τολυπεύειν|τολύπευσε|τολύπευσα|τολυπεύω
ἱππάζομαι|ἱππάζεαι
περιγίγνομαι|περιγίγνεται|περιγιγνόμεθ̓
ἐπισκύζομαι|ἐπισκύζωνται|ἐπισκύσσαιτο
ἠγερέθομαι|ἠγερέθεσθαι|ἠγερέθοντο|ἠγερέθονται
ἀλεείνω|ἀλεείνων|ἀλέεινε|ἀλεείνει|ἀλεείνεις|ἀλεείνω|ἀλεείνοντες|ἀλέεινεν
ἕννυμι|ἕσσατο|ἕσσαντο|ἕσσεν|εἱμένοι|ἕσαντο|εἱμένος|ἕσσω|ἕσσαν|εἷται|ἕσσαι|ἕσσει|ἕσσ̓|ἕσσαθ̓|ἕεστο|ἕσθην|εἷμαι|ἕσαθ̓|ἑέσσατο|ἑσσάμενος|εἱμένα|ἑσσαμένω|ἕννυτο|ἕσσο|ἑέσσατ̓|ἕστο|ἕννυσθαι|ἕσσε|ἕσασθαι|ἑσσάμενοι|ἕννυτ̓
ὑπεκφεύγω|ὑπεξέφυγον|ὑπέκφυγον|ὑπεκφυγέειν|ὑπεξέφυγε|ὑπεξέφυγεν|ὑπέκφυγε|ὑπεκφύγοι|ὑπέκφυγες
τιταίνω|ἐτιταίνετο|τιταίνετον|τιταινόμενος|τιταίνοιτ̓|τιτήνας|τιταίνων|τιταινομένω|τιταίνετο|ἐτίταινε
ἰάχω|ἴαχε|ἰάχων|ἰάχοντες|ἰάχοντος|ἴαχεν|ἰάχουσα|ἰάχοντα|ἴαχον
ἀναρρήγνυμι|ἀναρρήξας|ἀναρρήξειε|ἀναρρήξαντε
ἐπικερτομέω|ἐπικερτομέων
ἐπιχειρέω|ἐπιχειρήσειν|ἐπεχείρεον
παράκειμαι|παράκειται|παρέκειτο|παρεκέσκετ̓
ἀλεγύνω|ἀλεγύνετε|ἀλέγυνον|ἀλεγύνειν
καθέζομαι|καθεζομένη|καθεζόμενοι|καθεζομένω|καθεζώμεσθα|καθέζετο|καθεζόμενος
κοσμέω|ἐκόσμει|κόσμησε|ἐκόσμεον|κοσμῆσαι|κοσμηθέντες|κόσμησεν|κοσμησάμενος|κόσμηθεν
περισθενέω|περισθενέων
οὐτάω|οὐτάμεναι|οὐτάμενοί|οὔταε|οὐτάμενοι|οὖτα|οὔτησε|οὐτηθείς|οὐτάμεν|οὔτασκε|οὐταμένην|οὖτά|οὐτήσασκε
ἀναπείρω|ἀμπείραντες
σκάζω|σκάζων|σκάζοντε
βαρύνω|βαρυνθέν|βαρυνθεὶς|βάρυνε|βαρύνεται|ἐβάρυνε
ἐφορμάω|ἐφωρμήθην|ἐφορμηθέντε|ἐφορμηθεῖσα|ἐφορμᾶσθαι|ἐφορμήσας|ἐφωρμήθη|ἐφορμηθεῖεν|ἐφορμηθέντα|ἐφορμᾶται|ἐφορμηθεὶς|ἐφορμηθέντες|ἐφορμηθῆναι|ἐφώρμησαν
ἀποθαυμάζω|ἀπεθαύμασ̓
ἐποτρύνω|ἐποτρῦναι|ἐποτρύνειε|ἐποτρύνων|ἐποτρύνῃ|ἐποτρύνῃσιν|ἐποτρύνειεν|ἐπότρυνε|ἐποτρυνώμεθα|ἐποτρύνοντα|ἐποτρύνωσι|ἐπώτρυνας|ἐποτρύνῃσι|ἐποτρύνῃς|ἐπότρυνον|ἐποτρύνω|ἐποτρύνει|ἐποτρύνητον|ἐποτρύνας|ἐποτρύνουσα
κυμαίνω|κυμαίνοντα
ὑπεροπλίζομαι|ὑπεροπλίσσαιτο
ἀναιρέω|ἀνελέσθαι|ἀνελόντα|ἀναιρήσεσθαι|ἀνελὼν|ἀνέληται|ἀνέλοιο|ἀνείλετο|ἀνελόντες|ἀνελοίμην|ἀνέλοντο
λιγαίνω|ἐλίγαινον
στείνω|στείνοντο|στεινόμενος|στείνοιτο
ἐξαποδίω|ἐξαποδίωμαι
κορθύνω|κορθύεται
ὑποστορέννυμι|ὑποστορέσαι
ἱκετεύω|ἱκέτευεν|ἱκέτευσε|ἱκέτευσα|ἱκέτευσ̓|ἱκέτευσας
ὑπορρήγνυμι|ὑπερράγη
κυκλέω|κυκλήσομεν
τρυγάω|τρυγόῳεν|τρυγόωσιν
δράω|δρώοιμι
κυέω|κυέουσαν|ἐκύει
πειράζω|πειράζων|πειράζειν
παρίστημι|πάρστητε|παρίστατο|παρίσταται|παρίσταο|παρστὰς|παριστάμενος|παρίστασαι|παρίσταμαι|παραστὰς|παριστάμεναι|παριστάμενοι|παρστᾶσα|παρσταίη|παρισταμένη|παρεστάμεναι|παραστήσεσθαι|παρέστη|παρέστηκεν|παρασταῖεν|παρασταίης|παρστήετον|παραστάς|παρέσταν|παρέστης
συμφράζομαι|συμφράσσομαι|συμφράσσατο
παράφημι|παρφάμενος|παραιφάμενος|παράφημι|παρφάσθαι
ἀπαλοάω|ἀπηλοίησεν
ἐπισπέρχω|ἐπισπέρχων|ἐπισπέρχουσι
φιλέω|φιλέουσ̓|ἐφίλησε|φιλησέμεν|φιλέουσιν|φιλέεσκε|φιλήσῃ|φιλεόντων|φιλέων|φιλέωμεν|ἐφίλει|φιλέοντέ|φιλέοντες|φιλέεσκεν|φῖλαι|ἐφίλησαν|φιλέεις|φιλέει|φιλεῖν|φιλήμεναι|ἐφίλησ̓|ἐφίλησα|φιλήσεαι|φιλέεσθε|φιλέοντι|φιλεῖ|φιλέειν|φιλήσω|ἐφίλατο|φίλησε|φιλέουσά|φίλατο|φίλεον|φιλεῦντας|φίλει|φιλέοι|φιλοίη|φίλεόν|φιλῆσαι|φίλησα|φιλέῃσιν|φιλέοντε|φίληθεν
ἥκω|ἥκω|ἥκειν
ἀπορριγέω|ἀπερρίγασι
ἀμφιπονέομαι|ἀμφεπονεῖτο
τίνω|τίσω|ἔτισας|ἔτισεν|τῖσον|ἔτισε|τίσετε|τείσεις|τίνων|ἔτισ̓|τίσεται|τεισαίμεθα|τίσειν|τῖσαι|τίσειαν|τίσουσι|τίσασθαι|τίσαιτο|τισόμεθ̓|τίνειν|τίσατο|τίσωσιν|τίσεσθαι|ἔτισαν|τίσεις|τισαίατο|ἐτίσατο|τισαίμην
δάω|δαήμεναι|δεδάηκε|δαῆναι|δεδάασθαι|δέδαεν|δαῶμεν|δεδάηκας|δαείω|δαήσεαι|δεδαηκότες|δεδαὼς|ἐδάην
ἀποβλύζω|ἀποβλύζων
κρατέω|κρατέουσι|κρατέει|κρατέων|κρατέουσιν|κρατέειν|κρατέεις
κορύσσω|κεκορυθμένον|κεκορυθμένοι|κεκορυθμένα|κορύσσεαι|κορύσσων|κόρυσσε|κορυσσόμενος|κορυσσόμενον|κορύσσετο|κορύσσεται|κορυσσέσθην|κεκορυθμένος|κορυσσάμενος
μετεῖπον|μετέειπον|μετέειπε|μετέειφ̓|μετέειπεν
λωφάω|λωφήσειε|λωφήσει
δηιόω|δῃώσας|δηιόῳεν|δηϊόων|δῃώσῃ|δῃωθέντων|δῃώσαντες|δῃῶν|δῃώσαντε|δηϊόωντες|δῃώσειν|δῃωθέντες|δηϊόωντο|δῃώσωσιν|δῄουν
ἐπικίδνημι|ἐπικίδναται
ἐξάλλομαι|ἐξάλμενος|ἐξάλλεται
καταγηράσκω|καταγηράσκουσιν|κατεγήρα
θρῴσκω|θορὼν|θόρον|θόρωσι|ἔθορε|ἔθοῤ|θρῴσκωσιν|θόρε|θορόντες|θρῴσκοντας|θρῴσκων|θοροῦσα|θόῤ|θορόντα|θρῷσκον
πορφύρω|πορφύρῃ|πόρφυρε
ἱλάομαι|ἱλάονται|ἱλασσάμενοι
κυδάνω|κύδανον|κυδάνει
ἐκτανύω|ἐξετάνυσσ̓|ἐκτανύσας|ἐξετανύσθη
προσεῖπον|προσέειπεν|προσέειπε|προτιείποι|προσέειπον
ποτινίσσομαι|ποτινίσεται
συνάντομαι|συναντέσθην|συνήντετο|συναντόμενος
εἰσνοέω|εἰσενόησα|εἰσενόησεν
καταπήγνυμι|κατέπηξαν|κατέπηξεν|κατέπηκτο
δνοπαλίζω|ἐδνοπάλιζεν|δνοπαλίξεις
ἑρπύζω|ἑρπύζων|ἑρπύζοντ̓
κνώσσω|κνώσσουσ̓
χράω|κέχρητ̓|χρείων|χρησομένους|χρησόμενος|κεχρημένῳ|κεχρημένος|ἔχραε|κεχρημένον|κεχρημένοι|ἐχράετ̓|χρησόμενον
ἐγκεράννυμι|ἐγκεράσασα
παραδαρθάνω|παραδραθέειν|παρέδραθεν
σηκάζω|σήκασθεν
ἐπικραίνω|ἐπικρήηνον|ἐπικρήνειε|ἐπεκραίαινε
ἀπαμάω|ἀπαμήσειε
κατευνάζω|κατεύνασθεν
ὀνειδίζω|ὀνείδισας|ὀνείδισον|ὀνειδίζων
ἀσχάλλω|ἀσχάλλῃς
ἕπω|ἕπον|ἕποντα|ἕπουσιν
δέμω|ἔδειμε|ἔδειμαν|δέδμητο|δέμον|ἐδέδμητο|ἔδειμα|δείμαθ̓|ἐδείματο|δείμομεν
εἴρω|ἐερμένον|εἴρεσθ̓|ἔερτο|εἴρωμαι|εἴρηται|εἴρω
παρέχω|παρέχουσιν|παρέχῃ|παρασχέμεν|παρέχει|παρέχουσαι|πάρεχον|παράσχῃ|παρέξει|παρασχεῖν|παρεῖχον|παρέχωσι|παρέχοιμι|παρέξω
ἔρομαι|εἰρέσθω|εἰρόμεναι|εἴρηται|εἴρηαι|εἰρησόμεθ̓|ἐρέεσθαι|εἰρομένῃ|εἴρετο|ἐρώμεθα|ἐρέωμαι|εἰρώμεθα|ἐρέοντο|εἰρήσομαι|εἴροντο|εἰρόμενος|εἰρομένῳ|εἴρεαι|εἴρεσθαι|εἴρεο|εἴρομαι|εἰρήσεται|ἔροιτο|ἐρέσθαι
θαυμαίνω|θαυμανέοντες
ἐπικλύω|ἐπέκλυεν|ἐπέκλυε
ἐπινέω|ἐπένησε
διακοσμέω|διεκόσμεον|διεκοσμήσαντο|διακοσμηθεῖμεν
ὠμοθετέω|ὠμοθετεῖτο|ὠμοθέτησαν
δηθύνω|δηθύνοντ̓|δήθυνεν|δηθύνων|δηθύνῃσθα|δηθύνειν
γυμνόω|γυμνώθη|γυμνωθείη|γυμνοῦσθαι|γυμνωθέντα|ἐγυμνώθη
ἀναμαιμάω|ἀναμαιμάει
ἀποναίω|ἀπενάσσατο|ἀπονάσσωσιν
πονέω|πονεώμεθα|πονέεσθαι|πονεῖτο|πονήσατο|ἐπονεῖτο|πεπόνητο|πονεύμενον|πονησάμενοι|πονήσομαι|πονησάμενος|πονησόμεθ̓|πονέοιτο|πονέοντο|πονεύμενος
προβίβημι|προβιβὰς
ἀπαναίνομαι|ἀπηνήναντο|ἀπανήνασθαι
ἀμφιδινέομαι|ἀμφιδεδίνηται
ἀοιδιάω|ἀοιδιάει|ἀοιδιάουσ̓
εὐρύνω|εὔρυναν
στρωφάω|στρωφῶσ̓|στρωφᾶτ̓|στρωφᾶσθαι|στρωφῶσιν|στρωφῶσα|στρωφᾶσθ̓
ἀφρονέω|ἀφρονέοντες
ἀμφέρχομαι|ἀμφήλυθε|ἀμφήλυθεν
ἐφευρίσκω|ἐφεύρω|ἐφεύροι|ἐφεύρομεν
ἱδρύω|ἵδρυσεν|ἱδρύσασα|ἱδρύνθησαν|ἵδρυε|ἵδρυσε
ἀλύσκω|ἤλυξα|ἤλυξαν|ἀλύξαι|ἀλύσκων|ἀλύξας|ἀλύξῃς|ἀλύσκανε|ἀλύξῃ|ἀλύξειν|ἀλύξει|ἀλύξαιμεν|ἤλυξε
ἐκδύω|ἐκδῦμεν|ἔκδυνε|ἐκδὺς|ἐξεδύοντο
οὐτάζω|οὔτασε|οὐτασμένος|οὔταζον|οὔτασεν|οὐτάσῃ|οὔτασ̓|οὔτασται|οὐτάζοντο|οὐτάζων|οὐτάσαι
ἀκούω|ἀκούσῃ|ἀκούσεαι|ἀκούοντες|ἀκούειν|ἀκούετε|ἤκουσ̓|ἀκούσαμεν|ἀκουούσης|ἀκούουσαι|ἀκούω|ἀκούοντος|ἀκούσειαν|ἀκούσας|ἀκούων|ἀκούομεν|ἄκουσαν|ἀκουόντεσσι|ἤκουσεν|ἄκουεν|ἀκούει|ἄκουον|ἄκουσε|ἀκούετο|ἀκούσω|ἀκοῦσαι|ἄκουε|ἀκουέμεναι|ἠκούομεν|ἄκουσεν|ἀκούσαντες|ἄκουσον|ἄκουσας|ἄκουσα|ἀκουέμεναί|ἀκούουσ̓|ἄκουσ̓|ἀκούσονται|ἀκούεις|ἀκούσῃς|ἀκούσαι|ἤκουσα|ἤκουσε|ἀκουέμεν|ἀκουσάτω
ἐπιδινέω|ἐπιδινήσας|ἐπιδινηθέντε|ἐπιδινεῖται
ἀντέχω|ἀντίσχεσθε
πλέκω|πλεξάμενος|ἔπλεξε
κηκίω|κήκιε
ἀσχαλάω|ἀσχαλόωσι|ἀσχαλάαν|ἀσχαλόων|ἀσχαλάᾳ|ἀσχαλόωντα
δυσωρέομαι|δυσωρήσωνται
φθονέω|φθονέειν|φθονέω|φθονέοιμι|φθονέουσ̓|φθονέεις
προτιόσσομαι|προτιόσσετο|προτιόσσετ̓|προτιόσσομαι|προτιόσσεο
προιάπτω|προϊάψειν|προϊάψει|προΐαψεν
ἀποστυφελίζω|ἀπεστυφέλιξεν|ἀπεστυφέλιξαν
αὔω|ἀΰσας|αὖε|ἀΰσαντες|αὔοι|ἄυσαν|ἤϋσεν|ἤϋσε|ἄϋσε|ἄϋσεν|ἀϋσάντων|ἤϋσ̓|ἀῦσαι
κατατίθημι|καταθείομεν|καταθέντε|καταθήσω|κατθέμεν|κατέθηκαν|κάτθετε|κάτθεμεν|καταθεῖναι|κάτθετ̓|κατέθηκεν|καταθεὶς|κατθέμεθα|κατέθηκε|κατθέσθην|κατέθηχ̓|κατέθηκα|κατέθηκ̓|κατέθεντο|κάτθεσαν|κατθέμενοι|κατέθεντ̓|καταθήσει|καταθείομαι|καταθέσθαι
ἀπουρίζω|ἀπουρίσσουσιν
κεράω|κερῶντό|κερόωντο|κεράασθε|κερόωντό|κερῶντάς
χαλέπτω|χαλέπτει
βουλεύω|βουλευσέμεν|βουλεύῃσι|βουλεύωσ̓|βουλεύει|βουλεύσας|βουλεύσαντε|βούλευσαν|βουλεύειν|βουλεύσομεν|βούλευε|ἐβούλευσας|βούλευον|βουλεύουσιν|βουλεύσῃ|βουλεύῃσθα|βουλεύσατο|βουλευέμεν|βουλεύσωμεν|βούλευσα|βουλεύουσι
ἀπόρνυμι|ἀπορνύμενον
ὁμόω|ὁμωθῆναι
ἐπέρχομαι|ἐπήλυθεν|ἐπελεύσεσθαι|ἐπέλθωσιν|ἐπῆλθον|ἐπελθών|ἐπερχόμενον|ἐπήλυθον|ἐπελήλυθα|ἐπήλυθε|ἐπερχόμεναι|ἐπελθόντες|ἐπέλθῃ|ἐπελθὼν|ἐπῆλθεν|ἐπερχομένη|ἐπῆλθε|ἐπέλθῃσιν|ἐπερχομένων|ἐπερχομένους|ἐπέλθω|ἐπέρχεαι
στεῦμαι|στεῦτο|στεῦτ̓|στεῦται
ἐρωέω|ἠρώησαν|ἐρωήσει|ἐρωείτω|ἐρωήσουσι|ἐρωήσαιτ̓|ἐρωῆσαι|ἐρώει|ἐρωεῖ
διδάσκω|δεδιδάχθαι|διδασκόμενος|δίδαξε|διδάσκουσιν|διδασκέμεν|διδασκέμεναι|ἐδίδαξε|ἐδίδαξαν|διδάξαμεν
πάρημαι|παρήμενοι|παρήμενον|παρήμενος|παρημένω
μυθέομαι|μυθησαίμην|μυθεῖται|μυθέσκοντο|μυθήσατο|μυθεῖαι|μυθήσαιο|μυθεῖτ̓|μυθήσασθε|μυθήσαιτο|μυθήσασθαι|μυθέαι|μυθείσθην|μυθεόμην|μυθήσομαι|ἐμυθεόμην|μυθέομαι|μυθήσεαι
λωβεύω|λωβεύεις|λωβεύω
ἀποχάζομαι|ἀποχάζεο
ἀμφινέμομαι|ἀμφενέμοντο|ἀμφινέμονται
πέρθω|πέρσε|πέρσας|ἔπραθον|ἔπερσεν|πέρθετο|περθομένη|πέρσειαν|πέρσα|πέρσαντες|πέρθαι|πέρσεν|πέρσειν|πέρθοντε|πέρσεται
ἁλίσκομαι|ἁλοίην|ἁλοίη|ἁλώμεναι|ἁλώω|ἁλοῦσά|ἁλόντε|ἥλω|ἁλῶναι|ἁλώῃ
ἀβροτάζω|ἀβροτάξομεν
αἴρω|ἄρησθε|ἄρηται|ἀρόμην|ἀρέσθαι|ἤρἀ|ἀρθείς|ἀροίμην|ἀρέσθ̓|ἤρατο|ἠράμεθα|ἄρηαι|ἀρθεὶς|ἄροιο|ἄρετ̓|ἤρατ̓|ἄροντο|αἴροντας|ἄροιτο
ἁρπάζω|ἁρπάξασα|ἥρπαξ̓|ἁρπάξαντε|ἥρπασε|ἁρπάσῃ|ἁρπάξων|ἁρπάζοντε|ἁρπάξαν|ἥρπαξε|ἥρπασεν|ἁρπάξας
προσλέγω|προσέλεκτο
κατασκιάω|κατεσκίαον
ἐπαίσσω|ἐπαΐσσων|ἐπήϊξαν|ἐπαῖξαι|ἐπαΐσσοντα|ἐπήιξα|ἐπαΐξασθαι|ἐπαΐσσει|ἐπαΐξασκε|ἐπαΐσσονται|ἐπαΐξανθ̓|ἐπαΐξαι|ἐπαΐξας|ἐπαΐξαντες|ἐπήϊσσον
ἐπιπλήσσω|ἐπιπλήσσων|ἐπιπλήσσεις|ἐπιπλήξειν
ἐπέλπομαι|ἐπιελπόμενος|ἐπιέλπεο
ἀπαρέσκω|ἀπαρέσσασθαι
ἀποστίλβω|ἀποστίλβοντες
τρύχω|τρυχόμενός|τρύχουσι|τρυχώμεθα|τρύξοντα
τρύζω|τρύζητε
ὀρθόω|ὤρθωσε|ὀρθωθείς|ὤρθωσεν|ὀρθωθεὶς
ἀνίημι|ἀνιεῖσα|ἄνεσάν|ἀνιεμένη|ἀνήη|ἀνέντες|ἀνιείης|ἀνήῃ|ἀνίει|ἀνιεμένους|ἀνήσει|ἀνιεῖς|ἀνίησιν|ἀνῆκεν|ἀνέηκεν|ἀνῆκε|ἀνῆκας
καταδαρθάνω|καταδράθω|κατέδραθον|καδδραθέτην
ἀγρώσσω|ἀγρώσσων
κυβερνάω|κυβερνῆσαι
εὔχομαι|εὔξατο|εὔχεται|εὔχετ̓|εὔχεαι|εὐξαμένου|εὐχόμεναι|εὐχομένοιο|εὐχόμεθ̓|εὐξαμένοιο|εὐξαίμην|εὔχομαι|εὐχομένου|εὐχόμενος|εὔχἐ|εὔχεσθαι|εὔχεο|εὐξάμενος|εὔχομ̓|εὐχόμενόν|εὔξεαι|εὐχομένης|εὔχεσθε|εὐξάμενός|εὐξάμενοι|εὐχομένοισι|εὐξαμένῃ|εὐχομένω|εὐχομένη|εὔχοντο|εὔχετο|εὐχόμενοι|εὔξαντο
ἐρεύθω|ἐρεῦσαι|ἐρεύθων
ἀπομυθέομαι|ἀπεμυθεόμην
κτερεΐζω|κτερεΐξαι
ἀμφιπεριστέφομαι|ἀμφιπεριστέφεται
ἐπινηνέω|ἐπινήνεον|ἐπενήνοθε
μαστίω|μαστίεται|μάστιε
ὀρχέομαι|ὠρχείσθην|ὀρχήσασθαι|ὀρχεῦντ̓
ἐπιρράσσω|ἐπιρρήσσεσκε|ἐπιρρήσσεσκον
ἐγχρίμπτω|ἐγχριμφθεῖσα|ἐνιχριμφθέντα|ἐγχριμφθείς|ἐγχριμφθήτω|ἐγχρίμπτοντο|ἐγχρίμψας
εἰσμαίομαι|ἐσεμάσσατο
δαμνάω|δάμνα|ἐδάμνα|δαμναμένους|δαμνᾷ
ὑποφθάνω|ὑποφθαμένη|ὑποφθὰς|ὑποφθάμενος
ἐπινέμω|ἐπένειμε
συνορίνω|συνορινόμεναι
ψηλαφάω|ψηλαφόων
βιβάσθω|βιβάσθων
ἀτάλλω|ἄταλλε
μίμνω|ἔμιμνον|μίμνοι|μίμνετ̓|μίμνων|ἐμίμνομεν|ἔμιμνεν|μίμνεν|μίμνετε|ἔμιμνε|μίμνον|μίμνειν|μίμνε|μιμνόντεσσι|μίμνει|μίμνομεν|μίμνῃ|μιμνέτω|μίμνεις|μίμνω|μίμν̓|μίμνουσι
κίνυμαι|κίνυντο|κινυμένων|κινυμένοιο|κινύμενος
ἐρεύγομαι|ἐρυγόντα|ἐρευγόμενοι|ἤρυγεν|ἐρευγόμενον|ἐρευγομένης|ἐρεύγεται|ἐρεύγετο
ἀπαμείβομαι|ἀπαμειβόμενος|ἀπαμείβετο|ἀπαμειβόμενοι|ἀπαμειβόμενον
ἐκπατάσσω|ἐκπεπαταγμένος
στεφανόω|ἐστεφάνωτο|ἐστεφάνωται
ἀπομηνίω|ἀπομηνίσας|ἀπομηνίσει|ἀπομηνίσαντος
ἐμβάλλω|ἐμβάλλετε|ἔμβαλ̓|ἐμβάλετ̓|ἔμβαλον|ἔμβαλεν|ἐνέβαλλε|ἐμβάλλεο|ἐμβάλοι|ἐμβαλέειν|ἔμβαλε
εἰσαθρέω|ἐσαθρήσειεν
καθιδρύω|καθίδρυε
ῥυπόομαι|ῥερυπωμένα
ἀμφικεάζω|ἀμφικεάσσας
κλονέω|κλονέωσι|κλονέοντα|κλονέοντε|κλονέοντας|κλονέοντο|κλονέονται|κλονέων|κλονέει|κλονέεσθαι
ἀλετρεύω|ἀλετρεύουσι
περιπλέκω|περιπλέχθη|περιπλεχθεὶς
ἀθρέω|ἀθρῆσαι|ἀθρήσειε
διέπω|δίεπε|διέπουσ̓|δίεπ̓
φορέω|φορέουσιν|φορέεσκον|φορῆναι|φορέοντες|φορέῃσιν|ἐφόρει|φορέεις|φορέοις|φόρεον|φορέειν|φόρει|ἐφόρεον|φορέῃσι|φορέουσα|φόρησεν|φορέεσκε|φορέει|φορεούσας|φορέουσι|φοροίη|φορήμεναι
μετατρέπομαι|μετατρέπομ̓|μετατρέπῃ|μετατρέπεται
ἀναστεναχίζω|ἀνεστενάχιζ̓
βρίζω|βρίζοντα
ἐξεῖδον|ἔξιδεν
κονέω|κονίοντες
προερέσσω|προέρεσσαν|προερέσσαμεν
χραύω|χραύσῃ|ἔχραε
καταδέρκομαι|καταδέρκεται
νέομαι|νεώμεθ̓|νέηται|νεώμεθα|νεοίατο|νεῖαι|νέομαί|νέονται|νεόμην|νέομαι|νεῖται|νεῖσθαι|νέηαι|νεοίμην|νεοίμεθα|νεῦμαι|νεέσθω|νεῖτ̓|νέεσθαι|νέοντο|νεέσθων
διαπέταμαι|διέπτατο
κάρφω|κάρψω|κάρψεν
γέντο|γέντο
ἐξονομαίνω|ἐξονομήνῃς|ἐξονομῆναι
ἐξορμάω|ἐξορμήσασα
κροταλίζω|κροτάλιζον
πινύσκω|ἐπίνυσσεν
μοχθίζω|μοχθίζοντα
ἐπιρρέω|ἐπέρρεον|ἐπιρρέει
ἐρχατάομαι|ἐρχατόωντο
ἀμφιάζω|ἀμφιέσασα|ἀμφιέσαιμι|ἀμφιέσασθε|ἀμφιέσω
καθάπτω|καθαπτόμενος|καθαπτόμενοι|καταβήμεναι|καθάπτεσθαι|καθάπτετο
κλάζω|ἔκλαγξαν|κεκληγὼς|κλάγξας|κεκλήγων|κεκληγῶτας|κλάγξαντος|κεκλήγοντες|κλάζοντε
ἀποδατέομαι|ἀποδάσσεσθαι|ἀποδάσσομαι
πείθω|πεπιθοῦσα|πεποίθασίν|πιθήσεις|πείθηται|πεπίθοιθ̓|πίθηται|πιθοίατο|πείσονται|πείθῃ|πεποιθὼς|πεποιθώς|πεῖθε|πείθεσθ̓|ἔπειθον|πείθοντο|πείθεσθαι|πιθόμην|πείθοντό|πειθώμεθα|πείθονται|πείσειε|πεπίθοιεν|πείθεο|πείθοντ̓|πείθεις|πίθοντο|πεποίθω|πειθέσθην|πεπιθεῖν|πιθέσθαι|πεποιθότας|πεπίθωμεν|πίθεσθ̓|πείσεται|πειθόμενοι|πείσεσθαι|πείσεις|πιθήσας|πεπιθήσω|πίθεσθε|πεῖθ̓|πείθευ|πίθηαι|ἐπίθοντο|πείθεσθαί|πείθεό|πείθεθ̓|πεῖθεν|πείσειν|πείσομαι|πείθωνται|πίθεσθέ|πείθομαι|πιθέσθην|πείθω|ἐπείθετο|πειθόμενος|πεῖθον|πείσεἰ|πεπίθοιμεν|πεποίθεα|πείσει|πεποίθῃς|πιθώμεθα|πειθοίατο|πεισέμεν|ἔπειθε|πείσομ̓|πέποιθα|πεποιθότες|πίθοιό|πέποιθε|πείσεαι|πιθέσθων|ἐπέπιθμεν|πεποίθομεν|ἐπεποίθει|πίθοιο|ἔπειθεν
παραμείβω|παραμειψάμενος
ἐξηγέομαι|ἐξηγείσθω
ναυτίλλομαι|ναυτίλλεται|ναυτίλλεσθαι
ἐκπέρθω|ἐκπέρσουσ̓|ἐκπέρσειν|ἐκπέρσαντα|ἐκπέρσει|ἐκπέρσωσ̓|ἐξεπράθομεν|ἐκπέρσῃς|ἐκπέρσαντ̓|ἐκπέρσαι|ἐκπέρσαντες
μιμνάζω|μιμνάζειν
εἰσφορέω|ἐσφόρεον
ἀφρέω|ἄφρεον
καθέζω|καθεζόμενος
μειλίσσω|μειλισσέμεν|μειλίσσεο
ἀμφαγείρομαι|ἀμφαγέροντο
ἐπαείρω|ἐπάειραν
τετευχῆσθαι|τετευχῆσθαι
λαμπετάω|λαμπετόωντι
ἀσπάζομαι|ἠσπάζοντ̓|ἠσπάζοντο
ἀλύσσω|ἄλυξεν|ἄλυξαν|ἀλύσσοντες
σίζω|σίζ̓
ἀναδέρκομαι|ἀνέδρακεν
ὠθέω|ὦσαι|ὦσε|ὤσῃ|ὦσεν|ὤθεσκε|ὤθει|ὦσα|ὤσαντο|ὤσαισθε|ὠθεῖ|ὤσασκε|ὤσαιμεν|ὠσάμεθ̓|ὤσατο|ἔωσε|ὤσασθαι|ὤσαιτο|ὤσαιτ̓|ὦσαν|ὦσας
σπάω|σπασθέντος|σπάσατ̓|ἔσπασεν|σπασσάμενος|σπάσσατο|σπάσσασθε|σπάσεν|σπασάμην|ἐσπάσατο|ἐσπάσατ̓
δειδίσσομαι|δειδίσσεσθαι|δειδίσσεαι|δειδίξασθαι|δειδίσσετο|δειδισσέσθω|δειδίσσεο|δειδίξεσθαι
σπένδω|σπένδεσκε|σπεῖσαι|σπένδοντας|σπένδεσκον|σπένδοντ̓|σπείσομεν|σπένδων|σπείσαντες|σπένδῃσθα|ἔσπεισαν|σπένδῃ|σπείσασκε|σπεῖσον|σπείσας|σπένδοντες|σπείσῃς|σπεῖσάν
μεταίζω|μεταΐζειν|μετεισάμενος
ἀλφάνω|ἦλφον|ἄλφοι
ἠλάσκω|ἠλάσκουσιν|ἠλάσκουσαι
καταλείβω|καταλειβομένοιο|καλλείψω
περιστρέφω|περιστρέψας
σαλπίζω|σάλπιγξεν
ἴσκε|ἴσκε|ἴσκεν
ἀναλέγω|ἀλλέξαι|ἄλλεγον
διαπτοέω|διεπτοίησε
περιστεναχίζομαι|περιστεναχίζετο
ἀποκηδέω|ἀποκηδήσαντε
ἐξίημι|ἐξέμεν|ἐξιέναι
τετραίνω|τέτρηνεν|τέτρηνε|τέτρηνα
μέτειμι|μετέμμεναι|μετέω|μετέσσεται|μετείη|μετέσσομαι|μέτειμι|μετεῖναι|μέτεισι|μετείην|μετέασι|μετείω|μετέῃσιν
προφαίνω|προὐφαίνετο|προύφαινε|προυφαίνετ̓|προφανέντε|προφανέντ̓|προπέφανται|προύφαινον
ἀπολούω|ἀπολούσομαι
μεταμίγνυμι|μεταμίξομεν|μετέμισγον
ἐπιστρωφάω|ἐπιστρωφῶσι
ἵημι|ἧκ̓|ἥσειν|ἱέμενος|ἱεῖσι|ἕσαν|ἱέμενόν|ἕντο|ἵησιν|ἧκεν|ἱέμενον|ἧκα|ἧκε|ἱέμενοι|εἷναι|ἱέμεναι|ἵεται|ἵενται|ἱεμένοιο|ἥσω|ἵεσθε|ἧκέ|ἱέσθην|ἱεμένους|ἕηκε|ἱεμένη|ἱέμενός|ἵεν|ἵει|ἱέντες|ἱεμένῳ|ἵετ̓|ἱέμενοί|εἵην|ἧκαν|ἵετο|ἱεμένων|ἵησι|ἱεῖσαι|ἥσει|εἵη|ἱεμένω|ἵεντ̓|ἱεμένην
ζέω|ζεῖ|ζέε|ζέσσεν
ὀροθύνω|ὀρόθυνεν|ὀρόθυνον|ὀρόθυνε|ὀροθύνει
ἑλκυστάζω|ἑλκυστάζων
ἐρέπτομαι|ἐρεπτόμενοι|ἐρεπτομένους
ἐλύω|ἐλυσθείς|ἐλυσθεὶς|ἐλύσθη|ἔλυσεν|ἔλυσαν
ὑποτρέω|ὑπέτρεσαν|ὑπέτρεσας|ὑποτρέσαι
ἐγκύρω|ἐνέκυρσε
ἐπιμέμφομαι|ἐπιμέμφομαι|ἐπιμέμφεαι|ἐπιμέμφεται
γιγνώσκω|γιγνώσκουσα|γιγνώσκετε|γνώωσι|γιγνώσκω|γνοίη|γνώω|γνώῃς|γνώῃ|γνῶναι|γνῶτε|γνώομεν|γνώσεαι|γιγνώσκοντες|ἔγνωσαν|γιγνώσκεις|ἔγνως|γνῶμεν|γνῶσιν|γνοίην|γνωσόμεθ̓|γιγνώσκῃς|γνῶτον|γίγνωσκε|γιγνώσκων|ἔγνων|γνοίης|γνῶ|γνῷ|γνοῖεν|γνώσεται|γνῷς|γνώσῃ|γνώτην|γιγνώσκειν|γνώμεναι|γνώσεσθε|γνώσετ̓|γίγνωσκον|ἔγνω
ὀρίνω|ὀρινομένῳ|ὄρινας|ὄρινεν|ὤρινεν|ὠρίνετο|ὀρινόμενοι|ὀρινθείη|ὤρινάς|ὀρίνων|ὀρινομένη|ὀρίνω|ὀρίνονται|ὠρίνθη|ὀρίνει|ὀρίνθη|ὀρίναις|ὀρινθέντες|ὀρινομένους|ὤρινε|ὀρίνῃς|ὀρινόμενον|ὄρινα|ὀρίνετον|ὄρινε
κατάγω|κατήγετο|κατάγοντο|κατηγαγόμεσθα|κατάγειν|κατήγαγεν|κατάγων|καταξέμεν
ἐπιμιμνήσκομαι|ἐπιμνησαίμεθα|ἐπιμνησθεὶς
ἧμαι|ἧσο|ἥμεθα|ἧσθαι|ἡμένη|ἥμενος|ἧστό|ἧστ̓|ἥμεναι|ἧσ̓|ἧσαι|ἥμεθ̓|ἥμενον|ἥατ̓|ἧμαι|εἵαθ̓|ἕατ̓|ἥσθην|ἧσθ̓|εἵατο|ἧστο|ἥατο|εἵατ̓|ἥμην|ἧσται|ἥμενοι|ἕαται|εἵαται
οἴομαι|ὀϊομένοισι|ὀϊόμενος|ὀϊόμεθ̓|ὀϊόμενός|ὀίομαι|ὀΐσατο|ὀϊόμενον|οἴομαι|ὠΐετο|ὀϊομένῳ|ὀΐομαι|ὠΐσθη|ὀιομένη|οἴοιτο|ὀΐω|ὠίετο|ὀισάμενος|ὀϊσθεὶς|ὀίσατο|ὀίεαι|ὀΐεται|ὀΐεαι|ὀϊσάμενος|ὠΐσθην|ὀίω
ἀρνέομαι|ἀρνήσασθαι|ἀρνήσαιο|ἀρνείσθω|ἠρνεῖτο|ἀρνεῖται
προθέω|πρότιθεν|προθέῃσι|προθέεσκε
συλάω|συλήσας|σύλησας|ἐσύλα|συλήσω|συλήτην|συλήσετε|σύλα|συλήσων|συλήσειε|συλήσωσι|συλήσειν
τρίζω|τετριγῶτας|τετριγυῖαι|τρίζουσαι|τετριγυῖα|τετρίγει
λαβρεύομαι|λαβρεύεαι
φρονέω|φρονέουσιν|φρονέεις|φρονέοντε|φρονέουσ̓|φρονέῃσ̓|φρονέειν|φρονέουσι|φρονέοντες|φρονέοντι|φρόνεον|φρονέοντα|φρονεόντων|φρονέων|φρονέουσα|φρονέοντ̓|φρονέῃσι|φρονέω
περιχώομαι|περιχώσατο
ἀναίσσω|ἀναΐξειεν|ἀναΐξαντες|ἀναΐξασα|ἀναΐξαντ̓|ἀναΐξαντε|ἀναΐσσουσι|ἀνήϊξαν|ἀναΐξειαν|ἀναΐξας
μεθίστημι|μεταστήσω|μεθίστατο
ἐποχέομαι|ἐποχήσεται
κείρω|κεῖρε|κείρετ̓|κείρασθαί|κείροντες|κείροντό|ἐκείρετε|ἔκερσεν|κειρόμενοι|κείροντας|κέρσαντες|κερέειν|ἔκειρον|κείρει|κέρσε
ψαύω|ψαύσῃ|ψαύουσιν|ψαῦον
οἰμάω|οἴμησε|οἴμησεν
ἐμπλήσσω|ἐνιπλήξωμεν|ἐνιπλήξαντες|ἐνιπλήξωσι
κυρτόω|κυρτωθέν
ἐπικλείω|ἐπικλείουσ̓
παραβλώσκω|παρμέμβλωκεν|παρμέμβλωκε
περιτρέχω|περίδραμον
μεθίημι|μεθῆκε|μεθίει|μεθήσετε|μεθέμεν|μεθήσομεν|μεθῆκεν|μεθιέντας|μεθιεῖ|μεθίετε|μεθείη|μεθήσει|μεθῶμεν|μεθιέντα|μεθησέμεν|μεθίῃσι|μεθείω|μεθίεις|μέθιεν|μεθέηκεν|μεθιέμεναι|μεθίεμεν|μεθέηκε|μεθιέμεν|μεθιεῖς|μεθήσω|μεθέηκα|μεθησέμεναί
ἰδνόομαι|ἰδνωθείς|ἰδνωθεὶς|ἰδνώθη
δίω|δίεσθαι|δίωνται|δίωμαι|δίοιτο|δίε
δυσμενέων|δυσμενέοντες
περάω|περήσειν|πέραον|περῶντα|περάαν|πέρησε|περῆσαι|ἐπέρησα|ἐπέρασσαν|περόωσι|περήσω|περάσητε|πέρασαν|ἐπέρασσας|ἐπέρασσα|ἐπέρησε|ἐπέρησεν|περάασκε|ἐπέρασσε|περησέμεναι|περάσειε|περόωσιν|πέρησεν|περήσαμεν|περήσῃς
διοιστεύω|διοϊστεύσειν|διοϊστεύσῃ|διοϊστεῦσαί|διοϊστεύσειας
ἱερεύω|ἱέρευτο|ἱέρευσεν|ἱερεύσομεν|ἱρεύουσ̓|ἱερεύσω|ἱέρευσε|ἱρεύεσκον|ἱερεύσατε|ἱερεύοντες|ἱέρευον|ἱερεύετε|ἵρευον|ἱέρευσαν|ἱερευσέμεν|ἱερεύσειν|ἱρεύσασθαι|ἱέρευσ̓|ἱερεύσαντες
περιστέλλω|περιστείλασα
ἐφέζομαι|ἐφέζεσθαι|ἐφέζετο|ἐφεζόμενος|ἐφεζόμενοι|ἐφεζομένη
καθικνέομαι|καθίκεο|καθίκετο
δοάσσατο|δοάσσεται|δοάσσατο
ἀλογέω|ἀλογήσει|ἀλογήσεις
θηρεύω|θηρεύοντ̓
γεφυρόω|γεφύρωσεν
προπέμπω|προὔπεμψα|προὔπεμψε|προὔπεμψεν|προὔπεμψ̓
ὑπεκπροθέω|ὑπεκπροθέει|ὑπεκπροθέοντα|ὑπεκπροθέων
ὑφέλκω|ὕφελκε
κελαρύζω|κελάρυζεν|κελάρυζε|κελαρύζει
ἀάω|ἄασας|ἄασάν|ἄασ̓|ἀᾶται|ἀάσθην|ἀάσθη|ἄασεν|ἀασάμην|ἄσατο|ἀάσατο|ἆσέ|ἀασθεὶς
φορμίζω|φορμίζων
ἀποδύνω|ἀπέδυνε|ἀποδὺς|ἀπέδυσε
καταπλέω|κατεπλέομεν
πέμπω|πέμπ̓|πέμψουσι|ἔπεμψεν|ἔπεμπον|πέμπε|πέμπον|ἔπεμψε|πέμπετέ|πέμψῃς|πέμπων|πέμψας|πέμπωμεν|πέμψαντες|πεμπέμεν|πέμψεν|πεμπέμεναι|πέμψαιμι|πέμπω|πέμψειν|πέμψον|πέμπῃσιν|ἔπεμπε|ἔπεμψαν|πέμπεν|πέμπωσι|πέμψω|πέμψειεν|πέμψουσιν|πέμποιεν|πέμψει|πέμψαι|πέμψομεν|πεμψέμεναι|πέμψειας|πέμπειν|πέμψωμεν|πέμψαν|πέμπουσιν
στυγέω|ἔστυγον|στυγέῃσι|στυγέει|στύξαιμι|στυγέῃ|στυγέουσι|στυγέῃσιν
ἀναρπάζω|ἀνήρπαξαν|ἀναρπάξας|ἀναρπάξασα|ἀναρπάξασαι|ἀνήρπασε
ἐμέω|ἐμέων
ποτιπτύσσω|προσπτύξομαι|προσπτύξατο|προσπτύξεται|ποτιπτυσσοίμεθα
ἐξαρπάζω|ἐξήρπαξεν|ἐξήρπαξε|ἐξήρπαξ̓|ἐξαρπάξασα
δινεύω|δινηθήτην|δινηθῆναι|ἐδίνευον|δινεύων|δινήσας|δινεύεσκ̓|δίνεον|δινείσθην|δινεύουσαν|δινέομεν|ἐδινεόμεσθα|ἐδίνεον|δινεύοντες|δινεύοι
ὑπέχω|ὑποσχὼν|ὑπέσχετο
ἐνειμί|ἔνεστιν
ἐξανίημι|ἐξανιεῖσαι
ἀναβρόχω|ἀναβρόξειε|ἀναβροχέν
ξενίζω|ξείνισας|ξείνισ̓|ξείνισσεν|ξεινίζειν|ξείνισσε|ξείνισσας|ξεινίσαι|ξεινίσσομεν|ἐξείνισσα
προίστημι|προστήσας
ἐξάρχω|ἐξῆρχε|ἐξάρχων|ἐξάρχοντες|ἐξήρχετο
τίλλω|τίλλοντό|τιλλέσθην|τίλλων|τίλλε
τεύχω|τεύξεις|τεύχουσαι|τετύχθω|τεῦξαν|τεῦχεν|τετύκοντο|τετυκέσθαι|τέτυκται|τετυγμένον|ἔτευξε|τετεύξεται|τεύχοιμι|τετυγμένα|τεύξας|τεύξῃ|ἔτευχεν|ἐτέτυξο|τεῦξ̓|τέτυξο|τεύχων|ἐτέτυκτο|ἐτεύχετον|τεύχειν|τετύγμην|τέτυκτο|τεύξασα|τετυκοίμεθα|τεύξεἰ|ἔτευξα|τεύξειε|τεύξω|ἐτύχθη|τετύκοντό|τετυκεῖν|τετύχθαι|τεύξει|ἔτευξ̓|ἔτευχε|τεύξειεν|τεύξομεν|ἔτευξεν|τεύχει|τεῦχε|τεύχοντ̓|ἔτευξαν|τετυγμένος|τέτυξαι|τεῦξε|τεύξειν|τευχούσῃ|τετεύχατο|τεύξουσι|τετεύχαται
ἀγνοέω|ἠγνοίησεν|ἀγνοιῇσι|ἀγνώσασκε|ἀγνοιήσασ̓
ἀμύνω|ἀμυνομένῳ|ἀμῦναι|ἀμυναίμην|ἀμύνετο|ἀμυνέμεναι|ἀμύνει|ἀμύναι|ἀμύνῃς|ἀμύνουσιν|ἀμυνέμεν|ἀμυνόμενον|ἀμυνόμενος|ἀμύνεσθαι|ἀμύνοιτ̓|ἄμυνεν|ἀμύνετε|ἀμυνομένων|ἀμύνω|ἀμυνόμενοι|ἀμύνεις|ἀμύνειν|ἄμυνον|ἀμύνων|ἄμυνε|ἠμύνοντο|ἀμύνοι|ἤμυνε|ἀμύνονται
ἰσάζω|ἰσάσκετο|ἰσάζουσ̓
παλαίω|ἐπάλαισεν|παλαίσεις|ἐπάλαιον
πειράω|ἐπειρήσανθ̓|πειρήσεσθαι|πειρηθεῖμεν|πειρησαίμεθα|ἐπειρήσαντ̓|πειρῶντο|πείρα|πειρηθήτω|πεπείρημαι|πειρώμενος|πειρήσαντο|πειρηθείης|πειρήσεται|πειρωμένη|πειρήσαιτο|πειρήσοντα|πειρήσομαι|πειρᾷ|πειρήσεαι|πειρήσατο|πειρᾶν|πειρήσεσθον|πειρήσομ̓|ἐπειρῶντ̓|πειρήσω|πείρησαι|πειρηθῆναι|ἐπειρήσαντο|πειρᾶται|πειρήσαιτ̓|πειρήσασθε|πεπείρανται|πειρήθη|ἐπειρᾶτο|πειρηθήμεναι|πειράτω|πειρηθῶμεν|πειρηθῆτον|πειρήσεσθε
στερέω|στερέσαι
παρατυγχάνω|παρετύγχανε
προσαίσσω|προσαΐξας
στυφελίζω|ἐστυφέλιξε|ἐστυφέλιξαν|στυφελίζετε|στυφελίξῃ|στυφέλιξε|ἐστυφέλιξεν|στυφελίξαι|στυφελιζομένους|στυφελίζειν
κατακοσμέω|κατακοσμήσησθε|κατεκόσμει
μίγνυμι|μιγεῖσα|μιγέντα|μιγήσεσθαι|μίσγεσθαι|μίσγεσθ̓|ἔμικτο|ἐμίγην|ἐμίχθη|μιγέντε|μιγείης|μίσγοντό|μίσγεται|μιγῆναι|μισγομένων|μιχθεὶς|μέμικτο|μεμιγμένον|ἔμιξαν|μεμιγμένα|ἐμισγέσθην|μιγέωσιν|μίσγον|μίσγεαι|μιγήῃς|μισγέμεναι|μεμιγμένη|ἐμίγη|μίσγηται|ἔμιχθεν|μιγείη|ἐμίσγετο|ἐμίγης|μίκτο|μιχθήμεναι|μίγησαν|μίγεν|μίξεσθαι|μῖξαι|μισγέσκετο|μιγήμεναι|μεμιγμένοι|ἐμισγόμεθ̓|ἔμισγον|μίγη|μίσγετο|μίχθη|μιγείην
προέχω|προύχοντο|προὐχούσας|προὔχοντι|προὔχοντα|πρόεχ̓|προὐχούσῃ|προύχουσιν
συρράσσω|συνέρρηκται
καταλύω|καταλύσομεν|κατέλυσε
ἐπιτέλλω|ἐπετέλλετ̓|ἐπιτεῖλαι|ἐπέτελλε|ἐπετέλλετο|ἐπίτειλον|ἐπιτείλω|ἐπετείλατο|ἐπέτελλον|ἐπιτέλλεο|ἐπέτειλας|ἐπιτειλαμένῳ|ἐπέτελλεν|ἐπιτέλλομαι|ἐπιτέλλεαι|ἐπιτείλας|ἐπιτέλλω|ἐπέτελλ̓
ὑπερπέτομαι|ὑπέρπτατο
ἀμφαφάω|ἀμφαφόωσα|ἀμφαφόων|ἀμφαφάασθαι|ἀμφαφόωντο|ἀμφαφόωντας
εἰσάγω|εἰσαγαγών|εἰσάγαγον|εἰσῆγον|ἐσάγουσα|εἰσαγαγόντες|εἰσήγαγ̓|εἰσαγαγοῦσα
ἀπονίναμαι|ἀπόνηθ̓|ἀπονήσεται|ἀπονήμενος|ἀπόναιο|ἀπόνητο
μάρπτω|μάρψει|μάρπτῃσι|μάρπτε|ἔμαρπτε|μάρψαι|ἔμαρψεν|μάρψας|μάρψῃ|ἔμαρπτεν
ἐπιβρέμω|ἐπιβρέμει
παφλάζω|παφλάζοντα
ἐξαφαιρέω|ἐξαφέλησθε
πιφαύσκω|πιφαύσκομαι|πιφαύσκεται|πίφαυσκον|πιφαύσκεο|πιφαυσκόμενος|πιφαυσκέμεν|πίφαυσκε|πιφαύσκων|πιφαύσκεαι
παραμένω|παρμένετ̓|παρέμεινεν|παρμενέμεν
μελαίνω|μελαίνετο|μελαίνετ̓
κατακείω|κατακείαται|κακκείοντες|κατέκειτο|κατάκειτ̓|κατέκειτ̓|κατακείομεν|κατακείετε|κατακεῖσθαι|κατακείμενος
κομάω|κομόωντες|κομόωντε|κομόωντας
ἐνίπτω|ἔνιπτε|ἠνίπαπε|ἐνένιπεν|ἐνίπτοι|ἐνένιπε
ἐκδέρω|ἐκδείρας
ἐγκρύπτω|ἐνέκρυψε
ἐπασκέω|ἐπήσκηται
στείχω|στείχων|στεῖχον|ἔστιχον|στείχοντα|στείχοντες|στείχειν|ἔστειχε|στείχῃσι|στείχῃσ̓
προχέω|προχέοντο|προχέειν
καλύπτω|καλύψῃ|ἐκάλυψαν|καλύψω|καλυφθείς|κεκαλυμμένοι|ἐκάλυψεν|κάλυψεν|καλύπτει|ἐκάλυψα|κεκαλυμμένος|καλύψαι|καλύψατο|κεκάλυπτο|κάλυπτε|καλύψαντες|καλυψάμενος|καλύψας|κάλυψε|κάλυψαν|κεκαλυμμέναι|καλυψάμενοι|καλύπτοι|καλύπτων|κεκάλυφθ̓|κεκαλυμμένα|ἐκάλυψε|καλυψαμένη
ἀείρω|ἄειρεν|ἤειραν|ἀείροντο|ἄωρτο|ἀερθείς|ἀείρας|ἀέρθη|ἀειράμενος|ἀείρετο|ἀειρόμενος|ἀειρέσθην|ἄειρε|ἀειρομένη|ἀειρόμενον|ἀειρόμενοι|ἄειραν|ἀείραι|ἀειρομένων|ἀεῖραι|ἤειρεν|ἀείρων|ἀερθεὶς|ἀείραντες|ἄερθεν|ἀροίμεθά|ἀειράσας|ἀειραμένη
ἐκφθίνω|ἐξέφθιτο
προμάχομαι|προμάχεσθαι
νωμάω|νώμα|νωμῶν|νωμῆσαι|ἐνώμα|ἐνώμας|νωμᾷ|νωμᾷς|νώμησεν|νώμησαν|ἐνώμων
αἰσχύνω|αἰσχυνόμενοι|αἰσχυνόμενός|ᾐσχυμμένος|ᾔσχυνε|αἰσχύνομαι|ᾔσχυνας|αἰσχυνέμεν|αἰσχύνων|αἰσχύνωσι|αἰσχύνει
ξηραίνω|ἐξηράνθη
ἐμπνέω|ἐμπνύνθη|ἔμπνυτο|ἐμπνεύσῃσι|ἐμπνείοντε|ἔμπνευσε|ἐνέπνευσε|ἐνέπνευσεν
περιτέμνω|περιταμνομένους|περιταμνόμενον
περισείομαι|περισσείοντο
παρατρέω|παρέτρεσσαν
γεραίρω|γεραίρεις|γέραιρεν
λοχάω|λοχῆσαι|λοχήσομαι|λοχῶσιν|λοχήσας|λοχησάμενος|λοχόωσιν|λοχόωντες|λοχόωσι
ἐμφορέω|ἐμφορέοντο
ἐποπίζομαι|ἐποπίζεο
συναίνυμαι|συναίνυτο
ἀφίημι|ἀφίει|ἀφέτην|ἀφέηκεν|ἀφιεῖσαι|ἀφῆκεν|ἀφήσω|ἀφέῃ|ἀφέηκε|ἀφίετο|ἀφῆκε|ἀφείη|ἀφήῃ
ὀνίνημι|ὤνησας|ὀνήσειν|ὤνησεν|ὤνησαν|ὀνήσεται|ὀνήμενος|ὄνησο|ὄνησα|ὀνήσεαι|ὀνησόμεθ̓|ὀνίνησι|ὀνήσει
προβέβουλα|προβέβουλα
ἐπιχράω|ἐπέχραον
ἀλέγω|ἀλέγει|ἀλέγουσιν|ἀλέγω|ἀλέγουσι|ἀλεγούσας|ἀλέγοντες
κατεναίρομαι|κατενήρατο
φοβέω|φόβησεν|φοβῆσαι|φόβηθεν|πεφοβήατο|φοβέουσι|φοβεῖται|πεφοβημένος|ἐφόβησε|φοβήσομαι|πεφοβημένοι|φοβέεσθαι|φοβηθεὶς|φοβεῖ|ἐφόβησας|φοβέοντο|φοβέειν|ἐφόβηθεν|φοβεύμενος|φοβῆσαί|φοβηθείς
ἀπιστέω|ἀπίστεον
βούλομαι|βούλεται|ἐβόλοντο|βούλεαι|βούλετο|βουλοίμην|βούλομαι|βούλεο|ἐβούλετο|βούλοντο|βόλεσθε|βόλεται|βούλεσθ̓|βούλομ̓
περιμαιμάω|περιμαιμώωσα
ἄρχω|ἀρξάμενοι|ἄρξειαν|ἄρξει|ἦρξα|ἄρχ̓|ἄρχοιτο|ἄρχον|ἤρξατο|ἄρχῃ|ἀρχέμεναι|ἄρχε|ἦρχ̓|ἄρχει|ἄρξειεν|ἄρχωσι|ἀρξάμενος|ἄρξωσι|ἀρχέτω|ἦρχεν|ἦρχον|ἀρξάντων|ἀρχόμενος|ἄρχετε|ἦρχε|ἄρξομαι|ἤρχετο
προσδέχομαι|ποτιδέγμενος|ποτιδεγμένω|ποτιδέγμενον|ποτιδέγμεναι|ποτιδέγμενοι
καταστόρνυμι|καστορνῦσα
ἀφαρπάζω|ἀφαρπάξαι
αὐαίνω|αὐανθέν
τμήγω|τμάγεν|τμήξας
ἐξυπανίστημι|ἐξυπανέστη
λευκαίνω|λεύκαινον
χρίμπτω|χριμφθεὶς
ἐπόρνυμι|ἐπῶρσε|ἔπορσον|ἐπόρσειαν|ἐπῶρσ̓|ἐπόρνυε|ἐπῶρτ̓
ἀναμένω|ἀνέμεινα
δήω|δήεις|δήετε|δήομεν
ἐπαμύνω|ἐπάμυνε|ἐπάμυνον|ἐπαμύνω|ἐπαμυνέμεν|ἐπαμύνειν|ἐπαμῦναι|ἐπαμύνομεν
ὑλακτέω|ὑλάκτει|ὑλάκτεον
τρυπάω|τρυπῷ
προνοέω|προνοῆσαι|προνόησαν
ἀναβέβρυχε|ἀναβέβροχεν
σφάλλω|σφῆλεν|σφῆλαι
μεθάλλομαι|μετάλμενος
παραυδάω|παραύδα|παραυδήσας|παραυδῶν
ἀπολάμπω|ἀπελάμπετο|ἀπέλαμπεν|ἀπέλαμπ̓
προκυλίνδομαι|προκυλίνδεται
ἀτιμάω|ἠτίμησ̓|ἀτιμήσεἰ|ἀτιμῆσαι|ἀτιμήσειε|ἠτίμησας|ἀτιμᾷ|ἀτιμήσασ̓|ἀτίμα|ἠτίμησεν|ἀτιμήσαιτε|ἀτιμήσουσι|ἀτίμων
ἀφίστημι|ἀφίσταται|ἀφεστᾶσιν|ἀφεσταίη|ἀφέστασαν|ἀφέστατε|ἀπέστη|ἀποστήσωνται|ἀφεστᾶσ̓|ἀφεστήκει|ἀφεσταότες
ῥώομαι|ῥώοντο|ἐρρώοντο|ῥώοντ̓|ἐρρώσαντο
καταπτήσσω|καταπτήξας
παραγίγνομαι|παρεγίγνετο
ἀνέρομαι|ἀνειρόμενος|ἀνείρηται|ἀνείρεαι|ἀνείρετο
θλάω|θλάσσε|ἔθλασεν
ἀνίστημι|ἀναστὰς|ἀνστήσασ̓|ἀναστάς|ἄνστησον|ἀναστήσονται|ἀνστήμεναι|ἀνίστατο|ἀνστήσεις|ἀναστήσειεν|ἀνστήτην|ἀνιστάμενοι|ἀνστάντες|ἀνέστη|ἀναστήσας|ἀναστῇ|ἀνστήσει|ἀνέστησεν|ἀναστήσουσιν|ἀνστὰς|ἀνστήσεσθαι|ἀνστήσων|ἀναστάντες|ἀνέσταν|ἀνιστάμενος|ἀνίστη|ἀνστᾶσα
ἀλάομαι|ἠλώμην|ἠλᾶτο|ἀλήθης|ἀλώμενος|ἀλώμενον|ἀλᾶτο|ἀλόωνται|ἀληθείς|ἀλᾶσθε|ἀλώμενοι|ἀλήθην|ἀλόω|ἀλωμένη
παρακλίνω|παρακλίνας
περιπέλομαι|περιπλομένους|περιπλομένου|περιπλομένων
ἐρευνάω|ἐρευνῶντες|ἐρεύνα|ἐρευνῶν
διατρίβω|διατρίβωμεν|διατρίβουσιν|διατρίβῃσιν|διατρίβω|διατρίψας|διατρίβειν
ἀναβαίνω|ἀναβήμεναι|ἀνέβη|ἀναβησάμενοι|ἀμβαίνωμεν|ἀμβαίνοντες|ἀναβᾶσ̓|ἀναβὰς|ἀναβῇ|ἀμβαίη|ἀναβάντες|ἀναβάς|ἀμβαίνειν|ἀνέβαιν̓|ἀναβαινέμεν|ἀνάβαινε|ἀνέβαινε|ἀνεβήσετο|ἀναβαίη|ἀναβαίνει|ἀναβᾶσα
εὑρίσκω|εὕρῃ|εὕρητε|εὑρέμεναι|εὕρωσιν|εὕρετο|εὑρίσκω|εὕρῃσι|εὗρον|εὗῤ|εὕρωμεν|εὑρὼν|εὑρεῖν|εὑροίμην|εὗρε|εὕρομεν|εὗρεν|εὕροιμι|εὕρεο
πολεύω|πολεύειν
βάσκω|βάσκ̓
ἰσοφαρίζω|ἰσοφαρίζει|ἰσοφαρίζοι|ἰσοφαρίζεις|ἰσοφαρίζειν
ἀμφιφοβέομαι|ἀμφεφόβηθεν
ὑπεξαναδύομαι|ὑπεξαναδὺς
παλάσσω|παλάσσετο|πεπαλαγμένον|πεπάλακτο|παλαξέμεν|πεπάλασθε|πεπαλάσθαι
εἴβω|εἴβοι|εἶβε|εἶβον|εἴβων|εἴβεις|εἶβεν|εἴβει
ἐκκατεῖδον|ἐκκατιδών
ὀπυίω|ὄπυιε|ὀπυίῃ|ὤπυιε|ὀπυίοντες|ὀπυίοι|ὀπυιομένη|ὀπυιέμεναι|ὀπυιέμεν
διασκεδάννυμι|διεσκέδασ̓|διασκεδάσειεν
οἶδα|εἰδέω|εἰδότε|εἴδετ̓|εἰδότες|ᾔδεεν|ἴδμεν|οἶδα|ἰδῇς|εἴσεται|εἴσομαι|εἰδείης|εἰδῇς|οἶδεν|εἰδόσι|εἰδόσιν|εἰδήσειν|ἰδῇ|εἰδότος|ἰδυίῃσι|εἰδείη|εἰδώς|εἰδόθ̓|εἰδότ̓|ἰδυῖαν|ἰδυίῃ|εἰδὼς|ᾔδεε|ἴσθ̓|ᾔδη|εἴσεαι|εἴδετε|εἰδῶσι|οἶσθ̓|εἴδομεν|ἰδυίας|ἴσασιν|ἴδμεναι|ἴστε|ἴσασ̓|ἴσθι|ἴσασι|εἴσομ̓|οἶδας|ᾔδἐ|ἴστω|οἶσθα|οἶδ̓|εἰδῶ|ᾔδησθ̓|οἶδε|οἶδέ|εἰδότα|ἠείδη|εἰδῇ
γέγωνα|γέγωνε|γεγωνώς|ἐγέγωνεν|ἐγεγώνει|γέγωνέ|γεγωνέμεν
ἀμφιβάλλω|ἀμφιβαλεῦμαι|ἀμφιβαλόντες|ἀμφιβαλέσθαι|ἀμφιβαλόντι|ἀμφιβαλόντε|ἀμφιβαλὼν
μεδέων|μεδέων
ἑψιάομαι|ἑψιαάσθων|ἑψιάασθαι
ἐρητύω|ἐρητύοντο|ἐρητύειν|ἐρητύσειέ|ἐρητύετ̓|ἐρήτυον|ἐρήτυε|ἐρητύοντό|ἐρήτυθεν|ἐρητύεται|ἐρητύσασκε
καταφλέγω|καταφλέξω
ἐπιπροίημι|ἐπιπροέηκεν|ἐπιπροέηκε|ἐπιπροέμεν|ἐπιπροέηκα
φορύνω|φορύνετο
ἀποσκίδναμαι|ἀποσκίδνασθαι
πέλω|ἔπλετο|πέλει|πέλεν|ἔπλεο|ἔπλευ|πέλονται|πέλωνται|πέλευ|πέληται|πελώμεθ̓|ἔπλετ̓|πελέσκεο|ἔπλεν|πέλοντο|πέλεται|ἔπλεθ̓|πέλοιτο|πέλε
προσπίπτω|ποτιπεπτηυῖαι
κεδάννυμι|κέδασθεν|ἐκέδασσεν|κεδασθέντες|ἐκέδασσε|κεδασθείσης
τέρσομαι|τέρσεται|τερσῆναι|τερσήμεναι|τέρσοντο|ἐτέρσετο
πειραίνω|πειρήναντε
ἐνερείδω|ἐνέρεισαν
παρέζομαι|παρέζετο|παρέζεο|παρεζόμενος
κυνέω|κύνεον|ἔκυσσε|κύσσ̓|ἔκυσ̓|κύσσαι|κύνει|κύσεν|κύσειε|κύσε|κύσσε|κύσα
φράζω|φράσατο|φραζώμεσθ̓|φράζεσθ̓|φράζευ|φράζεαι|ἐφράσσατο|ἐφράσθης|πέφραδ̓|φράσσομαι|φραζόμεθ̓|φραζοίμεθα|πεφραδέειν|φράζεο|πέφραδε|φράσσατο|φράσεται|φράζεσθαι|ἐφράσσαντο|φράσσαντό|φράσσονται|πεφράδοι|φρασσόμεθ̓|ἐπέφραδεν|φράσσαντο|φράσσεται|φρασάμην|πεφραδέμεν|φραζώμεθ̓|φράσαι|φράζονται|φράσομαι|φραζομένῳ|φράζωνται|φραζέσθην|φραζώμεθα|φράσε|πέφραδέ|φράζεσθον|φράσσαντ̓|ἐπέφραδε|ἐφρασάμην|ἐπέφραδον|φράζετο|φραζέσθω|φραζομένη|ἐφράσαθ̓|φράζεσθε|ἐφράσατο
περιδρύπτω|περιδρύφθη
αἰόλλω|αἰόλλῃ
ἀποπλύνω|ἀποπλύνεσκε
γουνάζομαι|γουνάζεο|γουναζέσθην|γουνάζομαι|γουνάσομαι
μειδάω|μείδησε|μειδήσασα|μείδησεν
ἐφεψιάομαι|ἐφεψιόωντο|ἐφεψιόωνται
ἐγχέω|ἐγχείῃ|ἐνεχεύατο
ἕρπω|ἕρπων|ἕρπει|εἷρπον
μαίνομαι|μαινομένῃσιν|μαίνονθ̓|μαίνεσθαι|μαινομένοιο|μαίνετο|μαινόμενε|μαίνεαι|μαινόμενον|μαίνεται|μαίνεσθε|μαινόμενος|μαινομένῃ|μαίνηται
ἀπαλθαίνομαι|ἀπαλθήσεσθον
ἀπατιμάω|ἀπητίμησε
ἀποσκεδάννυμι|ἀπεσκέδασεν|ἀπεσκέδασ̓
ἀιστόω|ἀϊστώσειαν|ἀιστώθησαν
εἰσοιχνέω|εἰσοιχνεῦσαν|εἰσοιχνεῦσι
ἀμφιτίθημι|ἀμφέθετο|ἀμφιτεθεῖσα
χαρίζομαι|χαριζόμενος|κεχαρισμένα|χαρίζεαι|χαριζομένη|χαρίσασθαι|κεχάριστο|χαρίζεο|κεχαρισμένος|χαρίσαιτο|χαρίζετο|κεχαρισμένε
χαλεπαίνω|χαλεπήνῃ|χαλεπαίνειν|χαλεπαίνων|χαλεπαίνει|χαλέπαινε|χαλεπαίνοι|χαλεπῆναι
τίκτω|τέκε|ἔτικτεν|τέκετ̓|ἔτεκον|ἔτεκεν|τεκοῦσα|τεκέσθαι|τέκοι|τέκες|ἔτεκές|τέκωσι|ἔτεχ̓|τέκοιεν|τίκτει|ἔτικτε|τεκόμεσθα|τέκ̓|ἔτικτον|τίκτῃ|τέκον|τέξεις|τέκεν|τέκεθ̓|τίκτεν|τίκτε|τεκὼν|τέκῃ|ἔτεκ̓|τέξεσθαι|τέκετο|τίκτέ|τεκέειν|τεκοῦσά|ἔτεκε|τέκομεν
ἀμείβω|ἠμείβετ̓|ἀμειβομένω|ἀμειβόμεναι|ἄμειβεν|ἀμειβόμεθ̓|ἀμείβοντες|ἠμείψατ̓|ἀμείβεο|ἀμειβόμενος|ἀμείψασθαι|ἀμείψατο|ἀμείβων|ἀμειβόμενοι|ἀμειβομένη|ἀμείψεται|ἀμειψάμενος|ἄμειβε|ἀμείβεσθον|ἠμείβετο|ἄμειβον|ἀμείβετο|ἀμείβεται
παροίχομαι|παρῴχετο|παροίχωκεν
ἐντείνω|ἐντέταται|ἐντέτατο
ὀφέλλω|ὀφέλλειν|ὀφέλλεται|ὀφέλλωσίν|ὀφέλλετε|ὀφέλλειεν|ὀφέλλετο|ὄφελλε|ὤφελλες|ὤφελλε|ὤφελλον|ὤφελλ̓|ὀφέλλεις|ὀφέλλει|ὄφελλεν|ὄφελλον|ὀφέλλουσα
μετατροπαλίζομαι|μετατροπαλίζεο
ἐπιτολμάω|ἐπετόλμησε|ἐπιτολμάτω
ἀλέξω|ἀλεξήσειε|ἀλεξήσεις|ἀλεξόμενοι|ἀλέξασθαι|ἀλεξέμεναι|ἀλεξήσειν|ἀλεξέμεν|ἀλεξήσοντα|ἀλεξώμεσθα
ἐθείρω|ἐθείρῃ
ἀνωθέω|ἀνώσαντες
πίπτω|πίπτουσιν|ἔπεσε|ἔπεσ̓|πίπτων|πέσητον|πεσοῦσ̓|πίπτει|πέσεν|πέσῃσιν|ἔπιπτον|πεπτεῶτας|πῖπτον|πεσέτην|πεσέειν|πέσοιεν|πέσῃσι|πέσον|πεπτηὼς|πεσὼν|πέσωμεν|πεσέεσθαι|πεσοῦσα|ἔπιπτε|πεσέονται|πεσόντα|πέσοι|πίπτωσι|πέσῃ|πεσόντ̓|ἔπεσον|πεσόντος|ἔπεσεν|πεπτηῶτες|πεσόντες|πεπτηώς|πεπτεῶτ̓|ἔπιπτεν|πῖπτε|πέσε|πεσών|πέσωσι|πῖπτεν|πιπτόντων
εἰσκαταβαίνω|ἐσκαταβαίνων
διείρομαι|διείρεο|διείρεαι
εἰσαφικάνω|εἰσαφίκανεν|εἰσαφίκανε
περιτέλλομαι|περιτελλομένους|περιτελλομένου|περιτελλομένων
μενοινάω|μενοινώω|μενοίνεον|μενοινήσωσι|μενοινήσεἰ|μενοίνα|μενοίνησεν|μενοινάᾳ|μενοινᾷς|μενοινήῃσί|μενοινῶν|μενοινᾷ
πατάσσω|πάτασσεν|πατάσσει|πάτασσε
ὁρμέω|ὁρμηθέντες
δέρω|ἔδερόν|δείραντας|δέρον|ἔδειραν
βεβόλημαι|βεβολημένος|βεβολήατο
πτωσκάζω|πτωσκαζέμεν
ἀμέλγω|ἤμελγε|ἤμελγεν|ἀμελγόμεναι
σώω|σώεσκον|σώοντες
νευστάζω|νευστάζων
συμβάλλω|συμβλήμενος|σύμβαλον|ξύμβληντο|ξυμβλήτην|ξυμβλήμεναι|ξυμβλήμενος|συμβάλλετον|ξύμβλητο|συμβάλετ̓|συμβλήσεαι|ξύμβληται
ἀναφαίνω|ἀνέφαινον|ἀναφαίνεις|ἀναφῆναι|ἀναφαίνων|ἀναφαίνειν|ἀνεφαίνετο|ἀναφαίνεται
ἀμαλδύνω|ἀμαλδῦναι|ἀμαλδύνηται|ἀμαλδύνας
οἰνοποτάζω|οἰνοποτάζων|οἰνοποτάζει
συνάγνυμι|ξυνέαξαν|ξυνέαξε|συνέαξε
ἐπιστενάχω|ἐπεστενάχοντο
διατρέχω|διαδράμοι|διέδραμον
πατέομαι|πασσάμενος|πασάμην|πάσσασθαι|πεπάσμην|πάσαντο|ἐπασσάμεθ̓|πάσασθαι|πασσαμένω
κινέω|κίνησε|κινήσας|κινήσῃ|κινήσαντος|κινηθέντος|κινῆσαι|κινήθη|κίνησεν|ἐκίνηθεν
κραδαίνω|κραδαινομένη|κραδαινόμενον
ἐπιθύω|ἐπιθύουσι|ἐπιθύσαντες
ἐσείδω|ἔσιδε|εἰσεῖδον
παραίσσω|παρήϊξαν|παραΐσσοντος|παρήϊξεν
δοκέω|δοκέω|δόκησε|δοκέουσι|δοκέεις|δοκέει|δοκεῖ
ἀλέω|ἄλεσσαν|ἀλεώμεθα|ἀλέαιτο|ἀλέασθαι
μείρομαι|ἔμμορε|μείρεο|εἵμαρτο
ἀστράπτω|ἀστράπτῃ|ἀστράπτων|ἀστράψας|ἀστράπτει
ὑποθωρήσσομαι|ὑπεθωρήσσοντο
ἔπειμι|ἐπέην|ἐπιείσομαι|ἐπῇσαν|ἐπιόντας|ἐπιών|ἐπῆεν|ἐπήισαν|ἔπεισιν|ἔπειμι|ἔπεσαν|ἐπείη|ἐπέσσεται|ἐπιόντι|ἐπήϊεν|ἐπιόντα
ἐνεύδω|ἐνεῦδεν|ἐνεύδειν
κλείω|κληῗσαι|κλήϊσεν|ἐκλήϊσεν|κλείουσιν|κλείω
διεξερέομαι|διεξερέεσθε
πωλέομαι|πωλεύμενοι|πωλέ̓|πωλεύμην|πωλέσκετο|πωλεῖτ̓|πωλήσεαι|πωλεῖταί
ἀμφιπεριστρωφάω|ἀμφιπεριστρώφα
ἀράσσω|ἄρασσεν|ἄραξ̓|ἄραξεν|ἀράχθη|ἄραξε|ἀράξω
δαιτρεύω|δαιτρεύσων|δαιτρεύειν|δαιτρεῦσαί|δαίτρευον
βιώσκομαι|ἐβιώσαο
ἐφικνέομαι|ἐφίκοντο
ἀλύω|ἀλύων|ἀλύουσ̓|ἀλύεις
δαμάζω|δάμασον|δμηθέντα|δάμασ̓|δεδμημένος|δαμείω|δαμάσσατο|ἐδάμη|ἐδαμάσσατο|δάμασσεν|ἐδάμασσεν|ἐδάμην|δάμεν|δαμάσσας|δαμάᾳ|δαμήμεναι|δαμήῃς|δαμασαίατο|δαμείη|δαμεὶς|δαμεῖεν|δαμασθείς|δάμασσ̓|δάμασσαν|δαμασθεὶς|δαμάσῃ|δαμέντων|ἐδαμάσθην|δαμέντας|δαμείς|δαμασαίμεθα|δαμείετε|δαμέντ̓|ἐδάμημεν|δαμᾷ|δαμασσάμενοί|δαμόωσιν|δαμασαίμην|δαμασσάμενος|δαμῆναι|ἐδάμασσα|δαμάσθη|δαμέντε|δαμάσασθαι|δαμάσσῃ|δαμάσσεται|δάμασε|δάμασσον|δεδμήμεσθα|δαμέντες|δαμέντι|δαμάσσω|δεδμήατο|δαμέντα|δμηθήτω|δεδμήμην|ἐδάμασσε|δάμη|δάμασσας|δαμήῃ|δάμασσε|δαμάσαντες|δεδμημένον|δεδμημένοι|δαμάσσομεν|δαμάσαντό
ἐνσκίμπτω|ἐνισκίμφθη|ἐνισκίμψαντε
καταρρέζω|κατέρεξε|καρρέζουσα|κατέρεξεν
κορέω|κορήσατε
ἀνέχω|ἀνασχὼν|ἀνσχεθέειν|ἀνέχοιτο|ἀνεχοίμην|ἀνέχονται|ἀνέξομαι|ἀνίσχοντες|ἀνέχεσθαι|ἀνασχομένω|ἀνασχεῖν|ἀνεσχέθομεν|ἀνασχόμενος|ἀνέσχετο|ἀνάσχεο|ἀνέσχον|ἀνασχόμενοι|ἀνασχοίμην|ἀνασχών|ἀνέσχεθε|ἀνέχῃσι|ἀνέσχεν|ἀνασχέσθαι|ἄνσχεο|ἀνασχέμεν|ἀνέσχε|ἀνσχήσεσθαι|ἄνεχ̓
τορνόομαι|τορνώσεται|τορνώσαντο
καθίζω|καθεζομένη|καταείσατο|κάθιζ̓|κάθισαν|καθίζοις|κάθιζον|καθεῖσε|καθεῖσεν|καθῖζον|κάθισον|καθίζειν|καθίζει|καθῖζεν|καθίζων|καθῖζε|καθίσσας|καθίσασα
αὐγάζω|αὐγάζομαι
καταβρόχω|καταβρόξειεν
προλέγω|προλελεγμένοι
παμφαίνω|παμφαίνων|παμφαίνῃσι|πάμφαινον|παμφαίνοντας|παμφαῖνον|παμφαίνονθ̓
ἀντάω|ἀντήσω|ἤντησ̓|ἤντησας|ἀντήσομεν|ἠντήσατε|ἀντήσειε|ἤντεον
θύω|θύοντα|θῦσαι|ἐθύσαμεν|θῦεν|θύων|θῦε|θῦσε|θύει
ἐλαστρέω|ἐλάστρεον
ἀναχάζω|ἀναχασσαμένη|ἀναχαζομένοιο|ἀνεχάζετο|ἀναχάζομαι|ἀνεχάζεθ̓|ἀναχαζόμενον|ἀναχασσάμενος
ἐπείγω|ἐπειγομένη|ἐπείγει|ἐπειγόμενός|ἔπειγον|ἐπειγόμενος|ἐπείγετε|ἐπειγομένων|ἐπειγομένους|ἐπειγόμενοι|ἐπειγομένοισι|ἐπείγετο|ἐπείγῃ|ἔπειγε|ἐπειγομένην|ἐπείγετον|ἐπειγέσθω
μεταλλάω|μεταλλῶ|μεταλλῆσαι|μεταλλᾷς|μετάλλα|μεταλλῶσιν|μεταλλᾷ|μεταλλῆσαί|μετάλλησάν
καταρρέω|καταρρέον
πρόσκειμαι|προσέκειτο
τέτμον|ἔτετμεν|τέτμῃς|τέμει|τέτμεν|ἔτετμε
τίω|τίσω|τίετο|ἐτίομεν|τετιμένος|τετιμένον|τίω|τίουσαι|τίεσκεν|τίετ̓|τίωσ̓|τίσουσ̓|τίεται|τῖεν|τῖον|ἔτιον|τῖες|τίεν|τίουσι|τίεσκον|τῖε|τιέσκετο|τίουσιν|τῖ̓|τίσει|τιέμεν|τιοίμην|τίον|τίει|τίσουσιν
γενειάω|γενειήσαντα
ἐκλανθάνω|ἐκλελάθοιτο|ἐκλάθετο|ἐκλέλαθον|ἐξελάθοντο|ἐκλελάθωντ̓|ἐκλελαθέσθαι
ποιέω|ποιήσαντες|ποιήσειεν|ἐποίησεν|ποιεῖτ̓|ποιήσομεν|ποίησαν|ποίεον|ποίησον|ποίησε|ποιήσαντο|ποιήσεται|ποιῆσαι|ποιεύμην|ποιήσετε|ποίει|ποιήσατ̓|ποιήσειαν|ἐποίησαν|ἐποίει|ποιησέμεν|ποιήσῃ|ποιήσαιμεν|ποιησόμεθ̓|πεποίηται|ποιήσατο|ποιήσασθαι|ποιήσετ̓|ποιήσωνται|ποιήσομ̓|ποίησεν|ποίησ̓
ἐρεθίζω|ἐρεθιζέμεν|ἐρέθιζον|ἐρεθίζων|ἐρέθιζε|ἐρεθίζω
ὁμηρέω|ὡμήρησε
ἀτύζω|ἀτυζομένην|ἀτυζομένω|ἀτυζομένῃ|ἀτυζομένους|ἀτυζομένων|ἀτυζόμενοι|ἀτυζόμεναι|ἀτυχθεὶς
χηρεύω|χηρεύει
ἐκδίδωμι|ἔκδοτε
ἀείδω|ἀειδούσης|ἄεισε|ἤειδε|ἀείδεις|ἀείδοντες|ἄεισον|ἀείδω|ἀεῖσαι|ἀείδοιεν|ἤειδεν|ἄειδον|ἀείδειν|ἀειδέμεναι|ἄειδε|ἀεισόμενος|ἀείδει|ἀείδῃ|ἀείδῃσιν|ἀείδων|ἄειδεν
τηλεθάω|τηλεθάοντας|τηλεθόωσα|τηλεθάον|τηλεθόωντα|τηλεθόωσαν|τηλεθόωσαι
ὑπερικταίνομαι|ὑπερικταίνοντο
ἀσθμαίνω|ἀσθμαίνοντε|ἀσθμαίνων|ἀσθμαίνοντα|ἀσθμαίνοντ̓
καναχίζω|κανάχιζε
ἀφικάνω|ἀφικάνει|ἀφικάνεις|ἀφικάνω|ἀφίκανεν
πελεκάω|πελέκκησεν
ἐπιδίδωμι|ἐπιδωσόμεθ̓|ἐπιδοῦναι|ἐπέδωκε|ἐπιδώμεθα
ἐκφέρω|ἐκφέροι|ἐξοίσουσιν|ἐξέφερον|ἐκφερέμεν|ἔκφερεν|ἔκφεῤ|ἔκφερον|ἐξέφερεν
πορθέω|ἐπόρθεον|πόρθεον
οἰδάνω|οἰδάνεται|οἰδάνει
μωμεύω|μωμεύῃ
ἐρύομαι|ἔρυσασθαι
ἀποβαίνω|ἀποβῆναι|ἀποβήσομαι|ἀπέβησαν|ἀποβάντες|ἀπεβήσετο|ἀπέβαινεν|ἀπέβη|ἀπεβήτην
ἐρατίζω|ἐρατίζων
ἐνήνοθε|ἐπενήνοθεν
πρέπω|πρέπει|ἔπρεπε
περιτίθημι|περιθεῖεν
παραπλάζω|παρέπλαγξεν|παραπλάγξασα|παρεπλάγχθη
ἰάομαι|ἰήσασθαι|ἰᾶτ̓|ἰήσεται|ἰήσατο|ἰησάμενοι
βρομέω|βρομέωσι
δέχομαι|ἔδεκτο|δεχέσθω|δέξο|δεδεγμένα|δεξάμενοι|δεξαμένη|δεχοίμην|δεδεγμένος|δέξεται|δέδεξο|δέξατο|δειδέχαται|δέξασθαι|δέχαται|δέγμενοι|δέχεται|ἐδέξατο|δέχεσθαι|δέξασθ̓|δέκτο|ἐδέγμην|δειδέχατ̓|δεξάμενος|δέξομαι|δεδέξομαι|δεχώμεθα|δέξαι|δέχθαι|δείδεκτ̓|δέξατό|δέγμενος|δέχομαι
ἐπεντανύω|ἐπεντανύσας
ἀριστεύω|ἀριστεύεσκε|ἀριστεύεσκεν|ἀριστεύειν|ἀριστεύῃσι|ἀριστεύουσι|ἀριστεύοντα
μετοκλάζω|μετοκλάζει
προβιβάω|προβιβάντα|προβιβάς
περιάγνυμι|περιάγνυται
ἐρέφω|ἔρεψα|ἔρεψαν
ἀποδέχομαι|ἀπεδέξατ̓
ἐπαινέω|ἐπαινέομεν|ἐπαινήσαντος|ἐπῄνησαν|ἐπῄνεον|ἐπαινήσαντες
στέφω|στέφει|ἔστεφε
θαάσσω|θάασσεν|θάασσε|θαασσέμεν
ἀφραίνω|ἀφραίνει|ἀφραίνοντα|ἀφραίνεις
θάω|θῆσθαι|θήσατο
ἀποσπένδω|ἀποσπένδων
μαρμαίρω|μαρμαίροντες|μαρμαίροντας|μαρμαίροντα
ἐπιπίλναμαι|ἐπιπίλναται
ἐξάπτω|ἐξάψας|ἐξῆπτεν|ἐξάπτων|ἐξάπτεσθε
κτεατίζω|κτεατίσσας|κτεάτισσα|κτεάτισσεν
ἐπιλωβεύω|ἐπελώβευον
ἀλαπάζω|ἀλαπάξαι|ἀλαπάζει|ἀλάπαξ̓|ἀλάπαξα|ἀλαπάζοντα|ἀλαπαζομένην|ἀλάπαξε|ἀλαπάξεις|ἀλάπαζε
ἐίσκω|εἴσκοντες|ἐΐσκει|ἐίσκεις|ἐΐσκω|ἠΐσκομεν|ἐΐσκεις|ἤισκε|ἐίσκω|ἐίσκομεν|ἐΐσκομεν
ἱλήκω|ἱλήκῃσι
ὑποχέω|ὑπέχευε
ἀμφιπέλομαι|ἀμφιπέληται
ἀναβάλλω|ἀνάβαλλε|ἀμβαλλώμεθα|ἀνεβάλλετο
ἁφάω|ἁφόωντα
διακείρω|διακέρσαι
προβιβάζω|προβιβῶντος|προβιβῶντι
προτεύχω|προτετύχθαι
ἐξαπονέομαι|ἐξαπονέεσθαι
περιναιετάω|περιναιετάουσιν|περιναιετάουσι
συγχέω|σύγχεας|συγχεῦαι|σύγχει|σύγχυτ̓|συνέχευε
κραδάω|κραδάων
ἀβακέω|ἀβάκησαν
ἐπιφρονέω|ἐπιφρονέουσ̓
προερύω|προέρυσσεν|προέρυσσαν|προερύσσω
στιχάομαι|ἐστιχόωντο
συλλέγω|συλλέξατο|συλλέξομαι|συλλέξας
βαθύνω|βάθυνε
καταλείπω|κατέλειπον|καλλείψειν|καλλείπειν|κάλλιπες|κάλλιφ̓|καταλείπετε|κατέλειπεν|κάλλιπον|κάλλιπ̓|καταλείπειν|καλλιπέειν|κατελείπομεν|καταλείψομεν|καταλείψουσιν|κάλλιπεν
καθίημι|καθίετε|κάθεμεν|καθέηκα
μινυρίζω|μινύριζον|μινύριζε
ἐφοράω|ἐπιόψομαι|ἐφορᾷς|ἐπόψεαι|ἐφορᾷ|ἐποψόμενον|ἐποψόμενος|ἐφορῶντες
σιωπάω|σιωπῆσαί|σιωπᾶν|σιωπήσειαν
βάζω|ἔβαζε|ἐβάζομεν|ἐβάζετε|βάζειν|βάζουσι|βάζεις|βέβακται|βάζει
θρυλίσσω|θρυλίχθη
παραδείκνυμι|παρεδέξατο
θαλπιάω|θαλπιόων
ἀπολήγω|ἀπολλήξειαν|ἀπέληγε|ἀπέληγεν|ἀπόληγε|ἀπολλήξῃς|ἀπολήγει|ἀπολλήξωσι|ἀπολλήξεις
ἐκκυλίνδω|ἐξεκυλίσθη
τιμάω|τιμήσουσι|τετιμῆσθαι|τιμῶσι|τιμήσομεν|τιμῆσαι|τιμῶσαι|τίμησας|τιμήσαντο|τετιμήμεσθα|τίμα|τιμᾷ|ἐτιμήσασθ̓|τιμήσῃ|τιμήσασθαι|τίμησόν|τιμῶν|τιμήσουσιν|τιμήσῃς|ἐτίμα|τετίμηταί
ἀλάλημαι|ἀλάλησθε|ἀλάληται|ἀλάλησο|ἀλάλησαι|ἀλάλημαι|ἀλαλήμενος|ἀλάλησθαι
προσάγω|προσήγαγε
εὐχετάομαι|εὐχετόωντο|εὐχετόωνται|εὐχετοῴμην|εὐχετάασθαι|εὐχετόῳτ̓
οἰνοχοεύω|οἰνοχοεύειν|οἰνοχοεύων|οἰνοχοεύει
ὀπίζομαι|ὠπίζετο|ὠπίζετ̓|ὀπίζεο|ὀπίζομαι
ἀντιφέρω|ἀντιφέρεσθαι|ἀντεφέροντο
ὁμηγυρίζομαι|ὁμηγυρίσασθαι
στρεύγομαι|στρεύγεσθαι
βάπτω|βάπτῃ
ἐσχατάω|ἐσχατόωσα|ἐσχατόωντα|ἐσχατόωσαν
πηδάω|ἐπήδα|πηδῆσαι
ὑπολευκαίνομαι|ὑπολευκαίνονται
ἀμφιβαίνω|ἀμφιβέβηκε|ἀμφιβεβήκει|ἀμφιβεβήκῃ|ἀμφιβέβηκας|ἀμφιβέβηκεν
ὑπαλεύομαι|ὑπαλευάμενος
ὑποπερκάζω|ὑποπερκάζουσιν
ἀφαιρέω|ἀφέλοντο|ἀφελέσθαι|ἀφείλεο|ἀφελοίμεθα|ἀφελὼν|ἀφέλεσθέ|ἀποαιρεῖσθαι|ἀφαιρήσεσθαι|ἀφείλετο|ἀφεῖλε|ἀφαιρεῖται|ἀφελώμεθα|ἀφέλωμαι
καταμύσσω|καταμύξατο
ἐπιδεύομαι|ἐπιδευομένους|ἐπιδεύετ̓
ἀπομιμνήσκομαι|ἀπεμνήσαντο
λεαίνω|λειανέω|λειήνας|λείηναν
ἄρνυμαι|ἀρνύμενοι|ἀρνύμενος|ἀρνυμένω|ἀρνύσθην
πτύσσω|πτύξασ̓|πτύξασα|ἐπτύσσοντο|πτύξασά
ποικίλλω|ποίκιλλε
δηλέομαι|δηλήσαντο|δηλήσηται|ἐδηλήσαντ̓|δηλήσασθαι|δηλήσαιτο|δηλήσατο|δηλήσεται|δηλήσεαι
τρωχάω|τρωχῶσι|τρώχων
ἀπαμύνω|ἀπαμύνασθαι|ἀπήμυνεν|ἀπαμύνετο|ἀπαμυναίμεσθ̓
διαπέρθω|διεπράθετο|διαπέρσαι|διεπράθομέν|διαπραθέειν|διεπέρσαμεν|διαπέρσομεν|διέπραθον|διέπερσε
ἐκσεύομαι|ἐξέσσυτο
ἐκτείνω|ἔκτειναν
κύπτω|κύψαντι|κύψεἰ|κύψας
διάγω|διήγαγον
ἐφίστημι|ἐφεστᾶσιν|ἐπιστάμενοι|ἐφεσταότες|ἐφεστήκει|ἐπέστη|ἐφεστάμεναι|ἐφίστατο|ἐφεστάμεν|ἐφέστασαν|ἐφεσταότος
ἐκστρέφω|ἐξέστρεψε
ζῶ|ζώοντι|ζώοντα|ζώοντος
πλέω|πλέουσα|ἔπλεεν|ἔπλεον|πλῶον|πλεύσεσθ̓|ἐπλέομεν|πλεῖθ̓|πλέεν|πλέομεν|πλείοντες|πλείειν|πλώοιεν|πλέον|πλέων|πλεούσας
ἀπέχθομαι|ἀπέχθηται|ἀπεχθόμενος|ἀπέχθωνται
δεικανάω|δεικανόωντο|δεικανόωντ̓
περιηχέω|περιήχησεν
περίοιδα|περιῄδη|περίοιδε|περιίδμεναι
δάπτω|ἔδαψεν|δάψει|δαπτέμεν|ἔδαψας|δάπτουσιν|δάπτει
ἐγείρω|ἔγρετο|ἐγειρομένων|ἔγρεο|ἐγρήγορθε|ἐγείρῃσιν|ἐγρήγορθαι|ἐγείρῃ|ἐγρόμενος|ἔγροιτο|ἔγειρεν|ἤγειρας|ἤγειραν|ἐγεῖραι|ἐγείρειαν|ἐγείρει|ἐγρηγόρθασι|ἐγείρομεν|ἔγειρε
εἰκός|ἐϊκὼς|ἐϊκυῖ̓|ἐϊκυῖα|ἐικυῖα|εἰκυῖα|ἐϊκυῖαν
καταδύω|καταδῦναι|καταδύντα|καταδὺς|καδδῦσαι|καταδύσεο|κατεδύσετο|κατέδυ|καταδύντες|κατεδύσεθ̓|καταδῦσα|καταδύντι|καταδυσόμεθ̓|καταδύμεναι
κορυφόω|κορυφοῦται
ἄνωγα|ἄνωγον|ἀνώξομεν|ἀνώγοιμι|ἄνωγας|ἄνωγε|ἀνῶξαι|ἀνώγετον|ἀνώχθω|ἠνώγει|ἄνωγα|ἄνωχθι|ἀνώγοι|ἀνώγοιτ̓|ἠνώγειν|ἀνώγειν|ἀνωγέμεν|ἀνώγετε|ἤνωγον|ἠνώγεα|ἄνωγεν|ἀνωγέτω|ἠνώγεον|ἀνώξω|ἄνωχθε|ἀνώγει|ἀνώγῃ
ἀποπαπταίνω|ἀποπαπτανέουσιν
ἐπικλώθω|ἐπεκλώσαντο|ἐπικλώσῃ|ἐπέκλωσαν|ἐπέκλωσεν|ἐπικλώσωνται
νεμεσάω|νεμέσησαν|ἐνεμέσσα|νεμεσήσῃ|νεμεσσήσαιτό|νεμέσσα|νεμεσήσεται|νεμέσσηθέν|νεμεσήσετ̓|νεμεσσῶμαι|νεμέσησε|νεμεσσήθητε|νεμεσσηθεῖσα|νεμεσσήθη|νεμεσσῶμαί|νεμέσα|νεμεσσηθεὶς|νεμεσῶ|νεμεσᾶτον|νεμεσσηθέωμέν|νεμεσήσεαι|νεμεσσᾶται
κοιμάω|κοιμᾶται|κοιμηθέντες|κοιμηθέντι|κοιμήσασα|κοιμήσατο|κοιμήσωνται|κοίμησόν|κοιμηθῆναι|κοιμῶντο|κοιμᾶτ̓|κοίμησε|κοιμήθημεν|κοιμᾶθ̓|κοιμήσασθε|κοιμήσαντο|κοιμηθέντε|κοιμηθείη|κοίμησον|κοιμήσατε|κοιμήσαντ̓|κοιμήσας
σκεδάννυμι|σκέδασ̓|ἐσκέδασσεν|ἐσκέδασ̓|σκέδασεν|σκέδασον
πάσσω|πάσσων|πάσσειν|πάσσε|πάσαντο|ἔπασσε
μεγαίρω|μεγήρας|μεγήρῃς|μεγαίρω|μέγηρε
δέρκομαι|δέδορκεν|δερκομένω|ἔδρακον|δερκομένοιο|δερκόμενοι|δερκομένη|δέρκεσθαι|δερκέσκετο|δερκομένοισι|δεδορκώς|δερκομένῳ
ἐνστηρίζω|ἐνεστήρικτο
ἐξαυδάω|ἐξαύδα
συλεύω|συλεύειν|ἐσύλευον
μαιμάω|μαιμώωσα|μαιμώωσι|μαίμησε|μαιμώων|μαιμῶσιν
ἐπιπνέω|ἐπιπνείουσα|ἐπιπνείῃσιν|ἐπιπνεύσωσιν
ἐφαρμόζω|ἐφαρμόσσειε
δίδωμι|διδόντος|δοῦναι|δώσουσ̓|ἐδίδου|δίδωσι|διδοῖσθα|δώσω|δῶμεν|δὸς|δόσαν|δῶσιν|δόμεναι|δῶκεν|δέδοται|δόσκεν|δοῖεν|διδώσειν|δώωσ̓|δότε|δοῖμεν|διδοῦναι|δῶκα|δίδωσιν|δόμεν|δώωσιν|δώομεν|δῷς|ἔδωχ̓|ἔδωκ̓|ἔδωκεν|δίδου|δόντες|δός|ἐδίδους|δώῃσιν|ἔδωκα|δωσέμεναι|δόσκον|διδοῖτε|δώσουσι|διδόντες|δῶχ̓|δῶκας|δώσει|δότω|ἔδωκας|δώσεις|δώσουσιν|δότ̓|διδοῦσι|δίδωθι|δοθείη|διδούς|δοῦσα|δῷσι|ἔδομεν|δίδωμι|δίδοσαν|δῶκε|δώσειν|διδοῖς|ἔδωκαν|διδοῖ|δοίης|δωσέμεν|ἔδοσαν|δοίην|διδώσομεν|δοίη|διδοῦσιν|δόμεναί|δῶκαν|δίδομεν|ἔδοσάν|δῶκ̓|δώῃ|δῶκέν|διδοῖεν|ἔδωκε
δαιδάλλω|δαιδάλλων
ἀπολέπω|ἀπολεψέμεν
ἀποείκω|ἀπόεικε
προστίθημι|προσέθηκεν
ἀγορεύω|ἀγόρευσον|ἀγόρευε|ἀγορεύσω|ἀγορευέμεναι|ἀγορεύοντες|ἀγορεῦσαι|ἀγορεύοι|ἀγόρεὐ|ἀγορεύοντος|ἀγόρευεν|ἀγόρευσε|ἀγορεύειν|ἀγορεύεις|ἀγορεύσατ̓|ἀγορεύοις|ἀγορεύων|ἀγορευέμεν|ἀγορεύω|ἀγόρευον|ἀγορεύει|ἀγόρευες|ἀγόρευσεν
εἶπον|ἔειπεν|εἰπὲ|εἰπόντε|εἰπὼν|εἰπόνθ̓|εἶπε|εἰπέ|εἰπέμεναί|εἰπέμεν|εἶπας|εἶπες|ἔσπετε|εἰποῦσα|εἰπόντ̓|εἴπῃ|εἴπαθ̓|εἴπομεν|εἰπεῖν|εἰπέμεναι|εἴποιμι|εἰποῦσ̓|εἰπόντι|ἔειπον|εἴπεσκεν|εἴπῃς|εἶπεν|εἴπῃσιν|εἰπόντα|εἴπῃσθα|εἴποιμ̓|εἴπωμι|εἰπὸν|εἴφ̓|εἴπῃσι|εἰπών|εἴπατε|εἴπεσκε|εἴποι|εἴποις|εἶπον|εἴπω|εἰπόντος|ἔειπες|εἴπ̓|εἶπέ|ἔειπε
ἐπιφλέγω|ἐπιφλέγῃ|ἐπιφλέγει
ἐπαίρω|ἐπαείρας
ἐξαποβαίνω|ἐξαπέβησαν
ὑφαίνω|ὑφαίνει|ὑφόωσι|ὑφήνω|ὑφαίνοις|ὑφήνασα|ὕφαινεν|ὑφαίνουσιν|ὕφηνον|ὕφαινον|ὑφήνας|ὑφαίνεσκον|ὑφαίνεσκεν|ὑφαίνῃσιν|ὑφαίνειν|ὕφαινε
τάνυμαι|τάνυται
ἀηθέσσω|ἀήθεσσον
περιμηχανάομαι|περιμηχανόωντο|περιμηχανόωνται
καταστυγέω|κατέστυγε
διαρπάζω|διαρπάζουσιν
ἀπαφίσκω|ἀπαφίσκει|ἀπάφοιτο|ἤπαφε
ἵκω|ἵκει|ἷκε|ἷξεν|ἵκοι|ἷξον|ἵκω|ἷξε
ἀνερωτάω|ἀνηρώτων
γυιόω|γυιώσειν|γυιώσω
πύθω|πύσει|πύθεται|πυθομένων
βλώσκω|μέμβλωκε|μολόντες|μολών|μολοῦσαι|μολὼν|μόλῃ|μολοῦσα
ἀράω|ἀρημένος|ἀρημένον
τοξάζομαι|τοξαζοίατο|τοξαζοίμεθ̓|τοξάσσαιτο|τοξάζεαι|τοξάσσεται|τοξάζεσθαι
ἀναίνομαι|ἀνήνατο|ἀνήνασθαι|ἠναίνετο|ἀναίνεται|ἀνήνηται|ἀναίνομαι|ἀναίνεαι|ἀναίνετο
συνεέργω|συνεέργαθον
θεοπροπέω|θεοπροπέων
ἐμβρέμομαι|ἐμβρέμεται
παρακρεμάννυμι|παρακρεμάσας
ἀδέω|ἁδήσειεν|ἀδηκότες
ἀελπτέω|ἀελπτέοντες
προσμυθέομαι|προτιμυθήσασθαι
ὁδεύω|ὁδεύειν
ὀψείω|ὀψείοντες
ἀγλαίζω|ἀγλαϊεῖσθαι
ἐκτέμνω|ἐξέταμ̓|ἔκταμ̓|ἐκτάμνοντες|ἔκταμεν|ἐξέταμον|ἐκτάμνῃσιν|ἐκτάμνειν
ὀχέω|ὀχέοντας|ὀχέεσκον|ὀχήσατο|ὀχέειν|ὀχέεσθαι|ὀχήσονται|ὀχέων
λαγχάνω|λάχ̓|λάχῃ|λελάχωσι|λελόγχασιν|λάχομεν|λελάχητε|ἔλαχε|ἔλαχον|λάχον|λάγχανον|ἔλαχόν|λαχὼν|λαχεῖν|ἐλάγχανον|ἔλαχ̓|λάχῃσιν|λαχόντα|λάχεν|λάχε
ἀρκέω|ἤρκει|ἤρκεσ̓|ἤρκεσε|ἀρκέσει
ἐρύω|ἐρύσσεσθαι|ἐρύσσεαι|ἐρύουσιν|εἰρύαται|εἰρύσατο|εἰρύσαο|εἰρυμέναι|εἰρύσσαισθε|εἰρυόμεσθα|ἐρύσσεται|εἴρυντο|ἐρυσαίατο|ἐρύσασ̓|ἔρυσάν|ἐρύσαντες|ἐρύων|ἐρύοντα|ἐρύσσατε|εἴρυτο|εἴρυσθαι|ἐρύσαιο|ἔρυον|εἰρύσσονται|εἰρύατο|εἰρύσσατο|εἰρύσσασθαι|εἰρύσσαιτο|ἐρύσῃ|ἐρύουσι|ἐρύοντι|εἴρυσσέν|ἔρυσθαι|εἰρύσαθ̓|ἐρύσσομεν|ἐρύσαντας|ἔρυσαν|εἰρύατ̓|εἴρυσσε|ἐρύσσας|εἰρύσατ̓|ἐρύσσαι|ἔρυσσαν|εἴρυσαν|εἴρυσε|ἐρύσαντό|ἐρύειν|ἐρύσσατο|ἐρύσαιμ̓|ἐρύεσθαι|ἐρύσσωσ̓|ἐρύσας|ἐρύοντο|ἐρύσσαμεν|ἐρύσαι|ἐρύσσῃς|ἐρυσαίμεθα|ἐρυσσάμενος|ἐρύσσασθαι|ἔρυσεν|ἐρύσαιτ̓|εἰρυσάμην|ἐρύσατο|ἐρύσασθαι|ἐρύσαιτο|ἐρύσαντο
φείδομαι|πεφιδήσεται|φείδεο|πεφιδοίμην|φειδόμενος|πεφίδοιτο|φείσατ̓|πεφιδέσθαι
καταλήθομαι|καταλήθοντ̓
ὑδρεύω|ὑδρευούσῃ|ὑδρεύοντο
εἶδον|ἴδον|ἴδοιτο|ἴδοντο|ἴδῃς|ἰδόντα|εἰδήσεις|ἴδωμ̓|ἴδεσθε|ἴδεσκε|ἴδε|εἶδεν|ἰδόντες|εἶδε|ἰδεῖν|ἴδοιμι|ἰδοῦσά|ἰδὼν|ἴδησθε|ἴδ̓|ἴδοιεν|ἴδοις|ἰδώμεθα|ἴδομεν|ἰδόντ̓|ἰδόντι|ἴδεν|ἰδόμην|ἴδοι|ἴδωμι|ἴδῃ|ἴδηαι|ἴδωσι|ἴδηται|ἴδετο|εἶδον|ἴδοιτ̓|ἰδοῦσα|ἴδες|ἰδοῦσ̓|ἰδέειν|ἰδέσθαι|ἴδητ̓|εἶδες|ἰδέτην|ἴδω|ἰδοῦσαι|ἰδών|εἶδ̓|ἴδωμεν|ἰδόντας|ἰδοίατο|ἴδηθ̓|ἴδωμαι
δορπέω|δορπήσομεν|δορπῆσαι|δορπέομέν|ἐδόρπεον|δορπείτην
ἄπειμι|ἄπιθ̓|ἀπέσσονται|ἀπιόντα|ἀπεόντος|ἄπεσαν|ἀπεόντων|ἀπεσσεῖται|ἀπιόντος|ἀπεών|ἀπέην|ἀπιόντες|ἀπέσσεσθαι|ἀπῆν|ἄπειμι|ἀπέῃσιν|ἀπιὼν|ἀπέσσεται|ἀπῆμεν|ἀπέσσομαι
τύπτω|τετυμμένω|τύπτετε|τύπτουσιν|τύπτε|ἐτύπη|τύπτον|τύψῃ|τυπτομένων|τύπτων|τύψας|τύψον|τυπεὶς|τυπείης|τύψ̓|τύψε
φράσσω|φράξαντες|φράξε|φραχθέντες|φράξαντο
ἐγγίγνομαι|ἐγγεγάασιν|ἐγγεγάασι
θείνω|πέφνῃ|πέφνεν|ἔπεφνεν|πέφατ̓|θείνῃ|ἔπεφνον|θείνας|θεινομένην|ἔπεφνες|πεφνέμεν|πέφνῃς|ἔθεινε|θεινομένου|πέφνον|πεφνόντα|πέφαται|πέφανται|θεῖνε|πεφήσεαι|θεινέμεναι|θεινόμεναι|ἐπέφνομεν|θείνων|ἔπεφνε|ἐπέφνετε|πέφνε|πεφάσθαι|ἔπεφν̓|θεινομένων
κατέδω|κατεδόντων|κατέδων|κατέδονται|κατέδουσι|κατέδουσιν
συνέργω|συνέεργε|συνέεργον
ἐσθίω|ἐσθίεταί|ἔσθιε|ἤσθιε|ἤσθιεν|ἐσθιέμεν|ἔδονται|ἐσθίει|ἤσθιον|ἔσθἰ|ἐσθίετε
λιτανεύω|λιτανεύσομεν|ἐλλιτάνευσα|ἐλλιτάνευε|λιτάνευεν|λιτάνευε
ψεύδω|ψεύδεσθαι|ψευσαμένη|ψευδόμενοι|ψεύδἐ|ψεύδοντ̓|ψευσάμενοι|ψεύσομαι
ἐπισεύω|ἐπισσεύεσθαι|ἐπέσσυται|ἐπεσσύμενοι|ἐπεσσύμεθ̓|ἐπεσσυμένους|ἐπεσσύμενον|ἐπέσσυτο|ἐπεσσεύοντ̓|ἐπισσεύας|ἐπισσεύῃ|ἐπεσσύμενος
τρέπω|τετραμμέναι|τρέπεται|τραφθῆναι|ἔτρεψε|τράποντο|ἔτραπεν|τρέψειε|ἔτραπον|τρέπε|τραπέσθαι|ἔτραπε|ἐτράπετ̓|τρέψειαν|τρέψε|τρεψάμενοι|τρέψεν|ἔτρεψεν|τρέψας|τράπε|τέτραπτο|τετραμμένοι|τετράφθω|ἐτράπετο|τράπετο|τράπωνται|τετραμμένος|τράπεθ̓|τράπετ̓|τρέπεν|τρέψω|τετράφαθ̓|τετραμμένον
ἀτιτάλλω|ἀτιταλλομένην|ἀτίτηλα|ἀτίταλλ̓|ἀτιτάλλω|ἀτίταλλον|ἀτίταλλε|ἀτιταλλέμεναί|ἀτίταλλεν
σύνειμι|ξυνιόντας|ξύνισαν|ξυνιόντων|ξυνιόντες|συνίτην|ξυνέσεσθαι
ἐμποιέω|ἐνεποίεον
νήχω|νῆχε|νῆχον|νηχόμενοι|νηχομένοισι|νήξομ̓|νηχόμενος|νηχέμεναι
ἐπιληκέω|ἐπελήκεον
κοπρίζω|κοπρήσοντες
κάμνω|καμόντα|κάμοιεν|κάμω|κεκμηώς|κάμωσιν|κάμ̓|κάμνει|ἔκαμνεν|καμέτην|ἔκαμον|καμόντων|κάμοιτε|κεκμηότας|κάμνεις|κάμε|κέκμηκας|κάμνε|ἐκάμοντο|κάμῃσι|κεκμηῶτα|κάμεν|κεκμηῶτι|καμόμεσθα|κάμετόν|καμόντας|κάμον|καμεῖται
ἐκπέμπω|ἐκπέμψῃσι|ἐκπέμπεις|ἐκπέμψειε|ἔκπεμψάν|ἔκπεμπε|ἐκπέμψασθε
ἔννυμι|ἕσσο
σεύω|σεύῃ|ἔσσυται|ἔσσυο|ἔσσευε|σεύαιτο|σεῦα|σύτο|σεῦαν|ἐσσύμενοί|ἔσσυτο|ἔσσυμαι|σευάμενος|ἐσσεύαντο|σεύατ̓|σεύας|ἐσσεύοντο|ἔσσευα|ἐσσύμενόν|ἐσσύμενον|ἐσσύμενός|ἔσσυτ̓|σεῦε|σεύωνται|ἔσσευεν|σεῦεν
ἐξαγγέλλω|ἐξήγγειλεν
ἱκνέομαι|ἵκεο|ἵκοιτ̓|ἵκοιο|ἱκοίατο|ἵξεται|ἵκηται|ἱκέσθαι|ἵκωνται|ἵξεσθαι|ἵκησθε|ἱκοίμην|ἵκηαι|ἱκνεύμεναι|ἵξομαι|ἵκωμι|ἵκετ̓|ἱκόμεσθ̓|ἱκοίμεθα|ἵκευ|ἵκοιτο|ἵκετο|ἵκεθ̓|ἱκόμην|ἱκέσθ̓|ἱκόμεθ̓|ἱκοίμεθ̓|ἵκοι|ἱκώμεθα|ἵξετ̓|ἷκεν|ἱκέσθω|ἵκοισθε|ἱκόμεσθα|ἵκοντο|ἵκεσθον|ἱκέσθην|ἱκνεύμεσθα|ἵκῃ|ἵκωμαι
ἀπιθέω|ἀπίθησ̓|ἀπιθήσει|ἀπίθησεν|ἀπίθησαν|ἀπιθήσω|ἀπίθησε
ἐπικλίνω|ἐπικεκλιμένας
προεῖδον|προΐδωσιν|προϊδών|προϊδόντες|προϊδὼν|προΐδωνται
βροτόομαι|βεβροτωμένα
ἐκφαίνω|ἐξεφάανθεν|ἐκφανεῖ|ἐξεφάνη|ἐξεφαάνθη
οἰνοχοέω|ἐοινοχόει|οἰνοχοῆσαι|οἰνοχοεῦντες|ἐῳνοχόει|οἰνοχόει
ἀπωθέω|ἀπέωσε|ἀπωσάμενον|ἀπώσω|ἀπῶσεν|ἀπώσεται|ἀπωσάμενοι|ἀπωσέμεν|ἀπώσατο|ἀπώσει|ἀπώσεαι|ἀπώσασθαι|ἀπῶσαι|ἀπωσαμένους|ἀπώσομεν|ἀπῶσαν
ἐντροπαλίζομαι|ἐντροπαλιζόμενος|ἐντροπαλιζομένην|ἐντροπαλιζομένη
προίημι|προῆκε|προϊεῖσι|προΐει|προΐεις|προέμεν|προέηκα|προϊεῖσα|προέηκεν|προέηκε|πρόες|πρόεσαν|προΐειν|προΐησι|προέτω
νικάω|νικήσουσι|νικηθέντι|ἐνίκα|ἐνίκησεν|νίκησεν|νικηθεὶς|νικήσῃ|νικήσεἰ|νίκησα|νίκα|νικησέμεν|νικᾷ|νικήσαντ̓|νικήσαντι|νικάσκομεν|νίκων|νικῶντες|νικῆσαι|ἐνίκησα|νικήσας|νίκησε|ἐνίκησας|ἐνίκων|νικᾶν|νικᾷς
ἀνοίγνυμι|ἀναοίγεσκον|ἀνέῳγε|ἀνέῳξε|ἀνέῳγεν|ἀνῷγεν
πελάζω|πέλασαν|πελάσαι|πελασαίατο|πελάζειν|πέλασθεν|πελάσῃς|πελάσσομεν|πέλασεν|πλῆτο|πέλασε|πλῆντ̓|πελάσσαι|πέλασάν|πελάσῃ|πέλασσε|πέλασσεν|πελάσσατε|πεπλημένος|πελάσθη|πελάσσῃ
παμφανόων|παμφανόωσα|παμφανόωσαν|παμφανόωντος|παμφανόωντα
ἐξέλκω|ἐξελκομένοιο|ἐξέλκουσα
δενδίλλω|δενδίλλων
ὅπλομαι|ὅπλεσθαι
ἀναρρίπτω|ἀνερρίπτουν|ἀνέρριψαν|ἀναρρίπτειν
ἀποπλάζω|ἀποπλαγχθέντες|ἀπεπλάγχθη|ἀποπλαγχθέντας|ἀποπλαγχθεῖσα|ἀποπλαγχθεὶς|ἀπεπλάγχθης
νεικέω|νείκεσσε|νείκεσ̓|νεικείων|νεικεῖν|νείκεσεν|νεικεῖ|νείκεσε|νεικείῃ|νείκεον|νεικείῃσι|νεικέοι|νείκεσσ̓|ἐνείκεσας|νεικεῦσ̓|νείκεσέ|νεικείεσκον|νείκεσσεν|νείκειον|ἐνείκεον|νεικείειν|νείκει|νεικέσω|νεικείεσκε|νεικείω|νείκεε
ἐναραρίσκω|ἐναρηρός
μεθαιρέω|μεθέλεσκε
ἀποτρωπάω|ἀποτρωπῶσι|ἀποτρωπῶμεν
ἀποπαύω|ἀπέπαυσε|ἀπέπαυσαν|ἀποπαύἐ|ἀποπαύσομαι|ἀποπαύεαι|ἀποπαύσει|ἀπόπαυε|ἀποπαύεο|ἀπέπαυσας|ἀποπαύσεσθαι|ἀποπαύσεται
ἐπιπείθομαι|ἐπιπείθηται|ἐπεπείθεθ̓|ἐπιπείθεθ̓|ἐπιπείθονται|ἐπιπείσομαι|ἐπιπειθόμεναι|ἐπεπείθετο|ἐπιπείθεο|ἐπιπείσεται|ἐπιπείσεαι
ἀποπροίημι|ἀποπροίει|ἀποπροέηκε
ἀφήκω|ἀφῆκ̓
ἀνήνοθε|ἀνήνοθεν
ἠπεροπεύω|ἠπερόπευον|ἠπεροπεύει|ἠπεροπεύσῃς|ἠπεροπεύειν|ἠπεροπεύεις
κάθημαι|ἧντ̓|καθημένω|καθῆστο|ἧμαι|κάθησο|καθήατο|καθήμενοι|καθήμενον|καθήμεναι|καθήμενος
κεράννυμι|κερασσάμενος|κέρασσε|κέρασσεν|κεράσσατο|κεράσασα|κέρωνται|κεκράαντο
τείνω|τάθη|τετάσθην|ταθείς|τέταται|τείνας|ταθεὶς|τέτατο|τεῖναν|τέτατό|τείνειεν|τείνῃ|ἔτεινε|τέταντο|τέταθ̓|τεῖνεν
κατερύκω|κατερύκανε|κατέρυκε|κατερύκεται|κατερύκει|κατερύκομαι|κατερύκω|κατέρυκες
ἐξοίχομαι|ἐξοίχεται
ὄμνυμι|ὀμόσσας|ὀμόσαι|ὀμνυέτω|ὀμοῦμαι|ὀμεῖται|ὄμοσάν|ὄμνυε|ὤμοσε|ὀμόσαιμι|ὤμοσα|ὄμοσσεν|ὄμοσέν|ὄμνυθι|ὀμόσσατε|ὀμόσας|ὤμνυε|ὀμόσσαι|ὀμόσσῃ|ὄμοσσον|ὠμόσσαμεν|ὄμοσεν|ὄμοσον
δωρέω|δωρήσαιτ̓
ἰθύω|ἴθυσέν|ἴθυσε|ἴθυσαν|ἴθυσεν|ἰθύει|ἰθύσεἰ|ἰθύσῃ
ἀέξω|ἀέξουσιν|ἀέξω|ἀέξετο|ἄεξε|ἀέξει|ἀέξεται|ἀέξειν|ἀέξων|ἀέξῃ
ἅπτω|ἅπτεσθον|ἅπτεαι|ἅπτετ̓|ἅψασθαι|ἅψας|ἥπτετο|ἁπτέσθω|ἅψεσθαι|ἅψεται|ἅψατο|ἁψαμένη|ἥψατο|ἅπτηται|ἁψάμενοι|ἁπτόμενος|ἁψάσθην|ἅπτεσθαι|ἁπτόμενον|ἁπτομένη|ἁψάμενος|ἁπτόμεναι|ἅπτεται
καλέω|καλήμεναι|κεκλημένος|καλέουσα|καλέσασ̓|καλέσσας|καλεσσαμένω|καλέσαντα|κάλεσον|καλέοι|καλέεσκε|κάλεσσε|ἐκάλει|καλεῖ|καλέσσαι|καλέουσι|καλεοίμην|καλέων|καλέω|καλέσας|κάλεσσαν|κεκλήσῃ|κεκλῆσθαι|καλέσσω|καλέσασθε|κάλεόν|κέκλημαι|καλέσκετο|καλέουσ̓|καλέσασα|καλεῦντες|ἐκαλέσσατο|καλέεσκον|κεκλήατο|καλεσσάμενος|κάλεσσα|καλέσσατο|καλέονται|καλέσαντο|καλέουσιν|κέκληται|καλέσειεν|καλεσσαμένη|κάλεσσεν|κάλει|κάλεσσον|καλέσειε|καλέσαντες|καλέει|κάλεσσας|καλέεσθαι|ἐκάλεσσας|καλεῦντο|κάλεον
λείβω|λεῖβον|λεῖψαι|λείψαντε|λείβειν|λείβων|λεῖβε
ἐναίρω|ἐναίρεο|ἐναίροντα|ἐναίρειν|ἐναιρέμεν|ἐναίρω|ἔναιρε|ἐναιρόμενος|ἐναίρων|ἐνήρατο
καρκαίρω|κάρκαιρε
πιμπλάνομαι|πιμπλάνεται
θωρήσσω|θωρήσσοντο|θωρήξομεν|θώρηξεν|θωρήσσεο|θωρήσσετο|θωρηχθῆναι|θωρηχθέντες|θωρήσσεσθαι|θωρήσσοιτο|θωρήξομαι|θωρῆξαί|θωρήχθησαν|ἐθωρήσσοντο|θωρήσσεσθον
ἐφιζάνω|ἐφίζανε|ἐφιζανέτην
ἐπιμένω|ἐπίμεινον|ἐπιμεῖναι
ἀποστρέφω|ἀποστρέψαντες|ἀποστρέψῃσιν|ἀποστρέψασκε|ἀποστρέψαντε|ἀποστρέψοντας
ἠπύω|ἤπυεν|ἠπύει
ἐπεγείρω|ἐπέγειρε|ἐπεγρόμενος|ἐπέγρετο
κατασβέννυμι|κατέσβεσε
κατεσθίω|κατέδονται|κατεσθίει|κατήσθιε
μορμύρω|μορμύροντα|μορμύρων
περιρρέω|περίρρεε
ἀμαθύνω|ἀμαθύνει
μετρέω|μετρήσαντες
ὑποτρομέω|ὑποτρομέουσιν|ὑποτρομέεσκον
ἀθερίζω|ἀθέριζον|ἀθερίζω
παραείδω|παραείδειν
μετασσεύομαι|μετεσσεύοντο
θερμαίνω|θερμαίνοιτο|θερμήνῃ
ὄθομαι|ὄθομαι|ὄθετ̓|ὄθεται
μεταυδάω|μετηύδα|μετηύδων
ἀπέχω|ἀποσχήσει|ἀφέξω|ἀποσχέσθαι|ἀπεχώμεθα|ἀφέξεαι|ἀφεξόμεθ̓|ἄπεχε|ἀπόσχῃ|ἀπέχοντο|ἀπέχειν|ἀπέχονται|ἀπόσχωνται|ἀφέξομαι
ἀνείργω|ἀνέεργον|ἀνέεργε
μίσγω|ἐμισγέσκοντο
ἀπαράσσω|ἀπήραξεν|ἀπάραξε
παραπέμπω|παρέπεμψεν
καταστορέννυμι|κατεστόρεσαν
ὁμοφρονέω|ὁμοφρονέοις|ὁμοφρονέοντε
ἑδνόω|ἐεδνώσαιτο
φθίω|ἐφθίαθ̓|φθιμένοισι|φθίνοντος|φθιμένου|φθῖτ̓|φθίσεσθαι|φθινόντων|φθῖσαν|φθιμένοιο|φθίσονται|ἔφθιθεν|φθίῃς|φθίσειν|φθίσθαι|φθίσεσθ̓|ἔφθιεν|φθίεται|φθίσωμεν|φθίμενος|φθίνουσιν|ἔφθιται|φθινέτω|φθιόμεσθα|ἔφθιτ̓|φθίσει|φθῖσαι
ὁπλίζω|ὡπλίσσατο|ὁπλισόμεσθα|ὥπλισσε|ὁπλισάμεσθ̓|ὁπλίζοντο|ὡπλίζετο|ὅπλισσόν|ὁπλίζονται|ὅπλισθεν|ὁπλίσαθ̓|ὁπλίσαι|ὁπλίσσατο|ὁπλιζώμεθα|ὡπλίζοντο
σιτέομαι|σιτέσκοντο
ἰσχανάω|ἰσχανάασκον|ἰσχανόωντο|ἰσχανόωσιν|ἰσχανάᾳ|ἰσχανάᾳς|ἰσχανόων|ἰσχανόωνται|ἰσχαναάσθω|ἰσχανόωσαν
ἐξαναλύω|ἐξαναλῦσαι
διείργω|διέεργον
κλίνω|ἔκλινε|ἔκλιν̓|κλίνθη|ἐκλίνθη|κεκλιμένος|κλίνασα|κλίνας|κλιθῆναι|κεκλιμένη|κλινάμενος|ἐκέκλιτο|ἔκλιναν|κέκλιτο|κεκλίαται|κλῖνε|κλίνων|κλινθήτην|κεκλιμένον|ἐκλίθη|κλίνῃσι|κλινθῆναι|κλίναντες|κεκλιμένοι|κλῖναν|κεκλιμένων
ἄεσα|ἀέσαι|ἄσαμεν
ἀπαιτίζω|ἀπαιτίζοντες
ἐμπρήθω|ἐνιπρήσειν|ἐνιπρήσω|ἐνιπρήσει|ἐμπρήσειν|ἐνέπρηθον|ἐνιπρήσωσι
ἀποπλέω|ἀπέπλω|ἀπέπλειον|ἀποπλείειν
σκιάζω|σκιάσῃ
ποιπνύω|ποίπνυον|ποιπνύσασαι|ποιπνύσαντι|ποιπνύοντα|ἐποίπνυον
ἀποκτείνω|ἀπέκτεινεν|ἀποκτείνεις|ἀποκτείνω|ἀπέκταμεν|ἀποκτάνῃ|ἀπέκτανε|ἀποκτεῖναι|ἀποκταμένοιο|ἀποκταμένων|ἀπέκτανον|ἀποκτάμεν|ἀποκτείνων|ἀπέκτατο|ἀποκτάμεναι
αἴθω|αἰθομένας|αἰθομένοιο|αἰθομένοισιν|αἰθόμενον|αἰθομένοις|αἰθομένου
ἐξιθύνω|ἐξιθύνει
οἰχνέω|οἴχνεσκον|οἰχνεῦσιν|οἴχνεσκε
τίνυμαι|τίνυσθον|τίνυται|τίνυνται|τινύμενος
ὑποκλονέομαι|ὑποκλονέεσθαι
καταισχύνω|καταισχύνητέ|καταισχύνειν|καταισχύνοντα
περιστένω|περιστένεται
συντρέχω|συνέδραμον
βωστρέω|βωστρεῖν
ὑπεξάγω|ὑπεξαγάγοι
ἀραβέω|ἀράβησε
καταμάρπτω|κατέμαρπτε|καταμάρψῃ
κρίζω|κρίκε
ἐπιφέρω|ἐπένεικα|ἐποίσει
ἐπιμαίνομαι|ἐπεμήνατο
ῥαίνω|ἐρράδατ̓|ῥαίνοντο|ἐρράδαται|ῥάσσατέ
ἐλεέω|ἐλεήσει|ἐλεήσῃς|ἐλεησάντων|ἐλεήσας|ἐλέησε|ἐλέησον|ἐλέησά|ἐλέησεν|ἐλεήσῃ
αἰτίζω|αἰτίζων|αἰτίζεις|αἰτίζῃ|αἰτίζειν
τιτρώσκω|τρώσῃς|τρώσητε|τρώει|τρώσεσθαι
ἀναπετάννυμι|ἀναπεπταμένας
ἄζω|ἀζομένη
πιστόω|ἐπιστώσαντ̓|πιστώσαντο|πιστωθῆτόν|πιστωθῆναι
ἐξάγω|ἐξῆγεν|ἐξῆγε|ἔξαγε|ἐξάγαγ̓|ἐξαγάγοις|ἐξάγαγε|ἐξαγαγόντες|ἐξήγαγε|ἔξαγ̓|ἔξαγεν
περιτροπέω|περιτροπέοντες|περιτροπέων
ἀνθίστημι|ἀντέστη|ἀνθίσταντο
θάλλω|τεθαλυῖά|τεθαλυῖαν|τεθήλει|τεθαλυίῃ|τεθηλώς
μνάομαι|μνώοντο|μνωομένῳ|μνάᾳ|μνάασθαι|μνᾶσθαι|μνωομένω|μνᾶται|ἐμνώοντο|μνῶνται|μνώοντ̓|μνάσθω|μνώμεθ̓|μνάσκετ̓|μνώμενοι
οἰμώζω|οἰμώξειε|ᾤμωξεν|ᾤμωξαν|ᾤμωξέν|οἰμώξας
ἔργω|ἐέργῃ|ἐέργουσίν|ἐέργων|ἔεργε|ἔεργεν|ἔρξαν|ἐεργόμενοι|ἔεργον|εἴργουσι|ἐέργει|ἐεργμέναι
τιτύσκομαι|τιτυσκόμεναι|τιτυσκομένη|τιτυσκομένων|τιτυσκόμενοι|τιτυσκόμενος|τιτύσκετο
φαρμάσσω|φαρμάσσων
προτίθημι|προθέουσιν|προύθηκεν
ἀπεχθαίρω|ἀπεχθαίρει|ἀπεχθήρω
κολῳάω|ἐκολῴα
ἄνω|ἄνεται|ἦνον|ἄνω|ἄνοιτο
συνελαύνω|ξυνελαυνέμεν|συνελάσσαμεν|ξυνελαύνεις|ξυνελάσσομεν|ξυνελάσσαι
ἀναψύχω|ἀναψύχειν|ἀνέψυχθεν|ἀνέψυχον|ἀναψύχοντα
ὁρμίζω|ὡρμίσαμεν|ὁρμίσσομεν|ὥρμισαν
ἐπόμνυμι|ἐπώμνυον|ἐπώμοσε
οἴχομαι|οἴχονται|οἴχηται|οἴχεσθον|οἴχονθ̓|οἴχεσθ̓|οἰχόμενοι|οἴχεται|ᾤχεο|οἰχομένῳ|ᾤχοντο|ᾤχοντ̓|οἴχεσθαι|ᾠχόμεθ̓|οἴχωμαι|οἴχωνται|οἰχομένην|ᾤχεθ̓|οἴχεθ̓|οἴχετ̓|ᾤχετ̓|οἴχοιτο|οἰχόμενον|οἰχομένη|οἰχομένοιο|ᾤχετο
ἐκφεύγω|ἔκφυγεν|ἐκφύγομεν|ἐκφυγέειν|ἐξέφυγον|ἔκφυγε
κατείβω|κατείβετο|κατειβόμενον|κατείβετον
ἀποσκυδμαίνω|ἀποσκύδμαινε
μαστίζω|μάστιξέν|μάστιξεν
ἀπερύκω|ἀπερύκει|ἀπερύκων|ἀπερύκοι
ἀναμιμνήσκω|ἀνέμνησας
ξύω|ξῦον|ἔξυσ̓
ἀπολιχμάομαι|ἀπολιχμήσονται
θαυμάζω|θαυμάζοντες|θαύμαζεν|θαύμαζε|θαυμάζειν|θαυμάζεσκον|θαύμαζ̓|θαυμάζομεν|θαυμάζω|θαυμάσσεται|θαύμαζον|θαυμάζωσιν|θαυμάζων
πελεμίζω|πελεμιζέμεν|πελέμιζεν|πελεμίζετ̓|πελέμιξεν|πελεμίξαι|πελεμίχθη
φλύω|ἔφλυε
ἐρωτάω|εἰρωτᾷς|εἰρώτα
παρατρέπω|παρατρέψας
