ὑφίημι|ὑφέντες
ἐντίθημι|ἐνθεμένη|ἔνθεο|ἐνθήσω|ἔνθετο|ἐνθέμεναι|ἐντιθέμεσθα
ἐκκυλίνδω|ἐξεκυλίσθη
καταπλήσσω|καταπλαγῆναι|κατεπλήγη
κατακοσμέω|κατακοσμήσησθε|κατεκόσμει
ἡνιοχεύω|ἡνιόχευεν|ἡνιόχεὐ
κλάζω|κλάγξας|κλάζοντε|κλάγξαντος|κεκλήγοντες|κεκληγὼς|κεκληγῶτας|ἔκλαγξαν|κεκλήγων
εἰσδύνω|ἐσδύσεαι
δίδημι|δίδη|διδέντων
ὑπεκσῴζω|ὑπεξεσάωσεν
ἐπέρομαι|ἐπήροντο
λιγαίνω|ἐλίγαινον
χαίρω|χαίρουσιν|χάρησαν|ἐχάρησαν|χαρέντες|χαίρω|χαίρετ̓|χαῖρε|χαίρεσκον|κεχαρησέμεν|χάρη|κεχάροντο|χαίροντι|χαίρων|χαίρετε|κεχαρηότα|κεχάροιτο|χαίροντα|κεχαροίατο|χαιρήσειν|ἔχαιρε|χαίροντ̓|χαίρετον|χαρείη|ἐχάρημεν|χαῖρεν|χαίροντες|χαίρουσι|χαῖρον|χαὶρων|χαίρῃς|χαῖῤ|χήρατο|κεχαρήσεται|χαῖρέ|ἐχάρη|χαίρει
ἐντανύω|ἐντανύσῃ|ἐντανύσῃς|ἐντανύεσθαι|ἐντάνυσε|ἐντανύσασθαι|ἐντανύσειεν|ἐντανύσαι|ἐντανύουσιν|ἐντανύειν|ἐντανύσειν
λιλαίομαι|λιλαιόμενόν|λιλαίεο|λιλαιόμενα|λιλαίεαι|λιλαιομένη|λιλαιόμενοι|λιλαίετο|λιλαίεται|λιλαίομαι|λιλαίεσθαι
ῥάπτω|ἐράπτομεν|ῥάπτομεν|ῥάψαι|ῥάπτειν|ῥάψε|ῥάπτεις
καθίζω|καθίσασα|κάθιζον|καθεῖσε|καθεῖσεν|καθίζειν|κάθιζ̓|κάθισαν|καθῖζεν|καθῖζε|καθίζει|κάθισον|καθίσσας|καθίζων|καθίζουσιν|καταείσατο|καθεζομένη|καθῖζον|καθίζοις
τηρέω|τηρήσαντες|τηρήσασι
προσμείγνυμι|προσμείξαντας|προσέμειξαν
δρύπτω|δρύψ̓|δρυψαμένω|δρύφθη
κατατρύχω|κατατρύχῃ|κατατρύχω
ἀπιστέω|ἀπιστοίη|ἀπιστῆσαι|ἀπίστεον|ἀπιστεῖν
κατακείω|κατακείμενος|κατακείομεν|κατέκειτο|κατακείετε|κατακεῖσθαι|κατακείαται|κατέκειτ̓|κατάκειτ̓|κακκείοντες
νοστέω|νοστήσαντες|νόστησας|νοστήσειε|νοστήσαντα|νοστήσῃ|νοστήσεἰ|νοστήσεις|νοστήσει|νοστήσαντι|νοστήσειεν|νοστήσας|νοστήσαντά|νοστήσειν|νοστήσομεν|νόστησ̓|νοστῆσαι|νοστησέμεν|νοστήσαιμεν|νοστήσαντ̓|νοστήσω
διψάω|διψάων
βρέμω|βρέμει|βρέμεται
ἀνθίστημι|ἀνθίστασθαι|ἀντέστη|ἀνθίσταντο|ἀντιστὰς|ἀντέστησαν|ἀντιστάντα
πυνθάνομαι|πυθόμην|πεύσεται|πεύσεαι|πεπύθοιτ̓|πύθηται|πεύσομαι|πευσόμενον|πέπυσσαι|πυνθανόμενος|ἐπυνθάνοντο|πέπυστο|ἐπύθοντο|πεπύσθην|πύθηαι|πυνθανόμην|πυνθάνομαι|ἐπέπυστο|πευσόμενος|πυθοίμην|πυθοίατο|πυθέσθαι|πυνθάνονται|πυθόμενοι|πεπύσθαι|πύθησθε|πυνθανόμενοι|πύθοιτο|πέπυσμαι|πύθωνται|πυθέσθην|πέπυσται
ἀπατιμάω|ἀπητίμησε
ἀποδείκνυμι|ἀποδεικνύντες|ἀποδεῖξαι|ἀποδεικνυμένους|ἀποδείξειε|ἀποδείκνυμεν
κλείω|κλείω|κληῗσαι|κλήϊσεν|κλείουσιν|ἐκλήϊσεν
ἀναστενάχω|ἀναστενάχουσιν|ἀνεστενάχοντο
καθιδρύω|καθίδρυε
κρατύνω|ἐκαρτύναντο|κρατῦναι
ἀπογίγνομαι|ἀπογενόμενοι
ἡσυχάζω|ἡσυχάσασα|ἡσυχάζετε|ἡσυχάζειν|ἡσυχαζούσῃ|ἡσυχάζοι|ἡσύχαζόν|ἡσυχάσασαν|ἡσύχαζεν|ἡσύχαζον|ἡσυχαζουσῶν
ἀράομαι|ἠρᾶτο|ἀρήσετ̓|ἠρήσατο|ἠρήσαντο|ἠρᾶτ̓|ἀρώμενος|ἀρήσασθαι|ἠρᾶθ̓|ἠρώμην|ἠρῶ|ἀρήμεναι|ἀρήσῃ|ἀρᾶται|ἀρησόμεθ̓|ἀρησαίατ̓
τείνω|τεῖνεν|τεῖναν|τέτατό|τείνῃ|τέταται|ἔτεινε|τείνας|τάθη|τετάσθην|ταθείς|τέταντο|τέταθ̓|ταθεὶς|τέτατο|τείνειεν
συγκλονέω|συνεκλόνεον
ἀνασεύομαι|ἀνέσσυτο
κεδάννυμι|κέδασθεν|ἐκέδασσε|κεδασθέντες|κεδασθείσης|ἐκέδασσεν
προσφύω|προσφὺς|προσφῦσα
ἐκβάλλω|ἔκβαλε|ἔκβαλλε|ἐξέβαλον|ἔκβαλεν|ἔκβαλον
περιστείχω|περίστειξας
καθαίρω|καθήρατε|κάθαιρον|καθαιρομένης|κάθηρεν|καθήραντες|κάθηράν|καθαίρειν|καθῆραι|κάθηρον|ἐκάθηρε
ἐπιφλέγω|ἐπιφλέγῃ|ἐπιφλέγει
ἀπουρίζω|ἀπουρίσσουσιν
περιστεναχίζομαι|περιστεναχίζετο
ἐρέχθω|ἐρεχθομένην|ἐρέχθων
βάλλω|βάλετ̓|βεβλήατο|βεβλήκοι|βάλλον|βαλέτην|βαλλόμενος|βάλλεαι|βλημένου|βάλετο|ἔβαλόν|βλεῖο|βλῆτο|βεβλημένον|βαλλόμεν̓|βάλλετε|βάλεν|ἐβάλλετο|βαλέει|βάλλειν|ἐβάλοντο|βάλλετ̓|βάλοισθα|βαλόμην|βεβλήαται|βαλὼν|βαλοῦσαι|βαλόντες|βάλλων|βλήεται|βάλλε|βαλλομένοισιν|βάλλεο|βάλοι|βαλόντας|βάλλ̓|βαλέοντι|βαλοῦσ̓|βέβληαι|ἔβαλον|βαλεῖν|βαλόντε|βεβλημένος|βάλλωσι|βάλλευ|βαλών|βάλλετο|βαλλόμενός|βεβλημένοι|βάλλουσι|ἔβαλεν|βαλλομένων|ἔβλητ̓|βάλλομεν|βαλέειν|ἔβαλέν|βάλῃσθα|βεβλήκει|ἔβαλε|βαλλόμενα|ἔβαλες|βάλλοντες|βάλ̓|βάλε|βάλλονται|βαλλομένη|βάληται|ἔβαλλεν|βάλλονθ̓|βλῆσθαι|βάλωμεν|ἔβαλλον|ἔβαλ̓|βάλον|ἔβλητο|βλημένῳ|βέβλητο|βέβληται|βάλλεν|βάλλουσιν|βάλῃ|βαλὸν|βάλοιμι|βάλλει|βάλῃσιν|βαλῶ|βαλέω|βάλῃσι|βεβλήκειν|βάλες|βαλούσας|βλήμενον|βλήμενος|ἔβαλλε|βαλλομένοιο|βάλω
νοέω|νοήσω|νοέω|ἐνόησαν|νοήσας|ἐνόησεν|ἐνόησας|νόησον|νόησε|νόει|νοήσει|νοῆσαί|ἐνόησε|νοέοντι|νόησεν|νοεούσῃ|ἐνόησ̓|νοῆσαι|νοήσῃ|νοήσῃς|νοέεις|νόησα|νοήσεις|ἐνόησα|νοήσατο
ἀφικάνω|ἀφίκανεν|ἀφικάνεις|ἀφικάνω|ἀφικάνει
ἀποζάω|ἀποζῆν
περονάω|περονήσατο|περόνησε|περόνησεν|περονᾶτο
θνήσκω|τεθνηῶτας|θάνω|θάνοιεν|θάνοι|θνῄσκων|ἔθανεν|θνήσκοντας|θάνον|τεθνηώτων|τεθνηὼς|θνῇσκον|τεθνηῶτα|θάνῃσι|θάνε|θάνεν|τεθναίη|τεθναίης|τεθνηκυῖαν|θάνωσι|τεθνάμεναι|τεθνηότος|θανέειν|θνῄσκουσ̓|θανόντα|τεθνηῶτά|θανὼν|θανόντι|θανών|τέθναθι|θάνωμεν|θνήσκοντα|θάνῃς|τεθνηκότος|θανεῖν|τεθνηότας|τεθνάμεν|τεθνᾶσιν|τεθνᾶσι|θάνῃσιν|τεθνηότα|θάνες|θνήσκοντες|τεθναίην|τεθνηῶτι|τεθνηῶτος|τέθνηκε|ἔθαν̓|τεθνεῶτί|θανέεσθαι|τέθνηκεν|θανόντων|τεθνάτω|θανόντος|τεθνεώτων
καταμύσσω|καταμύξατο
ἐπεντανύω|ἐπεντανύσας
ἐριδμαίνω|ἐριδμαίνωσιν
δορυφορέω|ἐδορυφόρουν
ἐποπτάω|ἐπώπτων
βαρύθω|βαρύθει
ἀγορεύω|ἀγορεύσατ̓|ἀγόρεὐ|ἀγορεύοντες|ἀγόρευε|ἀγορεῦσαι|ἀγορεύοις|ἀγόρευες|ἀγορεύω|ἀγόρευσεν|ἀγόρευεν|ἀγορευέμεν|ἀγορεύοι|ἀγορεύεις|ἀγόρευσε|ἀγορεύοντος|ἀγορεύειν|ἀγορεύσω|ἀγορεύει|ἀγόρευον|ἀγορευέμεναι|ἀγορεύων|ἀγόρευσον
ἀίω|ἄϊον|ἀΐων|ἀίοντες|ἀΐεις|ἄϊε|ἄϊεν|ἀΐοντες|ἀΐοντι|ἀΐοιεν|ἀΐουσα|ἀίεις
παράφημι|παρφάμενος|παρφάσθαι|παράφημι|παραιφάμενος
ποτινίσσομαι|ποτινίσεται
ἐπικλύω|ἐπέκλυεν|ἐπέκλυε
ἀποσκυδμαίνω|ἀποσκύδμαινε
συλεύω|συλεύειν|ἐσύλευον
ἀποχωρέω|ἀποχωρησάντων|ἀπεχώρησεν|ἀπεχώρησαν|ἀπεχώρουν
ἀναλέγω|ἄλλεγον|ἀλλέξαι
κραδάω|κραδάων
ἀποπροτέμνω|ἀποπροταμών
ἀναπείθω|ἀνεπείσθημεν|ἀναπειθομένους|ἀναπείσας
νηέω|νηήσασθαι|νήει|νήεον|νηῆσαι|νηήσας|νηησάσθω|νήησαν
κατά-καθέζομαι|καθεζόμενοι|καθεζομένους|ἐκαθέζετο
μυκάομαι|μεμύκει|μυκώμεναι|μύκε|μεμυκὼς|μύκον
δράω|δρῷμεν|δράσαντές|δρῶσιν|δρᾶν|δρώοιμι|δρᾶσαι|δρᾷ|δρῶντες|δράσετε|δρῶντας|ἐδρῶμεν|δρῷεν
διαφεύγω|διέφυγον
ἐρυθαίνομαι|ἐρυθαίνετο
ἐπιφέρω|ἐπιφέρειν|ἐπένεικα|ἐπενεγκεῖν|ἐποίσει
ἀνακράζω|ἀνέκραγον
σιτέομαι|σιτέσκοντο
ἀνιχνεύω|ἀνιχνεύων
περίκειμαι|περίκειται|περίκειτο|περικείμενον
ἐξάπτω|ἐξάπτων|ἐξάπτεσθε|ἐξῆπτεν|ἐξάψας
πρόσφημι|προσέφης|προσέφη|προσέφην|προσφάσθαι
ἠερέθομαι|ἠερέθονται
ἐνικλάω|ἐνικλᾶν
ἐπισσεύω|ἐπεσσεύοντο
εἰσίζομαι|ἐσίζηται
τεκμηριόω|τεκμηριοῖ|τεκμηριῶσαι
ἀπονίναμαι|ἀπόνηθ̓|ἀπόνητο|ἀπόναιο|ἀπονήμενος|ἀπονήσεται
βλάπτω|βλαψόμεθα|βλάπτει|βλάπτε|βλάπτεσθαι|βλάψε|ἐβλάφθησαν|βλάπτουσ̓|βλαπτομένους|βλάπτουσι|βλάψασα|βλάψαι|ἔβλαψε|βλάβεν|βλαφθέντε|βλάψας|βλάπτοιεν|ἔβλαβεν|βλαβῆναι|βλάπτουσί|βλάπτειν|βλάψασαν|βλάψεν|βλαφθεὶς|βλαφθέντα|βλάπτοι|ἔβλαψάς|ἔβλαψαν|βεβλαμμένον|βλάβεται|βλάψειν
προτέμνω|προταμοίμην|προταμὼν
ἐρεύγομαι|ἐρυγόντα|ἤρυγεν|ἐρευγομένης|ἐρευγόμενοι|ἐρεύγεται|ἐρευγόμενον|ἐρεύγετο
ἐπιμηνίω|ἐπεμήνιε
σκοπιάζω|σκοπιάζων|ἐσκοπίαζον|σκοπιαζέμεν
ἐκφύω|ἐκπεφυυῖαι
τρίβω|τριβέμεναι|τρῖψαι|τρίβεσθε
ἐπιστενάχω|ἐπεστενάχοντο
κίω|κιόντες|κιοίτην|κιὼν|κιούσῃ|κιόντι|κιόντα|κίον|κιόντας|κιόντε|κίομεν|ἔκιε|κίῃς|κιοῦσαι|κί̓|κίε|κίοιτε|κίοι|κίεν|ἔκιον|κιών
ἀνερείπομαι|ἀνηρείψαντο
ὁράω|ὅρηαι|ὁρῶν|ὁρῶμαι|ὁρᾶται|ὄπωπα|ὁρῶντο|ἑώρων|ὁρᾶτο|ὁράασθαι|ὁρῷτο|ὁρόωσα|ὁρῶσα|ὄψῃ|ἑωρῶντο|ὀψομένη|ὄψεσθ̓|ὅρα|ὁρῶ|ὁρώμενος|ὁρόῳτε|ὁρόωντες|ὤφθησαν|ὁρᾶτε|ὁρᾷς|ὀψόμεναί|ὄψεται|ὄπωπας|ὄψει|ὁρόω|ὁρᾷ|ὄψεσθε|ὄψεαι|ὁρᾶσθαι|ὁρόων|ὁρῶντες|ὁρώμενοι|ὁράᾳς|ὄψεσθαι|ὀψόμενος|ὁρῶμεν|ὀπώπει|ὁρᾶν
ἐπιπλάζομαι|ἐπιπλαγχθείς
ὁμοιόω|ὁμοιωθήμεναι
ἀμφιθέω|ἀμφιθέουσι
ἀποικίζω|ἀπῴκισε|ἀπῴκισαν
ὑπεξαναδύομαι|ὑπεξαναδὺς
προπίπτω|προπεσόντες
ἀτέω|ἀτέοντα
ἐπιτέρπομαι|ἐπιτέρπεται
στρατόω|ἐστρατόωντο|ἐστρατόωνθ̓
στοναχέω|στοναχῆσαι
ἀναπετάννυμι|ἀναπεπταμένας
ἄγχω|ἄγχε
μαρμαίρω|μαρμαίροντας|μαρμαίροντες|μαρμαίροντα
ἐκτίθημι|ἐκθεῖσαι
ἀφρονέω|ἀφρονέοντες
ὑποσημαίνω|ὑποσημαίνοντας
διανοέομαι|διανοούμενοι|διανοήθητε|διανοηθέντας|διανοούμενον|διανοηθέντες|διενοεῖτο
ἱκάνω|ἱκάνεις|ἱκάνω|ἵκανε|ἱκάνομαι|ἱκάνοι|ἱκάνει|ἱκάνεται|ἱκάνετον|ἱκάνομεν|ἱκανέμεν|ἵκανον|ἵκανεν
νάω|νάει|νάουσιν
ἐγκαταλείπω|ἐγκαταλιπόντες
ἀμφιμυκάομαι|ἀμφιμέμυκεν
περιίστημι|περίστησαν|περισταῖεν|περιστήσαντες|περιστήσαντο|περιέστη|περιίσταθ̓|περίστησάν|περιστάθη|περιίστασθαι|περιέστηκεν|περιστήωσ̓
δαιδάλλω|δαιδάλλων
σκοπάω|σκοπεῖν
ἁλίσκομαι|ἁλοίην|ἁλώω|ἁλοίη|ἁλῶναι|ἁλόντε|ἡλίσκετο|ἁλίσκονται|ἁλώῃ|ἁλώμεναι|ἥλω|ἁλισκόμεναι|ἁλοῦσά|ἑάλωσαν|ἁλίσκηται
κτείνω|κτεῖν̓|κτενέεις|κτείνουσι|κτεινομένων|κταμένοιο|κτανέοντα|κταμένῳ|κταμένοισι|κτείνειν|κτείνονται|κτείνωμι|ἔκταθεν|ἔκτεινεν|κτενέειν|κτείνασα|κτάμεναι|κτεινώμεθα|ἔκτανεν|κταμένοισιν|ἔκτανον|κτείνας|κτέωμεν|κτεῖνον|κτείνεσκε|κτείναντες|κτεινόμενος|κτείνῃς|κτεινομένους|κτεῖναι|κτείνοντο|ἔκταν|κτάν̓|ἔκτανες|κτείνῃ|κτείνοντ̓|ἔκτεινον|κταμένης|ἔκτανε|κτεῖνας|κτεινώμεθ̓|κτείνωμεν|κτάνον|κτείνοντές|κταμένων|κτάσθαι|ἔκτεινε|κτείνων|ἔκτα|κτεῖνε|ἔκταν̓|κτείνω|κτεινομένῳ|κτείναιμι|κτεῖναί|κτείνει|κτάνε|κτείνεις|κτενέει|κτενεῖ|κτείνεσθαι|κτενέω|κτεῖνεν
ἀλάομαι|ἀλώμενοι|ἀλώμενον|ἀλήθην|ἠλᾶτο|ἀλωμένη|ἀληθείς|ἀλόωνται|ἀλόω|ἀλώμενος|ἀλήθης|ἀλᾶτο|ἠλώμην|ἀλᾶσθε
μιαίνω|μιαίνεσθαι|μιάνθην|μιάνθησαν|μιήνῃ|ἐμιαίνετο
ῥιπτάζω|ῥιπτάζων
περιδύω|περίδυσε
ἀμενηνόω|ἀμενήνωσεν
λανθάνω|ἔλαθε|ἔλαθεν|λάθωσι|ἔληθον|λάθον|λήθετ̓|λήθεαι|λῆθε|ἔλαθ̓|λανθανόμην|λήθοντε|λάθοντο|λήσειν|λελάθῃ|λάθῃσι|λήσεσθαι|λήσομαι|ἐλάνθανε|ἔληθε|λελαθέσθ̓|λελάθοντο|λῆθεν|λάθωμαι|λάθετ̓|λαθέτην|λάθηται|λάθωνται|λαθέσθαι|ἐλάνθανον|λάθε|λάθ̓|λήσεις|λήθει|λαθοίμην|λάθοι|ληθάνει|λήθοντο|λαθών|λήθεις|λήθω|λήθετο|λήθεσκεν|ἐλήθετο|λαθοίατο|λελασμένος|ἐλήθομεν|λάθεν|λαθὼν|λελαθέσθω|λανθάνειν|λήσει
κοτέω|κοτέοντε|κεκοτηότι|κοτέουσ̓|κοτέσσεται|κοτέουσιν|κοτέων|κοτέοντο|κοτεσσαμένη|κοτέσσατο|κοτεσσάμενος|κοτέοντος
ἐντρέπω|ἐντρέπεται
σμύχω|σμύχοιτο|σμῦξαι
ἐκνοστέω|ἐκνοστήσαντε|ἐκνοστήσαντι
τίνω|τίσειν|τίσουσι|τίσω|ἔτισας|ἔτισεν|τῖσον|τίσεσθαι|τίνων|ἔτισ̓|τίσετε|ἐτίσατο|τείσεις|ἔτισαν|τισόμεθ̓|τεισαίμεθα|τίσωσιν|τίσαιτο|τίσειαν|τίσασθαι|τισαίατο|τίσεις|τίσατο|τισαίμην|τίνειν|ἔτισε|τῖσαι|τίσεται
ὀνίνημι|ὀνήσειν|ὀνήμενος|ὄνησα|ὀνήσεται|ὀνήσεαι|ὀνίνησι|ὀνήσει|ὤνησεν|ὤνησαν|ὤνησας|ὄνησο|ὀνησόμεθ̓
τέλλω|ἐτέταλτο|τέταλτο|τελέω|ἔτελλεν|ἔτελλε
ὑδρεύω|ὑδρεύοντο|ὑδρευούσῃ
καταδεύω|κατέδευσας
πυρπολέω|πυρπολέοντας
κυδαίνω|κύδαινε|κυδαίνων|κύδαινόν|κυδῆναι|κύδηνεν
ὑποδάμναμαι|ὑποδάμνασαι
κτέομαι|κτήσατο|ἐκτῆσθαι|ἐκτήθη
στένω|στένει|ἔστενεν|ἔστενε
ἀθύρω|ἀθύρων
χυτλόω|χυτλώσαιτο
ἀποσφάλλω|ἀποσφήλωσιν|ἀποσφήλειε
ἐράω|ἐράασθε
τρώγω|τρώγειν
ἀντί-ἐπιπλέω|ἀντεπέπλεον
νέω|ἔννεον|νήσαντο
ἐπεξέρχομαι|ἐπεξέρχεται|ἐπεξελθών|ἐπεξέλθωσιν|ἐπεξῆλθον
νομίζω|νομίζομεν|νομίσῃ|ἐνόμιζε|νομίζοντες|ἐνόμισαν|νομίζων|νομίσας|νομίζειν|νομίσητε|ἐνόμιζεν|νομίζω|νομίσαντες|νομίζει|ἐνόμιζον|νομιζόμενα|νομίσαντα|νομίζουσι
ἀπονέω|ἀπονέωνται
ποντοπορεύω|ποντοπορευέμεναι|ποντοπορεύων
μεταλήγω|μεταλήξαντι
τίω|τιέσκετο|τίετ̓|τίσει|τίσω|τῖες|τίεται|τετιμένον|τῖεν|ἔτιον|τῖ̓|τίωσ̓|τίετο|τετιμένος|τίεσκεν|τίω|τίσουσ̓|τιέμεν|ἐτίομεν|τίεσκον|τίσουσιν|τίουσαι|τίουσιν|τῖε|τιοίμην|τίεν|τίουσι|τίει|τίον|τῖον
τροχάζω|τροχόωντα
λωβάομαι|λωβήσασθε|λωβήσαιο
ἀποκτείνω|ἀποκτείνων|ἀπέκτανον|ἀπέκτανε|ἀποκτάμεναι|ἀποκτάμεν|ἀποκτάνῃ|ἀποκτείνω|ἀπέκτατο|ἀπέκταμεν|ἀποκτεῖναι|ἀποκταμένων|ἀπέκτεινεν|ἀποκτείνεις|ἀπέκτειναν|ἀποκταμένοιο
βιάζω|βιασθῶσι|βιαζόμενοι|βιάζεται|βιάζετο|βιάζωνται|βιαζόμενον|βιάζεσθαι|βιάζετε|βιάζηται|βιάσασθαι|βιαζομένων
συνδέω|ξυνδῆσαι|συνέδησα|ξυνέδησεν
προτύπτω|προὔτυψε|προὔτυψαν
λοχάω|λοχησάμενος|λοχήσομαι|λοχόωσι|λοχῆσαι|λοχόωσιν|λοχῶσιν|λοχήσας|λοχόωντες
ὁρμάω|ὡρμᾶτο|ὁρμήσωνται|ὅρμησ̓|ὥρμα|ὁρμήσατ̓|ὁρμηθήτην|ὁρμηθῆναι|ὁρμώμενοι|ὥρμηνται|ὁρμηθέντος|ὁρμῆσαι|ὁρμᾶτ̓|ὁρμᾶτο|ὁρμηθεὶς|ὁρμηθέντε|ὁρμᾶσθαι|ὁρμήσῃ|ὁρμήσειε|ὁρμηθέντι|ὁρμήθησαν|ὁρμῶντ̓|ὁρμηθέντες|ὁρμηθέντα|ὁρμήθη|ὁρμηθείς|ὡρμήθησαν
τραπέω|τραπέουσι
λαβρεύομαι|λαβρεύεαι
ἀτέμβω|ἀτεμβόμενος|ἀτεμβόμενός|ἀτέμβονται|ἀτέμβειν|ἀτέμβει
ὀρύσσω|ὀρύξαι|ὀρύξας|ὀρύξομεν|ὀρύσσειν|ὄρυξαν|ὄρυξ̓
ἀφίστημι|ἀποσταῖεν|ἀπέστησεν|ἀφέστηκε|ἀφέστατε|ἀφεσταότες|ἀπέστη|ἀφεστήκει|ἀφεστηκότες|ἀφεστᾶσ̓|ἀποστήσωνται|ἀφεσταίη|ἀφισταμένους|ἀποστάντων|ἀφέστασαν|ἀφεστᾶσιν|ἀφισταμένων|ἀφίσταται
ὑφέλκω|ὕφελκε
σέβομαι|σέβεσθε
μειδιάω|μειδιόωσα|μειδιόων
ἐπιβρίθω|ἐπιβρίσῃ|ἐπιβρίσειαν|ἐπέβρισαν
διανύω|διήνυσεν
δάω|δεδάηκε|δαείω|ἐδάην|δαῶμεν|δαήσεαι|δεδαὼς|δεδάασθαι|δεδαηκότες|δεδάηκας|δέδαεν|δαῆναι|δαήμεναι
ἔρχομαι|ἐλεύσεται|ἐλθέ|ἐλθὲ|ἔλθω|εἰλήλουθεν|ἔλθῃσιν|ἐλθόντ̓|ἐλθούσας|ἐλθοῦσαι|ἐλθοῦσι|ἔρχεσθον|ἐλευσόμεθ̓|ἔλθετ̓|ἔλθωσ̓|ἐλθόνθ̓|ἔλθῃσ̓|ἐλεύσεαι|ἔλθῃς|ἦλθεν|ἐρχόμενοι|ἤλθεθ̓|ἐρχομενάων|ἤλυθεν|ἐρχόμεθα|ἔρχησθον|ἐλεύσομαι|ἔλθῃ|ἔρχονται|ἐλθόντι|ἔρχεσθαι|ἔρχεσθε|ἐλθόντες|εἰληλούθει|ἐρχομένοισι|ἐρχομένω|εἰλήλουθε|ἔρχηται|ἐλθοῦσιν|ἔλθωσι|ἔρχομ̓|ἔρχεται|εἰλήλουθας|ἔρχεαι|ἐλθοῦσαν|ἦλθε|ἦλθες|ἔλθοις|ἐλθέμεν|ἤλυθον|ἐλθόντα|ἔλθητε|ἔρχεο|ἦλθον|ἔλθητον|ἐλεύσονται|ἐρχομένων|ἔρχευ|ἐρχομένην|ἐλθοῦσ̓|ἐλθεῖν|ἐλθών|εἰλήλουθα|ἐλεύσεσθαι|ἤλυθ̓|ἐρχομένοιο|ἐρχόμενος|ἐληλουθὼς|ἐρχομένῳ|ἐλθόντος|ἔλθοι|ἤλθετε|ἐρχομένη|ἤλθομεν|ἐλθέμεναι|ἐρχομένοισιν|ἤλυθες|ἔλθοιμι|ἦλθ̓|ἐλθοῦσα|ἔρχεό|ἔνθεο|εἰλήλουθμεν|ἔλθωμεν|ἐλθόντε|ἐρχόμενον|ἐλθόντων|ἐλθὼν|εἰληλουθώς|ἐρχόμεθ̓|ἤλυθε|ἔρχεσθ̓|ἔλθῃσι|ἐρχομένοις|ἔρχομαι
ἀμφιδαίω|ἀμφιδέδηε
κυρτόω|κυρτωθέν
δηιόω|δῃῶν|δηϊόωντες|δῃώσαντες|δῃώσειν|ἐδῄου|δῃῶσαι|ἐδῄωσαν|δῃωθέντων|δῃώσαντε|δηιόῳεν|δῃοῦν|δῃώσῃ|δῄουν|δῃώσας|δῃώσωσιν|δηϊόων|δῃωθέντες|δηϊόωντο
εἰμί|ἔστε|ἔστων|ἔον|ἔστιν|εἰμὶ|εἰμί|ἐών|ἔσεται|ἔῃσι|ἔσομαι|ἐσσόμεθ̓|ἐοῦσι|ἔσσομαι|ἐόν|ἐστί|εἰμέν|ἔασιν|ἰόντας|ἔστω|ἤστην|ἔησθα|ἐόντα|ἔσονται|ἐσσομένοισιν|ἐσσομένῃσιν|ἰόντα|ἐσόμεσθα|ἔωσι|εἰσὶν|ἐσόμεθα|ἐσσόμενα|ἐστι|ἐόντες|ἔασι|ἔωσιν|εἲς|εἶναι|ἐόνθ̓|εἰμεν|ἔσσεται|ὦσι|ἐούσης|ἐστόν|ἔστί|ἐοῦσ̓|ἦμεν|ᾖ|ἐστὶν|εἴς|ἐστ̓|ἔσομ̓|ἐούσῃ|ἰοῦσαι|εἴσ̓|ἔσοντ̓|εἰσί|ἔσσετ̓|ἐσμὲν|ἤην|εἰμι|ἐόντε|ἦτε|ἦν|ᾖσι|ὂν|ἔσεσθαι|ἔμεν|ὤν|ἔμμεναι|εἰσι|ἦσαν|ἔσθ̓|εἶς|ἐστίν|οὖσαν|οὖσι|εἰμ̓|ἔσεαι|ἐόντι|ἔσκεν|ἔσεσθε|εἰσὶ|οὐσῶν|ἐσμέν|ἰοῦσαν|ἐοῦσαν|ἦα|ἔστ̓|εἴην|εἰμὲν|ἐστὸν|εἶτ̓|οὔσης|ἐσσὶ|ἔμεναι|εἶεν|ἔσεταί|ἴωσι|ἔην|ἔσσεσθ̓|εἴμ̓|ὦσ̓|ἔσκον|ἐσσ̓|ἐστὲ|ὄντα|ἔσται|ἔσσεσθαι|ἦεν|εἴης|ἐσσεῖται|ᾖσιν|ἐστε|ἐσσι|ἔσσ̓|ἐσμεν|ἔασ̓|ὄντος|ἐόντων|ἔμμεν|εἰσιν|ἦσθα|ἔσεσθον|ἔσσοντ̓|ἰόντες|οὖσαι|εἴατο|ἔῃ|εἴη|ὢν|ἐσθ̓|ἔστι|ἔσαν|ἔσκε|ἐόντ̓|ἐσσομένοισι|ἔα|ἔσάν|οὖσιν|ὄντων|εἶμεν|ἔσσεαι|ἐστέ|ἐστιν|ἐόντος|ἐὸν|ὄντας|ἔσῃ|ἰόντος|ἔω|ἐσόμενον|ἴωσιν|ἔοις|ἔσχ̓|ἐστον|εἰσ̓|ἐόντας|ἐσσί|ἔσσονται|εἰσίν|ἔῃσιν|ἐοῦσα|οὖσα|ἐὼν|ἐστὶ|ὄντες|ὦσιν|ἔοι
μαίνομαι|μαίνεται|μαίνονθ̓|μαινόμενος|μαινόμενε|μαίνεσθαι|μαίνετο|μαινομένῃ|μαίνεσθε|μαίνεαι|μαινόμενον|μαίνηται|μαινομένοιο|μαινομένῃσιν
συνεπιλαμβάνομαι|ξυνεπελάβοντο
ἐπιστρωφάω|ἐπιστρωφῶσι
ἐπιπληρόω|ἐπεπλήρωντο
ὑβρίζω|ὑβρίζων|ὑβρίξεις|ὑβρίζοντες|ὑβριζόμενοι|ὑβρίζεσθαι
ῥιγόω|ῥιγωσέμεν
ἀποκηδέω|ἀποκηδήσαντε
αὐλίζομαι|αὐλιζομενάων
ἐλλείπω|ἐλλείπομεν
ψαύω|ψαύσῃ|ψαῦον|ψαύουσιν
φορύσσω|φορύξας
ποιμαίνω|ποιμαίνων|ποιμαίνοντο|ποιμαίνεσκεν|ποιμαίνοντ̓
φέρω|οἶσε|ἐνείκατε|φέρωμεν|φέροντες|φέροντος|φέρεσθαι|φέρω|φερώμεθα|ἐνείκας|φέρωμαι|φέρῃσι|φερέσθω|ἔφερον|φέρον|φέροιεν|οἴσει|φέρεις|φέρουσα|φέροι|φέρηται|ἐνεῖκαι|οἴσειν|ἤνεικεν|ἐφέροντ̓|φέρτε|οἴσεται|φέρομεν|φέρουσιν|οἴσετον|φέρεσκε|ἐνείκῃ|ἐνείκαι|οἴσουσιν|ἔνεικε|φέροντο|φερέτω|φέρων|οἰσέμεν|φέροις|οἰσομένη|οἴσουσι|φέρειν|ἔνεικαν|φέρεσκον|φερόμην|φέρεται|οἴσῃ|φέρῃ|οἴσεσθαι|φερέμεν|οἴσω|ἠνείκαντο|ἐνείκω|φέροιο|φέρονται|ἐνείκαμεν|οἰσόμενος|οἴσετε|φεροίμην|φέρουσαν|οἰσέτω|φέρει|οἴσομεν|φέῤ|φέρῃσιν|πέροντες|φέρετ̓|ἤνεικαν|ἔνεικεν|φέρητον|φερέσθων|φέροντα|οἴσουσ̓|φέροντας|φέρουσαι|φέροιτο|φέρεν|φέρε|ἐφέροντο|οἴσων|φερέτην|οἰσέμεναι|ἔφερεν
καθαιρέω|καθαιρήσουσι|καθῄρουν|καθῄρει|καθελόντες|καθαιρεῖν|καθελεῖν|καθαιροῦντας|καθελοῦσι|καθείλομεν|καθέλοιμεν|καθελοῦσα|καθαιροῦντες|καθέλῃσι|καθαιρεθείη
βεβόλημαι|βεβολημένος|βεβολήατο
χηρεύω|χηρεύει
ἐξανίημι|ἐξανιεῖσαι
εὔχομαι|εὔχεσθαι|εὐχομένοισι|εὔχομ̓|εὐχομένου|εὐχόμενόν|εὔχοντο|εὐξαμένοιο|εὔξεαι|εὔχετ̓|εὔξαντο|εὐχομένη|εὐχόμενος|εὐχομένης|εὔχετο|εὐξαμένου|εὔχομαι|εὐχόμεθ̓|εὔχεο|εὐχόμεναι|εὐξάμενός|εὐξάμενοι|εὐχομένω|εὔχἐ|εὐξαίμην|εὐξάμενος|εὐχόμενοι|εὔχεται|εὐχομένοιο|εὐξαμένῃ|εὔχεαι|εὔξατο|εὔχεσθε
διίστημι|διαστάντες|διαστήτην|διασταῖεν|διέσταμεν|διίστατο|διέστησαν|διέστη
μετακλαίω|μετακλαύσεσθαι
ἀνείργω|ἀνέεργε|ἀνέεργον
ἀναδιδάσκω|ἀναδιδάξαι
ἀντιλέγω|ἀντέλεγον
κατείβω|κατειβόμενον|κατείβετο|κατείβετον
μιμνήσκω|μνησάμενοι|μνησαίατο|μνησάσθω|μνήσασα|μίμνησκ̓|μέμνημαι|μνησαμένω|μνήσασθαι|μνησόμεθ̓|μεμνέῳτο|μέμνητ̓|μιμνήσκεται|μέμνηται|μνησαμένοις|μνησώμεθα|μνήσω|μνήσαντο|μέμνησαι|μνήσῃ|μνησάμενος|μνησαίαθ̓|ἔμνησας|μνήσονται|μνήσομαι|μιμνήσκοιτο|μεμνημένος|μνησαμένῳ|μνησθῆναι|μνήσασθε|μνήσατο|ἐμνήσατο|μνησόμεθα|μεμνῆσθαι|μεμνώμεθα|μνησαμένη|μεμνήσεσθαι|ἐμνήσθη|μεμνημένον|μνησθέντας|μιμνήσκεο|μεμνήσομ̓|μιμνησκόμενος|μεμνημένοι|μνήσαιτο|μνῆσαι|μέμνηαι|μέμνῃ|μιμνησκόμεναι|μιμνήσκοντο|μνησάσκετο|μνήσατ̓|μεμνημένη|μεμνῄμην|μνήσει|μνήσεσθαι|μέμνηντο|μιμνήσκεσθαι
πλήσσω|πέπληγον|ἐπέπληγον|πλήξῃ|πλήξειε|πεπληγυῖα|πλῆξ̓|πλῆξεν|πεπλήγετο|πληγέντε|πλῆξα|πεπλήγων|πληγέντι|πεπλήγοντο|πληγεῖσ̓|πληγεῖσα|πλῆξε|πληγέντα|πλήγη|πέπληγόν|πληξάμενος|πλήσσουσι|πλήξαντε|πλήξας|πεπληγέμεν|πληγεὶς
ἀμφιέννυμι|ἀμφιέσαντο
ἐφίζω|ἐφεσσάμενος|ἐπιέσσαμεν|ἐφέσσαι|ἐφῖζε|ἐπιεισαμένη|ἐπιείσομαι|ἐφίζεσκε
ἀέξω|ἄεξε|ἀέξῃ|ἀέξων|ἀέξω|ἀέξετο|ἀέξουσιν|ἀέξεται|ἀέξει|ἀέξειν
ἀποκοσμέω|ἀπεκόσμεον
μέμφομαι|ἐμεμψάμην|μεμφόμενοι|μέμφονται
κραίνω|κρηῆναι|κεκράανται|κρηήνατ̓|κρήηνον|κραίνουσι|κρῆνον|κρανέεσθαι|ἐκραίαινεν|κρῆναί
φαγεῖν|ἔφαγόν|φάγες|φάγῃσι|φαγόντε|φάγον|φάγωσι|φαγέμεν|φάγοιτε|φάγοι|φαγὼν|φάγομεν|φάγε|φαγέειν|ἔφαγε|φάγωσιν|φάγῃσιν
περιφράζομαι|περιφραζώμεθα
κυέω|ἐκύει|κυέουσαν
παρατάσσω|παραταξάμενοι
ἀλεείνω|ἀλεείνοντες|ἀλεείνω|ἀλέεινε|ἀλεείνεις|ἀλεείνει|ἀλεείνων|ἀλέεινεν
ἐσείδω|εἰσεῖδον|ἔσιδε
ἐκβαίνω|ἐκβαίνοντα|ἔκβητ̓|ἐκβήσαντες|ἐκβὰς|ἐκβῆναι|ἐκβάντες
ἐπαείρω|ἐπάειραν
παμφαίνω|πάμφαινον|παμφαίνῃσι|παμφαίνων|παμφαίνοντας|παμφαῖνον|παμφαίνονθ̓
προεῖδον|προΐδωσιν|προϊδὼν|προΐδωνται|προΐδωμεν|προϊδών|προϊδόντες|προϊδεῖν|προΐδοι
ἀντιστρατοπεδεύω|ἀντεστρατοπεδεύοντο
συναίνυμαι|συναίνυτο
προσάγω|προσήγαγε|προσάγοντες|προσάγεσθαι
τυγχάνω|ἔτυχες|τυχόντα|τετύχηκε|τεύξεσθαι|τυχεῖν|ἔτυχον|ἐτύγχανον|τύχωμι|τύχῃσι|τύχε|τυχὼν|ἐτυγχάνετε|ἔτυχε|τύχῃ|τετευχώς|τυγχάνειν|τυχήσας|ἐτετεύχατο|τύχησε|ἔτυχεν|τυχών|ἐτύχησεν|τύχοις|τύγχανε|τύχῃς|τετυχηκώς|ἐτύχησε
εἰκός|εἰκὸς|ἐϊκυῖ̓|ἐϊκυῖαν|εἰκυῖα|εἰκός|ἐϊκὼς|ἐϊκυῖα|ἐικυῖα
προοφείλω|προυφειλομένης
ἐγχρίμπτω|ἐγχριμφθεῖσα|ἐγχριμφθήτω|ἐγχρίμπτοντο|ἐγχρίμψας|ἐνιχριμφθέντα|ἐγχριμφθείς
ἀπεχθαίρω|ἀπεχθήρω|ἀπεχθαίρει
ἀτιμάζω|ἀτιμάζουσιν|ἀτιμάζει|ἠτίμασεν|ἀτιμάζουσι|ἀτιμάζοντες|ἀτιμάζεσκε|ἀτιμάζοντας
πρεσβεύω|ἐπρεσβεύσαντο|πρεσβευόμενοι|πρεσβευομένων|πρεσβευσόμενοι|πρεσβεύεσθαι|ἐπρεσβεύοντο
παρατρωπάω|παρατρωπῶσ̓
ἐξαρπάζω|ἐξήρπαξεν|ἐξήρπαξ̓|ἐξήρπαξε|ἐξαρπάξασα
κατοικίζω|κατῴκιζε|κατῳκίζετο|κατοικίσαι|κατῴκισαν
παραπαφίσκω|παρήπαφεν
δείξω|δίον
διασχίζω|διέσχισεν|διεσχίσθη
ὀδύσσομαι|ὀδώδυσται|ὠδύσαο|ὠδύσατο|ὀδύσαντο|ὠδύσατ̓|ὀδυσσαμένοιο|ὀδυσσάμενος
ἐργάζομαι|ἐργάζεσθαι|ἐργασαμένη|εἴργασμαι|εἰργάξετο|εἰργασμένοι|ἐργάζοντο|ἐργάζοιο
περιβαίνω|περίβη|περιβάντα|περιβὰς|περιβῆναι|περίβησαν
ἀπαμύνω|ἀπαμύνασθαι|ἀπαμυναίμεσθ̓|ἀπαμύνετο|ἀπήμυνεν
μισέω|μίσησεν
ἐνέπω|ἐνίσπες|ἐνέπουσα|ἐνέποντε|ἐνίσπω|ἔνισπε|ἐνίσποι|ἔννεπε|ἐνίψω|ἐνισπεῖν|ἐνισπήσω|ἐνίσπῃ|ἐνίσποις|ἐνέποντες|ἐνέποντα|ἐνέποιμι|ἐνίψει|ἔνισπες
φρίσσω|πεφρίκασιν|ἔφριξεν|φρίξας|φρίσσει|φρίσσουσιν|πεφρικυῖαι|πεφρίκασι
ἐγκοσμέω|ἐγκοσμεῖτε
θαυμάζω|θαυμάσσεται|θαύμαζεν|θαυμάζω|θαυμάζωσιν|θαυμάζων|θαυμάζομεν|θαύμαζ̓|θαύμαζον|θαυμάζειν|ἐθαύμαζον|θαυμάσαι|θαυμάζεσκον|θαυμάζοντες|ἐθαύμασέ|θαυμαζόντων|θαύμαζε|θαυμάζεσθαι
ἐντύω|ἔντυεν|ἔντυον
ἐπιλωβεύω|ἐπελώβευον
οἴω|οἴω
προίσχω|προϊσχόμενοι
διατίθημι|διαθεῖναι
πένομαι|πενώμεθα|πένεσθαι|πένοντο|ἐπένοντο
κυλίνδω|ἐκυλίνδετο|κυλίνδει|κυλινδομένη|κυλινδομένην|κυλίσθη|κυλίνδων|κυλίνδεσθαι|κυλινδόμενός|κυλίνδετο|κυλινδόμενος|κυλίνδεται|κυλίνδον|κυλινδόμενα
ἀπολήγω|ἀπολήγει|ἀπολλήξειαν|ἀπόληγε|ἀπολλήξῃς|ἀπολλήξωσι|ἀπολλήξεις|ἀπέληγεν|ἀπέληγε
ἐξαλαπάζω|ἐξαλάπαξαν|ἐξαλαπάξειν|ἐξαλαπάξῃ|ἐξαλαπάξαι|ἐξαλαπάξας|ἐξαλάπαξε
ἐπικτάομαι|ἐπικτᾶσθαι
ἀπαείρω|ἀπαειρόμενον
νεμεσίζομαι|νεμεσιζέσθω|νεμεσίζῃ|νεμεσίζεται|νεμεσίζετο|νεμεσίζομαι|νεμεσίζομ̓
χρεμετίζω|χρεμέτιζον
ἀναμίγνυμι|ἀνέμισγε|ἀμμίξας
ἀνακρεμάννυμι|ἀγκρεμάσασα
φονεύω|φονεύειν
διέχω|διέσχε
ἀντιλαμβάνω|ἀντιλαβεῖν
ἀμφαραβέω|ἀμφαράβησε
ναυπηγέω|ναυπηγηθῆναι|ἐναυπηγοῦντο
πορίζω|ποριζόμενοι|πορισώμεθα
εἰσβιβάζω|ἐσβιβάσαντας
ἀναγκάζω|ἀναγκάσαντες|ἀναγκασθήσεσθαι|ἀναγκάζωνται|ἀναγκάζεται|ἀναγκάσαι|ἀναγκαζομένοις|ἀναγκασθέντας
διείρομαι|διείρεαι|διείρεο
ῥιγέω|ῥίγησέν|ῥίγησεν|ἐρρίγῃσι|ῥίγησ̓|ἐρρίγησαν|ῥίγησε|ἔρριγα|ῥιγήσειν|ἐρρίγει|ἐρρίγησε|ἔρριγ̓
καταχέω|κατέχευε
ἐξοφέλλω|ἐξώφελλεν
ἐνεύδω|ἐνεύδειν|ἐνεῦδεν
συνόμνυμι|ξυνομόσωσιν|ξυνομόσαντες
κρίνω|κρίνωσι|ἔκρινεν|κριθεὶς|κρῖν̓|κεκριμένοι|κεκριμένους|κρινθέντες|κρίνων|κρίνας|κρινάμενος|ἔκριναν|κρίνεσθαι|κρίνειν|κεκριμένη|κρίνονται|κρινόντων|κρῖναι|κεκριμένον|κρίνασθαι|κρίναντος|κρινάσθων|κρινθέντε|κρίνοιμι|κρίνουσι|κρίνῃ|κρινώμεθ̓|ἐκρίνατ̓|κρίνοντες|κρίνηται
διαπράσσω|διαπρήξαιμι|διαπραξάμενοι|διέπρησσον|διαπραξάμενος|διαπρήσσωσι|διαπρήσσουσα
ἀμύσσω|ἄμυσσε|ἀμύξεις
ἐπασκέω|ἐπήσκηται
καταρρέζω|καρρέζουσα|κατέρεξεν|κατέρεξε
ἐπέχω|ἐπεῖχε|ἐπέσχε|ἐπώχατο|ἐπισχών|ἐπισχοίης|ἐπεῖχον|ἐπέχεις|ἔπεχεν|ἐπέσχον
πιμπλάνομαι|πιμπλάνεται
παιφάσσω|παιφάσσουσα
συναλλάσσω|ξυναλλάξαι
λιτανεύω|λιτάνευεν|ἐλλιτάνευσα|λιτάνευε|λιτανεύσομεν|ἐλλιτάνευε
ἐφυβρίζω|ἐφυβρίζων
διείργω|διέεργον
λωβεύω|λωβεύεις|λωβεύω
τετευχῆσθαι|τετευχῆσθαι
δραγμεύω|δραγμεύοντες
ὀιζύω|ὀιζύσας|ὀϊζύομεν|ὀΐζυε|ὀϊζύσας
ἀναβαίνω|ἀναβὰς|ἀνέβαινε|ἀνέβαιν̓|ἀνεβήσετο|ἀμβαίη|ἀναβαίνει|ἀναβαινέμεν|ἀναβᾶσ̓|ἀμβαίνοντες|ἀναβῇ|ἀναβάς|ἀναβαίη|ἀναβάντες|ἀμβαίνωμεν|ἀναβήμεναι|ἀναβησάμενοι|ἀνάβαινε|ἀνέβη|ἀμβαίνειν|ἀναβᾶσα
ἐγκατατίθεμαι|ἐγκάτθετο|ἐγκάτθεο
προσλέγω|προσέλεκτο
παρασκευάζω|παρεσκεύαστο|παρεσκευάζοντο|παρεσκευάσαντο|παρασκευάζειν|παρασκευαζόμεθα|παρεσκευασμένοι|παρασκευάζεσθε|παρασκευασάμενοι|παρεσκευασμένα|παρασκευαζομένους
καταπαύω|καταπαύσειν|καταπαύετε|καταπαύσῃ|καταπαυέμεν|κατέπαυσα|κατέπαυσε|καταπαύσομεν|καταπαυσέμεν
τεχνάομαι|τεχνησάμενος|τεχνήσομαι|τεχνήσατο|τεχνᾶται|τεχνήσαιτο
ἐπιμανθάνω|ἐπιμαθών
λούω|λούεσθαι|λούσειαν|λοῦσαι|λούσῃ|λοεσσάμενός|λοῦσαν|λοῦσέν|λούσατέ|λούσασθαι|λοῦσάν|λοῦσεν|λοῦσον|λό̓|λοέσσας|λελουμένος|λοῦσ̓|λοεσσάμεναι|λοῦσθαι|λοέσσατο|λούσαιτο|λοεσσάμενος|λοεσσαμένω|λούσαντο|λοέσσαι|λούσασα|λόεον|λούσασθε|λοέσσομαι
ἔρομαι|εἴρηται|ἐρώμεθα|εἰρήσομαι|εἰρήσεται|ἐρέεσθαι|εἰρόμεναι|εἴροντο|εἰρομένῳ|εἰρέσθω|εἴρεαι|εἰρόμενος|εἴρεο|εἴρεσθαι|εἰρώμεθα|ἐρέσθαι|εἴρηαι|εἴρετο|εἴρομαι|ἔροιτο|εἰρησόμεθ̓|ἐρέωμαι|ἐρέοντο|εἰρομένῃ
ἀναξηραίνω|ἀγξηράνῃ
στίλβω|στίλβοντας|στίλβων
ἐπικίδνημι|ἐπικίδναται
ἐπαρήγω|ἐπαρήγοις|ἐπαρήγειν|ἐπαρήγει
ἀναρπάζω|ἀνήρπαξαν|ἀναρπάξασα|ἀναρπάξας|ἀνήρπασε|ἀναρπάξασαι
παραμένω|παραμείνωσιν|παρμένετ̓|παρμενέμεν|παραμένων|παρέμεινεν|παραμεῖναι
ἀγγέλλω|ἤγγειλε|ἀγγελλόντων|ἀγγείλειε|ἀγγείλαιμι|ἠγγέλθη|ἀγγελέουσα|ἄγγειλον|ἀγγεῖλαι|ἀγγελέουσι|ἀγγελέοντα|ἀγγελέουσαν|ἀγγέλλων|ἀγγείλας|ἀγγέλλοντες|ἀγγείλωσι|ἤγγειλ̓|ἀγγελέων
ἀάω|ἀάσατο|ἀασθεὶς|ἄασεν|ἀάσθην|ἄασ̓|ἄσατο|ἄασάν|ἀασάμην|ἀάσθη|ἆσέ|ἄασας|ἀᾶται
ἐπιγιγνώσκω|ἐπιγνώωσι|ἐπιγνώῃ|ἐπιγνῷ|ἐπιγνῶναι
ἀπάγω|ἀπάγουσι|ἀπαγάγοι|ἀπάγειν|ἀπήγαγεν|ἀπήγαγε|ἀπαγάγωσι|ἀπήγαγον|ἀπάξειν|ἀπαγαγόντες
κτάομαι|κτᾶσθαι|κτήσασθαι|κεκτῆσθαι|κεκτήμεθα|κτήσωνται|κτησάμενοι|κτῶνται|κεκτημένοι|ἐκτήσω|ἐκέκτηντο|κτάμενον|ἐκτήσατο|κτᾶται
παχνόω|παχνοῦται
στροφαλίζω|στροφαλίζετε
θυόω|τεθυωμένον
ὑφαίνω|ὑφήνω|ὕφαινε|ὑφαίνεσκον|ὑφόωσι|ὑφαίνοις|ὑφαίνῃσιν|ὕφαινον|ὑφήνας|ὕφαινεν|ὑφήνασα|ὕφηνον|ὑφαίνειν|ὑφαίνουσιν|ὑφαίνει|ὑφαίνεσκεν
πρέπω|πρέπει|πρέποντα|ἔπρεπε
ναιετάω|ναιετοώσῃ|ναιετάουσαν|ναιεταόντων|ναιετάοντας|ναιετοώσας|ναιετάουσιν|ναιετάασκε|ναιετάοντα|ναιετάουσι|ναιετάω|ναιετάων|ναιετοώσης|ναιετάασκον
γαίω|γαίων
ἀποίχομαι|ἀποίχεαι|ἀποιχομένου|ἀποίχονται|ἀποίχεται|ἀποιχομένοιο
ἀθροίζω|ἁθροισθέντες
εἰσμαίομαι|ἐσεμάσσατο
περιτροπέω|περιτροπέοντες|περιτροπέων
γεγωνέω|ἐγεγώνευν|γεγώνευν|γεγωνεῖν
ἀμφιδινέομαι|ἀμφιδεδίνηται
μίμνω|μίμνομεν|ἔμιμνεν|μίμνε|μίμνων|μιμνέτω|μίμνειν|μίμνω|μίμνῃ|μίμνει|ἐμίμνομεν|μίμνεις|μίμνετ̓|ἔμιμνον|μίμνον|μίμνεν|μιμνόντεσσι|ἔμιμνε|μίμνετε|μίμνοι|μίμν̓|μίμνουσι
ἐπιάλλω|ἐπίηλεν
εἰσθρῴσκω|ἔσθορε
ὀκνέω|ὄκνεον|ὀκνείω|ὀκνεῖν|ὀκνεῖ|ὀκνῶν
καταγινέω|καταγίνεον
πλωίζω|ἔπλῳζον
ὑπάρχω|ὑπάρχει|ὑπῆρχον|ὑπαρχούσης|ὑπάρξῃ|ὑπαρχόντων|ὑπάρξαντες|ὑπῆρχε|ὑπάρχοντα|ὑπάρχουσαν|ὑπῆρκτο|ὑπάρχον|ὑπάρχουσι|ὑπάρχοντά
βρύω|βρύει
ἐγχέω|ἐγχείῃ|ἐνεχεύατο
ἀπορέω|ἠπόρησε|ἀπορεῖν
γέντο|γέντο
ἀλαπάζω|ἀλάπαζε|ἀλαπάξεις|ἀλάπαξ̓|ἀλαπαζομένην|ἀλάπαξε|ἀλαπάζοντα|ἀλάπαξα|ἀλαπάξαι|ἀλαπάζει
δωρέω|δωρήσαιτ̓
ἀναπίπτω|ἀναπίπτουσιν
ἐπισκευάζω|ἐπισκευάσαντες
ἐπιτάσσω|ἐπέταξάν|ἐπιταχθήσεσθε|ἐπιτασσομένη|ἐπιτάσσοντες
δαιτρεύω|δαίτρευον|δαιτρεῦσαί|δαιτρεύσων|δαιτρεύειν
ἐίσκω|ἐίσκεις|ἐΐσκομεν|ἐΐσκει|ἠΐσκομεν|ἐίσκομεν|εἴσκοντες|ἐΐσκεις|ἤισκε|ἐίσκω|ἐΐσκω
ἀνάσσω|ἀνάσσοι|ἄνασσε|ἀνάσσοντ̓|ἄνασσεν|ἀνάσσονται|ἄνασσες|ἀνάσσοις|ἀνάξασθαι|ἀνάσσειν|ἀνάσσεις|ἀνάξει|ἤνασσε|ἀνασσέμεν|ἀνάξειν|ἀνάξομεν|ἀνάσσει|ἀνάσσων|ἀνάσσω
εἴρω|εἴρω|εἴρηται|ἔερτο|εἴρωμαι|εἴρεσθ̓|ἐερμένον
ἐπιπέλομαι|ἐπιπλόμενον
κλάω|κλάσε|ἐκλάσθη
εἰσβάλλω|ἐσβαλόντας|ἐσβαλεῖν|ἐσβαλόντες|ἐσβεβληκότων|ἐσβάλλειν|ἐσβάλλει
προαγορεύω|προαγορευόντων|προαγορεύουσιν|προαγορεύειν
ἑρπύζω|ἑρπύζοντ̓|ἑρπύζων
εἰσνοέω|εἰσενόησα|εἰσενόησεν
ἐπιρρέπω|ἐπιρρέπῃ
ἀλογέω|ἀλογήσει|ἀλογήσεις
ὑποθωρήσσομαι|ὑπεθωρήσσοντο
ἐπαμάω|ἐπαμήσατο
ἀπεκλανθάνομαι|ἀπεκλελάθεσθε
ἀτάλλω|ἄταλλε
παρίσχω|παρίσχομεν|παρισχέμεν
συνοικοδομέω|ξυνῳκοδομημένοι
διαλύω|διαλύεσθαι|διαλύσειν
ἀμαλδύνω|ἀμαλδύνηται|ἀμαλδύνας|ἀμαλδῦναι
πάσσω|πάσσε|ἔπασσε|πάσσων|πάσσειν|πάσαντο
νομεύω|νομεύων|ἐνόμευε
μεταπέμπω|μετεπέμποντο|μεταπεμφθεὶς|μεταπέμποντος
ἐγγράφω|ἐνεγέγραπτο|ἐγγεγραμμένον
παρατυγχάνω|παρατυχὸν|παρετύγχανε|παρατυγχάνον|παρατυχόντος
ἐνίημι|ἐνῆκας|ἐνῆκε|ἐνήσομεν|ἐνεικέμεν|ἐνεῖσα|ἐνίησι|ἐνίετε|ἐνῆκεν|ἐνήσει|ἐνήσεις|ἐνέηκε|ἐνήκαμεν
ἀδικέω|ἀδικοῦντα|ἠδικῆσθαι|ἀδικοῦμεν|ἀδικεῖσθαι|ἀδικεῖν|ἀδικούμεθα|ἀδικοῦσιν|ἀδικοῦντας|ἀδικησάντων|ἀδικοῖεν|ἀδικῶσι|ἀδικεῖτε|ἠδίκουν|ἠδικήμεθα|ἀδικούμενοι|ἀδικουμένοις|ἀδικουμένη|ἀδικοῖντο|ἀδικῶνται|ἀδικούμενοί|ἠδικημέναις|ἀδικοῦσι|ἀδικουμένους
ἐκδέχομαι|ἐξεδέχοντο
ἐρευνάω|ἐρευνῶντες|ἐρεύνα|ἐρευνῶν
προσβοηθέω|προσεβοήθησαν|προσεβεβοηθήκει
σεβάζομαι|σεβάσσατο
ἐπικεύθω|ἐπικεύσῃς|ἐπίκευθε|ἐπικεύσω
ἐπαμείβω|ἐπαμείψομεν|ἐπαμείβεται
ἐξαγγέλλω|ἐξήγγειλεν
ἐλαστρέω|ἐλάστρεον
λιπάω|λιποῦσα|λίποιμεν|λιπεῖν
μετατάσσω|μετατάξασθαι
ἀποστερέω|ἀποστερῆσαι|ἀποστερῶν|ἀποστεροῦντες
ἐπιμίγνυμι|ἐπιμισγόντων|ἐπεμείγνυντο|ἐπιμειγνύντες
ῥοιβδέω|ῥοιβδήσειεν
ἐξαφαιρέω|ἐξαφέλησθε
ἐξαιρέω|ἔξελον|ἐξέλετο|ἐξείλοντο|ἐξέλεθ̓|ἐξέλετ̓|ἐξαιρεύμην|ἐξελόμην|ἔξελε|ἐξείλετο
βέομαι|βέῃ|βείομαι|βέομαι
ἄγαμαι|ἀγάασθε|ἀγασσάμενοι|ἀγάσσεσθαι|ἄγαμαι|ἀγάσησθε|ἀγάασθαι|ἀγάσασθαι|ἠγάσσατο|ἀγασσάμενος|ἠγάασθε|ἄγαμαί|ἀγάσσατο|ἀγασσάμεθ̓|ἀγάσαντο|ἄγασθε
ἐκνικάω|ἐκνενικηκότα|ἐκνικῆσαι
γιγνώσκω|γνώωσι|γνῶσιν|γιγνώσκεις|γνώῃ|γνοὺς|γιγνώσκουσα|γνῶ|γνώσῃ|γνώῃς|γνῶμεν|ἔγνω|γνώσεαι|γιγνώσκειν|γνώτω|γνῶναι|γνώσεσθε|γνώω|γιγνώσκων|γνώτην|ἔγνως|γίγνωσκον|γνῷ|γνῷς|γνοίη|γνοίης|γνόντες|γνοίην|γίγνωσκε|γιγνώσκω|γνωσόμεθ̓|γνωσθέντες|γνῶτε|γνώμεναι|ἔγνωσαν|γνωσθησόμεθα|γνωσθέντα|γνοῖεν|γιγνώσκοντες|γιγνώσκετε|γνώσετ̓|γνώομεν|γνῶτον|γιγνώσκῃς|γνώσεται|ἔγνων
ἐν-ἀντιόομαι|ἐναντιουμένοις
τέθηπα|τεθηπότες|τέθηπά|ταφὼν|τεθηπότας|τεθηπὼς|ταφών|τέθηπεν|ἐτεθήπεα
ποικίλλω|ποίκιλλε
προιάλλω|προΐαλλεν|προΐαλλε
ἄζω|ἀζομένη
παραδείκνυμι|παρεδέξατο
ἀποσπένδω|ἀποσπένδων
ἀναβοάω|ἀνεβόησεν
ἀμφιάχω|ἀμφιαχυῖαν
ἀγινέω|ἠγίνεον|ἀγινεῖ|ἀγινέμεναί|ἀγίνεον|ἀγινεῖς|ἀγίνεσκον
κατασβέννυμι|κατέσβεσε
μεταδαίνυμαι|μεταδαίσομαι|μεταδαίνυται|μεταδαίσεται
βρομέω|βρομέωσι
ἐπαπειλέω|ἐπηπείλησεν|ἐπαπειλήσας|ἐπηπείλησ̓|ἐπηπείλησε
ἐπιτρέπω|ἐπιτρέψομεν|ἐπιτρέψαντες|ἐπιτρέψειας|ἐπετράπομέν|ἐπέτρεψε|ἐπέτρεπεν|ἐπιτρέψειεν|ἐπιτράπεθ̓|ἐπιτρέψαι|ἐπιτραπέουσι|ἐπέτρεψας|ἐπιτρέψαντος|ἐπίτρεψον|ἐπέτρεπε|ἐπετράπετο|ἐπιτετραμμένοι|ἐπιτρέπειν|ἐπιτετράφαται|ἐπιτρέψοντες|ἐπιτέτραπται|ἐπέτρεψεν
ὑπερείπω|ὑπήριπε
νεικέω|νείκεσ̓|νεικεῖ|νεικείων|νεικείειν|νείκεσσ̓|νείκεσσεν|νεικείω|νεικείεσκε|νεικέοι|νεικεῖν|νεικέσω|νεικείῃσι|νείκεσσε|νεικεῦσ̓|ἐνείκεσας|νείκεσε|νεικείεσκον|νείκει|νεικείῃ|ἐνείκεον|νείκεσέ|νείκεον|νείκεε|νείκειον|νείκεσεν
περιαγγέλλω|περιαγγέλλουσαι
ἅλλομαι|ἆλτ̓|ἆλσο|ἅλεται|ἅληται|ἆλτο
πτωσκάζω|πτωσκαζέμεν
παραγγέλλω|παραγγελλόμενα|παραγγέλλῃ
ἐπεῖπον|ἐπεῖπον
ἑδριάω|ἑδριόωντο|ἑδριάασθαι
κατακαίω|κατέκηε|κατακήομεν|κατακαιέμεν|κακκῆαι|κατακῆαι|κατέκαιον
πλανάω|πλανόωνται
κλίνω|κλινάμενος|κεκλιμένον|κλίνθη|κεκλιμένων|κέκλιτο|κεκλιμένος|κλῖνε|κλίναντες|κλίνῃσι|ἐκλίνθη|κεκλίαται|ἔκλιν̓|κλίνασα|ἐκέκλιτο|κλινθήτην|κεκλιμένη|ἐκλίθη|κλινθῆναι|κλίνας|κλιθῆναι|κλῖναν|κλίνων|ἔκλινε|κεκλιμένοι|ἔκλιναν
ἐφοπλίζω|ἐφοπλίσσαι|ἐφοπλίσσαντες|ἐφοπλίσσειας|ἐφοπλίσαι|ἐφοπλισόμεσθα|ἐφοπλίσσαιτε|ἐφοπλίζωμεν|ἐφοπλίσσωσι|ἐφοπλίσσουσιν
ὀλισθάνω|ὄλισθε|ὄλισθεν
ῥύσκομαι|ῥύσκευ
μοχθέω|μοχθήσειν
ὑποσταχύομαι|ὑποσταχύοιτο
χαρίζομαι|κεχαρισμένος|κεχαρισμένα|χαρίσαιτο|κεχάριστο|χαριζομένη|κεχαρισμένε|χαρίζεο|χαρίζετο|χαρίζεαι|χαριζόμενος|χαρίσασθαι|χαρίζεσθαι
φθονέω|φθονέοιμι|φθονέω|φθονέεις|φθονέειν|φθονέουσ̓
ἐπινέω|ἐπένησε
εὐφημέω|εὐφημῆσαί
διωθέω|διῶσεν
θέλγω|θέλξει|θέλγοιτό|θέλγει|ἔθελχθεν|ἔθελγεν|θέλξας|θέλγουσιν|ἔθελγε|θέλξαι|ἐθέλχθης|θέλγε|ἔθελξε|θέλγεσκ̓
ἐργαθεῖν|ἔργαθεν|ἐέργαθεν
μετάφημι|μετέφη
λαμπετάω|λαμπετόωντι
ἀμφιπίπτω|ἀμφιπεσοῦσα
κίδναμαι|ἐκίδνατο|κίδναται
σκύζομαι|σκυζομένης|σκυζομένῳ|σκυζομένη|σκύζεσθαι|σκύζεσθαί|σκύζευ
προσποιέω|προσεποιήσαντο|προσποιήσειαν|προσεποιήσατο|προσεποιεῖτο|προσεποιοῦντο
προερύω|προέρυσσεν|προέρυσσαν|προερύσσω
ἐκθρῴσκω|ἐξέθορε|ἔκθορε|ἐκθρῴσκει
τρυπάω|τρυπῷ
παράκειμαι|παρεκέσκετ̓|παράκειται|παρέκειτο
πολίζω|πεπόλιστο|πολίσσαμεν
ἀπίσχω|ἄπισχε
μεταίζω|μετεισάμενος|μεταΐζειν
δέω|δησάσκετο|δεηθέντες|δησάντων|δεδεμένοι|δεομένοις|δεήσει|δέδεντο|δῆσε|δησάμενοι|ἐδήσατο|δήσας|ἐδεήθησαν|δέῃ|δησάμενος|δῆσα|δέδετ̓|ἔδει|ἔδησαν|δέοιμι|ἐδεύετο|δήσαντες|δεόμενοι|δέον|δήσειν|ἐδέοντό|ἔδησε|δῆσαι|δέοντο|δεηθέντων|δῆσεν|ἔδησεν|δέονται|δεύῃ|δήσαντας|δησαίμην|δεησομένους|δευόμενος|δεησόμενοι|δέδετο|δεῖσθαι|δήσατ̓|δευομένους|δῆσαν
δενδροτομέω|δενδροτομήσαντες
διαφράζω|διεπέφραδε
ἀριθμέω|ἀριθμηθήμεναι|ἠρίθμει|ἠρίθμεον|ἀριθμήσει|ἀριθμήσας|ἀριθμήσω
ἀναγγέλλω|ἀναγγελοῦσι
δυάω|δυόωσι
κέλλω|κελσάσῃσι|κέλσαι|ἐκέλσαμεν
διόλλυμι|διόλωλε
δακρύω|δακρύσαντας|δάκρυσα|δακρύσασα|δεδάκρυσαι|δακρύσας|δεδάκρυνται
ἔλδομαι|ἐέλδεαι|ἐέλδεται|ἐελδομένοισι|ἔλδεται|ἐελδομένῳ|ἐελδόμενός|ἐελδομένοισιν|ἐελδόμενος|ἐλδόμεναι|ἔλδεαι|ἐελδέσθω|ἐέλδετο|ἐέλδομαι
ἀκοστάω|ἀκοστήσας
θεμόω|θέμωσε
ἐπιέννυμι|ἐπιειμένος|ἐπιειμένοι|ἐφέσσεσθαι|ἐπιειμένον|ἔφεσσαι|ἐπιειμένε
ἄρνυμαι|ἀρνύμενοι|ἀρνύμενος|ἀρνύσθην|ἀρνυμένω
ἐγκαλέω|ἐνεκάλουν
ἐπιγράφω|ἐπιγράψασθαι|ἐπέγραψαν|ἐπέγραψε|ἐπιγράψαι|ἐπέγραψεν|ἐπιγράψας
τρέχω|ἔδραμε|ἔδραμ̓|θρέξασκον|δράμεν|ἔδραμον|τρέχει|δραμέτην
ἐπιφράζω|ἐπεφράσω|ἐπιφράσσετ̓|ἐπιφρασσαίμεθα|ἐπεφράσατ̓|ἐπιφρασσαίατο|ἐπιφρασσαίατ̓|ἐπεφράσθης
ὀψείω|ὀψείοντες
ὁρμάζω|ὁρμώμενος
διίημι|δίηται|διέσθαι
ῥέζω|ῥέζειν|ῥέζων|ῥέζουσ̓|ἔρεξας|ῥέζουσιν|ῥεχθέντος|ῥέξαι|ῥέξαντες|ῥέζετε|ῥέξω|ῥέξ̓|ῥέζουσι|ῥέξειν|ῥέξει|ῥέζει|ἔρεξε|ῥέζω|ῥέξαιμι|ῥέξαντα|ῥέζουσαν|ῥέζεσκον|ἐρέξαμεν|ῥεχθὲν|ῥέξαντι|ἔρεξαν|ἔρρεξεν|ἔρεζε|ἔρεξεν|ῥέξας|ῥέξειε|ῥέξομεν|ἔρεξ̓|ῥέξῃς|ἔρεξα|ῥέξαντας|ῥέξῃ|ῥέζεις|ἔρρεξε|ῥέζον|ἔρεζον|ῥέζε|ῥέζοι|ῥέξωσι
ἰάλλω|ἰάλλοντα|ἴαλλε|ἰάλλειν|ἴαλλεν|ἴηλεν|ἰῆλαι|ἴαλλον|ἴηλον|ἰήλω|ἴηλα
τελέω|τελέσειεν|τετέλεστο|τελέσαιμεν|τελέσειας|τελέσαι|τελέσεἰ|τελείει|τελεῖ|τελέοντες|τελέεσθαι|ἐτελείετο|τελέσσαι|τελέσθη|τελέουσι|τελέει|ἐτέλεσσαν|τελέουσιν|ἐτέλεσσα|τελέω|τελέσσῃς|τετελεσμένος|τελέσσῃ|τέλεσόν|ἐτέλεσσε|τελέσωσι|τετέλεσται|τελέσσω|τελέσῃ|τέλεσσαν|τελέσειε|τελέσαιμι|τελεῖσθαι|τελεῖται|τελέωμεν|τελέοιεν|τέλεον|ἐτέλειον|ἐτέλεσσεν|τετελεσμένον|τέλεσ̓|ἐτελέσθη|τετελεσμένα|τελέσω|τελείεται|ἐτέλεσσας
ἀναφέρω|ἀνένεικα|ἀνενείκατο
ἀφήκω|ἀφῆκ̓
χράω|χρήσασθε|χρώμενοι|κεχρημένῳ|χρῆσθε|ἐχρήσαντο|χρώμενα|ἔχρησε|χρήσεσθαι|ἔχραε|χρησάμενοι|χρείων|χρησαμένου|κεχρημένος|χρησόμενον|χρήσαντος|κεχρημένον|χρησομένους|ἐχράετ̓|κέχρητ̓|κεχρημένοι|χρησόμενος|χρωμένῳ|χρησαμένης
ἀπαλθαίνομαι|ἀπαλθήσεσθον
μονόω|μονωθεὶς|μουνωθέντα|μούνωσε
λογίζομαι|λογιζόμενοι
καταπέσσω|καταπέψῃ
ἰσχανάω|ἰσχανάᾳ|ἰσχανόωσιν|ἰσχαναάσθω|ἰσχανόωνται|ἰσχανάασκον|ἰσχανόων|ἰσχανόωσαν|ἰσχανάᾳς|ἰσχανόωντο
στείχω|στείχειν|στείχοντα|στείχων|ἔστειχε|στείχῃσι|ἔστιχον|στεῖχον|στείχῃσ̓|στείχοντες
ἐπιδέω|ἐπιδεύομαι|ἐπιδεύεαι|ἐπέδησε
ἐκλανθάνω|ἐκλάθετο|ἐξελάθοντο|ἐκλέλαθον|ἐκλελαθέσθαι|ἐκλελάθοιτο|ἐκλελάθωντ̓
συλλέγω|συλλέξατο|συλλέξας|συλλέξομαι
ἀγαπάω|ἀγαπᾷς|ἀγάπησα
χάζω|χάζεσθε|χάζετ̓|χάζεο|ἐχάζετο|κεκάδοντο|χαζώμεσθα|χαζώμεθ̓|χάζετο|κεκαδὼν|χασσάμενος|χάσσασθαι|χάσσατ̓|χάσσονται|χάζονθ̓|χάζεσθαι|κεκαδήσει|χάζοντο
ἐλπίζω|ἐλπίσας|ἐλπίσαντες|ἐλπίζουσιν|ἤλπιζον
πέσσω|πέσσῃ|πέσσων|πεσσέμεν|πέσσει|πέσσω
δαρθάνω|ἔδραθ̓
ἐκλογίζομαι|ἐκλογίζοιτο|ἐκλογίσασθαι
ταράσσω|τετρήχει|τετρηχυῖα|ταράξῃ|ἐτάραξε
παράγω|παράγεσθαι
ἐπιπάρειμι|ἐπιπαριόντας
ἐπαμύνω|ἐπαμῦναι|ἐπαμυνέμεν|ἐπάμυνον|ἐπάμυνε|ἐπαμύνω|ἐπαμυνεῖτε|ἐπαμύνομεν|ἐπαμύνειν
ῥαίω|ἔρραιε|ῥαῖσαι|ῥαίσῃ|ῥαιομένου|ῥαίοιτο|ῥαίῃσι|ῥαισέμεναι|ἐρραίσθη
κατοικέω|κατῳκημένους
ἀμφιχέω|ἀμφιχυθεὶς|ἀμφιχυθῆναι|ἀμφιχυθείς|ἀμφεχέοντο|ἀμφέχυτ̓|ἀμφεχύθη
ἐξαναλύω|ἐξαναλῦσαι
ἐνδύω|ἐνδυόμενος|ἐνδῦσα|ἔνδυνε
μύρω|μυρομένη|μυρομένους|μυρόμενόν|μυρομένοισι|μυρομένοισιν|μύρονθ̓|μυρόμενοι|μύρονται|μυρομένω
ἀίσσω|ἤϊξεν|ἀΐσσων|ἀίξαντε|ἀΐσσοντε|ἀίσσουσιν|ἠΐχθησαν|ἀΐσσονται|ἀΐξασθαι|ἀίξασα|ἀΐσσουσα|ἀΐξῃ|ἀϊχθήτην|ἀΐξαντε|ἀΐσσοντος|ἀϊχθῆναι|ἤϊξαν|ἀίσσοντα|ἤϊξε|ἀΐξασαι|ἀΐξασα|ἀΐξας|ἀΐξωσι|ἀΐξαντα|ἤιξαν|ἠΐχθη|ἀΐξασκε|ἀΐσσουσι|ἤϊσσον
σμαραγέω|σμαραγεῖ|σμαραγήσῃ
φλέγω|φλέγετο|φλέγει
ἀλύσκω|ἀλύξῃς|ἤλυξαν|ἀλύξας|ἀλύξαι|ἤλυξα|ἀλύξει|ἀλύξειν|ἀλύξῃ|ἀλύσκανε|ἀλύσκων|ἤλυξε|ἀλύξαιμεν
συμβουλεύω|ξυνεβούλευε
ἐθέλω|ἐθέλει|ἐθέλεσκον|ἐθελούσῃ|ἐθέλοντ̓|ἐθέλωσιν|ἐθέλεσκε|ἐθέλωμι|ἐθέλοιεν|ἐθέλω|ἐθελήσεις|ἐθέλῃσ̓|ἐθέλεσκες|ἐθέλοιτέ|ἐθέλῃσιν|ἐθελησάντων|ἐθελήσω|ἐθέλητον|ἐθέλουσά|ἐθελήσετον|ἐθελῆσαι|ἐθέλωσ̓|ἔθελ̓|ἐθέλοιμι|ἐθέλῃσθα|ἔθελον|ἐθέλουσα|ἐθέλοντα|ἐθέλουσι|ἐθέλων|ἐθέλῃς|ἐθέλῃσι|ἐθέλοντά|ἐθέλοντας|ἐθέλοιμεν|ἠθελέτην|ἔθελεν|ἠθέλετον|ἤθελον|ἐθέλομεν|ἐθέλοις|ἐθέλουσιν|ἐθέλοι|ἤθελεν|ἐθέλουσ̓|ἐθέλοντες|ἤθελε|ἐθελούσης|ἔθελόν|ἐθέλησε|ἐθελήσει|ἐθέλῃ|ἐθέλησα|ἐθέλεις|ἐθέλητε|ἔθελε|ἐθέλωσι|ἐθέλουσαν|ἤθελ̓
ἐπιβρέμω|ἐπιβρέμει
ἀνέζομαι|ἀνέσει
προεέργω|προέεργε
οἰδέω|ᾤδεε
συμπλέω|ξυμπλεῖν|ξυνέπλεον
πέκω|πεξαμένη|πείκετε
ἀπείργω|ἀπέεργεν|ἀποέργει
ἰάομαι|ἰᾶτ̓|ἰήσατο|ἰησάμενοι|ἰήσεται|ἰήσασθαι
παρασημαίνομαι|παρασημηνάμενος
μελάνω|μελάνει
ἀποτελέω|ἀπετέλεσαν
παρέρχομαι|παρέλθῃ|παρερχομένην|παρήλθομεν|παρεληλυθώς|παρέρχεται|παρῆλθε|παρελθόντες|παρελθὼν|παρελθέμεν|παρελεύσεαι|παρέλθοι
μάρναμαι|μαρναμένοιϊν|μάρναται|μάρνασθαι|ἐμαρνάσθην|μάρναό|μαρναμένων|μαρναμένοισιν|μαρναίμεθα|μαρναμένοισι|μάρναθ̓|μάρναο|ἐμαρνάμεθ̓|μαρνάμενος|μαρναμένοιιν|μαρναμένοιο|ἐμάρνατο|μαρνάμενοι|μαρναμένους|μάρνατο|μαρνάμενον|μαρνάμεθ̓|μάρνασθ̓|ἐμάρναο|μάρναντο
τελευτάω|τελευτηθῆναι|τελευτήσουσιν|τελευτήσω|τελευτήσειας|ἐτελεύτα|τελεύτησέν|τελεύτησάν|τελευτήσεσθαι|τελευτήσει|τελευτήσῃς|τελευτήσας|τελευτήσειεν|ἐτελεύτησεν|τελευτήσεις|τελευτήσειν|τελευτᾷ|τελεύτα|τελευτῆσαι
σκαίρω|σκαίροντες|σκαίρουσιν
καταλύω|καταλύσομεν|κατέλυσε|καταλῦσαι|καταλύοντες|κατελύθησαν|καταλύειν|καταλύεσθαι
ἐπιχρίω|ἐπιχρίεσθαι|ἐπιχρίοντες|ἐπιχρίσασα
μίγνυμι|ἐμίγης|μέμικτο|ἐμίγην|μίκτο|μιγείης|μισγέσκετο|μιγεῖσα|μίσγεσθαι|ἐμίχθη|ἐμισγέσθην|μίξεσθαι|ἐμίσγετο|μιγῆναι|μεμιγμένοι|μιγέντα|μίσγηται|ἔμικτο|μιγήσεσθαι|μῖξαι|μιχθεὶς|μίσγεται|ἐμισγόμεθ̓|ἔμιξαν|μίσγεαι|μεμιγμένη|μιγείη|μίγησαν|μισγομένων|μιχθήμεναι|μεμιγμένα|μίγη|μιγήῃς|μίγεν|μιγέωσιν|ἔμισγον|μιγέντε|ἔμιχθεν|μίσγοντό|μίσγεσθ̓|μίσγετο|μιγείην|μίχθη|μισγέμεναι|ἐμίγη|μιγήμεναι|μεμιγμένον|μίσγον
τέρπω|τεταρπώμεσθα|τερπόμενοι|τερπομένοισιν|τερπόμεθ̓|τέρπεσθε|ταρπώμεθα|τερπόμενον|τάρφθη|τερπομένοισι|τέρπομ̓|ἔτερπον|τερψάμενος|τέρπεο|τάρπημεν|τερφθείη|τέρποντ̓|τέρπομαι|ἐτέρπετο|τεταρπόμενοι|τέρπετε|τέρπῃσιν|τεταρπόμενός|τέρπεσθον|ἐταρπήτην|τέρποντες|τέρπειν|τεταρπόμενος|ἐτέρπετ̓|τερπόμενος|τερπομένω|τάρπησαν|τέρπεαι|ταρπῆναι|τραπείομεν|τερπομένη|τερπόμενόν|ἔτερπε|τάρφθεν|ταρπήμεναι|τέρποντο|τέρπεσθαι|τέρπετο|τέρπετ̓|ἐτέρφθητε|ἔτερπεν|τέρποιτο|τέρπονται|τερπέσθω|τερπώμεθα|ἐτέρφθησαν|τέρπεται|τετάρπετο|τέρπηται|τέρψομαι|τερπέσθην
ἐπαιτέω|ἐπαιτήσειας
ἐκπλέω|ἐκπλέοντας|ἐκπλεῦσαι|ἐκπλεύσας
δέρκομαι|δερκομένοισι|δέδορκεν|δερκομένοιο|δερκομένη|δερκομένω|ἔδρακον|δερκομένῳ|δερκέσκετο|δέρκεσθαι|δεδορκώς|δερκόμενοι
ἀναίνομαι|ἀναίνομαι|ἠναίνετο|ἀνήνηται|ἀνήνασθαι|ἀναίνετο|ἀνήνατο|ἀναίνεται|ἀναίνεαι
ὑπερβάλλω|ὑπέρβαλε|ὑπειρέβαλον|ὑπερβαλέειν
προδιαγιγνώσκω|προδιάγνωτε
κυρέω|κῦρε|κύρεται|κύρσας
κατεσθίω|κατήσθιε|κατεσθίει|κατέδονται
ἐξαπονίζω|ἐξαπένιζεν
βράσσω|ἔβραχε
ἐναντιόομαι|ἠναντιοῦτο|ἐναντιωθῆναι
ἐπινοέω|ἐπινοήσωσι|ἐπινοῆσαι|ἐπινοήσαντες
ἀποκινέω|ἀποκινήσασκε|ἀποκινήσωσι
ποτάομαι|ποτῶνται|πεπότηται|ποτέονται|πεποτήαται
ἕρπω|ἕρπων|ἕρπει|εἷρπον
ἐπιδινέω|ἐπιδινηθέντε|ἐπιδινεῖται|ἐπιδινήσας
κυβιστάω|κυβιστᾷ|κυβίστων
παραυδάω|παραύδα|παραυδῶν|παραυδήσας
ἐκτανύω|ἐξετάνυσσ̓|ἐξετανύσθη|ἐκτανύσας
ἐπικεράννυμι|ἐπικρῆσαι
καταδαρθάνω|κατέδραθον|καταδράθω|καδδραθέτην
ἐφορμέω|ἐφορμούσαις
ὑποκρύπτω|ὑπεκρύφθη
κοσμέω|κόσμησε|κοσμησάμενος|κοσμῆσαι|κόσμησεν|ἐκόσμει|κόσμηθεν|κοσμοῦντες|κοσμηθέντες|ἐκόσμεον
χολάω|χολοῦμαι
συνέρχομαι|ξυνελθόντες|ξυνήλθομεν
ἀνοικοδομέω|ἀνοικοδομεῖν
κλονέω|κλονέωσι|κλονέοντε|κλονέεσθαι|κλονέει|κλονέοντο|κλονέων|κλονέονται|κλονέοντα|κλονέοντας
διατρέχω|διέδραμον|διαδράμοι
ὑπαντιάζω|ὑπαντιάσας
τιτρώσκω|τρώσῃς|τρώσεσθαι|τρώει|τρώσητε
περιστεναχίζω|περιστεναχίζεται
κοιμάω|κοιμήσασθε|κοιμήθημεν|κοιμηθείη|κοιμήσασα|κοιμηθῆναι|κοιμᾶται|κοιμηθέντε|κοιμήσατο|κοίμησόν|κοιμήσωνται|κοίμησε|κοιμήσαντο|κοιμηθέντες|κοιμᾶθ̓|κοιμήσας|κοιμηθέντι|κοιμήσατε|κοιμᾶτ̓|κοιμῶντο|κοιμήσαντ̓|κοίμησον
ἐπιμειδάω|ἐπιμειδήσας
ὕπειμι|ὑπῆσαν|ὑπέασι
βρίζω|βρίζοντα
πέλω|πέληται|πέλε|πελέσκεο|ἔπλεθ̓|πέλοιτο|πέλεν|πέλευ|πελώμεθ̓|ἔπλετ̓|πέλοντο|πέλει|ἔπλετο|ἔπλεν|πέλωνται|ἔπλευ|πέλεται|πέλονται|ἔπλεο
οὔλω|οὖλέ
ὄρομαι|ὄροιτο|ὄροντο|ὄρονται
αὔω|ἄυσαν|ἤϋσεν|ἄϋσε|ἀῦσαι|ἀϋσάντων|ἀΰσαντες|ἀΰσας|αὔοι|ἄϋσεν|ἤϋσ̓|ἤϋσε|αὖε
ἐπιλεύσσω|ἐπιλεύσσει
ἀναθρῴσκω|ἀναθρῴσκων
ὄμνυμι|ὤμοσα|ὄμνυε|ὀμεῖται|ὄμοσέν|ὤμνυε|ὤμοσε|ὄμοσσον|ὄμοσεν|ὀμόσαι|ὄμοσσεν|ὀμνυέτω|ὠμόσσαμεν|ὄμοσον|ὀμόσαιμι|ὀμόσσατε|ὀμόσας|ὄμοσάν|ὀμόσσαι|ὀμόσσῃ|ὀμόσσας|ὀμοῦμαι|ὄμνυθι
ἐλύω|ἔλυσαν|ἐλυσθείς|ἔλυσεν|ἐλυσθεὶς|ἐλύσθη
ἐξοίχομαι|ἐξοίχεται
κεντέω|κένσαι
ἀπορρίπτω|ἀπορρίψαντα|ἀπορρῖψαι
δέχομαι|δέγμενοι|δείδεκτ̓|ἐδέχοντο|δέκτο|δεχομένοις|δειδέχατ̓|δέξασθαι|ἐδέξαντο|ἔδεκτο|δέχομαι|δεχέσθω|δέχοισθε|δέχεσθε|δεξάμενος|δέχονται|δέγμενος|δεδεγμένος|δεξαμένων|δέχθαι|δεδέξομαι|δεξαμένοις|δέχεσθαι|δέξαι|δεδεγμένα|δέξο|δεξαμένη|δέξεται|δέξαιτο|δεχόμενοι|δεχοίμην|δέξατο|ἐδέγμην|δέχεται|δέχαται|δειδέχαται|δεδεγμένοι|δεχώμεθα|δεξάμενοι|δεξαμένου|ἐδεξάμεθα|δέξομαι|δέξασθ̓|δέξατό|ἐδέξατο|δέδεξο|ἐδέξαντό
ἀποδέχομαι|ἀπεδέξαντο|ἀπεδέξατ̓
ἀπεμέω|ἀπέμεσσεν
σβέννυμι|σβέσαν|ἔσβεσεν|σβέσσαι|σβέσατ̓|ἔσβη
μηρύομαι|μηρύσαντο
ἐπιμίμνω|ἐπιμίμνω
ἐπιστρέφω|ἐπιστρέψας
εἰσδέρκομαι|ἐσέδρακον|ἐσέδρακεν
παροίχομαι|παρῴχετο|παροίχωκεν
τερσαίνω|τέρσηνε
καπνίζω|κάπνισσάν
σκιάω|σκιόωντό
ἐπιλείβω|ἐπέλειβον
ξύω|ξῦον|ἔξυσ̓
καθικνέομαι|καθίκεο|καθίκετο
προεπιβουλεύω|προεπιβουλεύειν
κατερείπω|κατήριπε|κατερήριπεν
ἀρτύω|ἤρτυε|ἀρτύει|ἤρτυεν|ἤρτυον
προτερέω|προτερῆσαι
ὑπεράλλομαι|ὑπεράλμενον|ὑπερᾶλτο
ἀντικαθίστημι|ἀντικαθίσταντο|ἀντικαθεστηκυίας
ἀπαναίνομαι|ἀπανήνασθαι|ἀπηνήναντο
καταστόρνυμι|καστορνῦσα
πομπεύω|πόμπευον
προτρέπω|προτραποίμην|προτράπηται|προτραπέσθαι|προτρέποντο
ἀπολείπω|ἀπολείπει|ἀπολείπουσιν|ἀπολιπόντες|ἀπέλειπεν
σκάλλω|σκήλεἰ
συνεέργω|συνεέργαθον
βασιλεύω|βασίλευεν|βασιλεύοντα|βασίλευε|βασιλεύοντος|βασιλεύσομεν|βασιλευέμεν|βασιλεύσει|βασιλεύοι|ἐβασίλευσε|βασιλευέτω
μετατρέπομαι|μετατρέπομ̓|μετατρέπῃ|μετατρέπεται
περιμηχανάομαι|περιμηχανόωνται|περιμηχανόωντο
χρῄζω|χρηίζοντι|χρηΐζοντα|χρηΐζεις|χρηΐζων
ἀνάπτω|ἀνῆψεν|ἀνάψαι|ἀνῆπτον|ἀνήφθω
παρευνάζομαι|παρευνάζεσθε
βιβάσθω|βιβάσθων
φανάω|ἐφάνησαν|φανῆναι
ἐπιβάλλω|ἐπέβαλλεν|ἐπέβαλλον|ἐπιβαλλόμενος
προερέσσω|προέρεσσαν|προερέσσαμεν
κατορύσσω|κατορύξαι
ἀπομυθέομαι|ἀπεμυθεόμην
ἐπικλίνω|ἐπικεκλιμένας
στιχάομαι|ἐστιχόωντο
ἐπαλαστέω|ἐπαλαστήσασα
περισείομαι|περισσείοντο
ἀλαστέω|ἠλάστεον|ἀλαστήσας
πέρθω|πέρσε|ἔπραθον|πέρσειαν|πέρθαι|πέρσεν|πέρσειν|πέρθετο|περθομένη|πέρσας|πέρθοντε|πέρσα|ἔπερσεν|πέρσαντες|πέρσεται
ὑδραίνω|ὑδρηναμένη
ὑπερέχω|ὑπείρεχεν|ὑπείρεχε|ὑπερέσχε|ὑπείρεχον|ὑπερέσχεθε|ὑπέρσχῃ
ἐκκλέπτω|ἐξέκλεψεν|ἐκκλέψαντες
στείβω|στείβοντες|στεῖβον
λίσσομαι|λισσομένη|λισσόμενοι|λίσσεο|λίσσοιτ̓|λίσσετ̓|λίσσονθ̓|λίσσεαι|λιτοίμην|ἐλίσσετο|λίσῃ|λισσομένους|λισσόμενος|ἐλλισάμην|ἐλλίσσονθ̓|λίσσομαι|λίσσεσθ̓|λίσσωμ̓|λίσσομ̓|λίσσεσθαι|λίσσεται|λίσαι|λίσσοιτο|λιτέσθαι|λίσσωμαι|λισσομένω|λίσσεθ̓|ἐλλίσσεθ̓|λίσσοντο|λισσομένῳ|λισσέσκετο|λίσσηαι|ἐλλίσσετο|λίσσοντ̓|λίσσετο|λίσσονται
ἀμφιπεριστέφομαι|ἀμφιπεριστέφεται
ἀποκείρω|ἀπεκείρατο
ἐκδίδωμι|ἔκδοτε|ἐκδοίη|ἐκδίδωσιν|ἐξέδοσαν
ῥιζόω|ἐρρίζωται|ἐρρίζωσεν
ἐπίσχω|ἐπισχόμενος|ἐπισχέτω|ἐπίσχειν|ἐπισχεῖν|ἐπίσχετε
ἑτοιμάζω|ἑτοιμάσαιντο|ἑτοιμάσατ̓|ἑτοιμάσσαντο|ἑτοιμασάτω|ἑτοιμασσαίατ̓
ὁμαδέω|ὁμάδησαν
διπλασιόομαι|διπλασιουμένην
σκιάζω|σκιάσῃ
ἐπιβοηθέω|ἐπιβοηθεῖν
ἀηθέσσω|ἀήθεσσον
περιτρομέω|περιτρομέοντο
ἀμφιμάχομαι|ἀμφιμάχωμαι|ἀμφεμάχοντο|ἀμφιμάχωνται|ἀμφιμάχεσθαι|ἀμφιμάχονται
περιτρέφομαι|περιτρέφεται|περιτρέφετο
ἐρωτάω|εἰρωτᾷς|ἐρωτῶντες|εἰρώτα|ἐρωτῶντος
σπανίζω|σπανίσαντές
τειχομαχέω|τειχομαχεῖν
ἐκκολάπτω|ἐξεκόλαψαν
ἐκδιαβαίνω|ἐκδιαβάντες
κορυφόω|κορυφοῦται
ἀντιφερίζω|ἀντιφερίζειν|ἀντιφερίζεις
ἐγκεράννυμι|ἐγκεράσασα
ἀποφεύγω|ἀπέφυγον
ἐφιζάνω|ἐφιζανέτην|ἐφίζανε
ἐλεέω|ἐλέησεν|ἐλέησον|ἐλεησάντων|ἐλεήσει|ἐλέησά|ἐλεήσας|ἐλεήσῃς|ἐλέησε|ἐλεήσῃ
μυθολογεύω|μυθολογεύειν|μυθολογεύω
ἄπειμι|ἄπεσαν|ἄπειμι|ἀπέῃσιν|ἀπῆμεν|ἀπιέναι|ἀπεσσεῖται|ἀπέην|ἀπιόντος|ἀπέσσονται|ἀπούσης|ἀπεόντων|ἀπόντες|ἀπεόντος|ἀπέσσομαι|ἀπῆν|ἄπιθ̓|ἀπιὼν|ἀπιόντα|ἀπέσσεται|ἀπιόντες|ἀπέσσεσθαι|ἀπεών
ἑλίσσω|ἑλίξας|ἑλιχθέντων|ἑλίξεται|ἑλίσσετο|ἑλισσόμενος|ἑλισσομένη|ἑλισσέμεν|ἑλισσόμενόν|ἑλιξάμενος|ἑλισσόμενοι|ἑλίσσεται|ἑλισσόμενον
ἀσπάζομαι|ἠσπάζοντ̓|ἠσπάζοντο
ἀποπλύνω|ἀποπλύνεσκε
μεθίστημι|μετέστη|μετέστησαν|μεθίστατο|μεταστήσω|μεταστησάμενοι|μεταστάντας
ὁπλέω|ὥπλεον
ἄλαλκε|ἀλάλκοις|ἀλαλκέμεναι|ἀλαλκεῖν|ἀλαλκέμεν|ἀλάλκοιεν|ἀλάλκῃσιν|ἀλαλκών|ἄλαλκε|ἀλάλκοι
ἀγρέω|ἀγρεῖθ̓|ἄγρει
ἀναδύνω|ἀνέδυ|ἀναδύη|ἀναδῦναι|ἀνεδύσετο|ἀνδύεται
ὑπολείπω|ὑπέλειπον|ὑπελείπετο|ὑπελείπετ̓|ὑπολίπωμεν|ὑπολίπησθε|ὑπολειφθῆναι|ὑπολείψομαι|ὑπολειπομένοις
διαφθείρω|διέφθειρεν|διαφθείρουσι|διεφθάρησαν|διέφθορας|διέφθειραν|διεφθαρμένοι|διαφθείραντες|διαφθέρσει
στέφω|στέφει|ἔστεφε
παλαίω|ἐπάλαιον|ἐπάλαισεν|παλαίσεις
ἀλδήσκω|ἀλδήσκοντος
δείλομαι|δείλετό
ἀνθιστάω|ἀνθίστασαν
προσήκω|προσήκοντες|προσήκειν|προσήκοντας|προσήκοντές|προσηκόντων|προσήκοντά|προσήκει
ἐπαφύσσω|ἐπήφυσεν
πίνω|πινέμεναι|ἔπιον|πίε|πιέμεν|πίνειν|πίεν|ἔπιόν|πινέμεν|ἔπιεν|πίνοντες|πίνοντά|πίνετε|ἔπινον|πίοιεν|πίνωσιν|πιεῖν|πιοῦσα|πῖνε|πίνουσ̓|πίῃ|πίνεσκεν|πίνῃ|πίνοντας|πίνοιεν|πιόντες|πίνοντ̓|πίον|ἔπινεν|πιόμεν̓|πίνετο|πιέειν|πιόμενος|πίνουσαι|πίοιμι|πινόντων|πῖνέ|πίω|πίνετ̓|πινομένοιο|πίῃσθα|πίνουσιν|πίοι|πίνοντέ|πίνουσί|πίνων|πιὼν
κακόω|κεκακωμένοι|ἐκακώσατε|κακῶσαι|κεκακωμένον|ἐκάκωσε|κακουμένην|κεκακωμένος|κάκου|κακοῖς
ἀπορρήγνυμι|ἀπορρήξας
ψηφίζομαι|ψηφίσασθε|ἐψηφισμένων|ψηφίσασθαι|ψηφίζεσθε
ἐπιθυμέω|ἐπιθυμῆσαί|ἐπιθυμήσαντες
κυβερνάω|κυβερνῆσαι
τυραννεύω|τυραννευθείσης|ἐτυράννει|τυραννῶν
ἀποπλέω|ἀποπλεῖν|ἀποπλείειν|ἀπέπλειον|ἀπέπλευσαν|ἀποπλέοντες|ἀπέπλω
κονίω|ἐκόνισε|κεκονιμένοι|κεκόνιτο|κονίσουσιν
ἐπιδημεύω|ἐπιδημεύεις
ψηφίζω|ἐψηφίσαντο|ἐψηφισμένοι
περιβάλλω|περιβάλλετον|περιβάλλει|περιβαλλομένους|περίβαλλε|περιεβάλλοντο
παραπείθω|παρπεπιθόντες|παραιπεπίθῃσιν|παραιπεπιθοῦσα|παρπεπιθὼν|παρέπεισεν
παρεξελαύνω|παρεξελάαν|παρεξελάσῃσθα
ἐξικνέομαι|ἐξικόμην|ἐξίκετο|ἐξικέσθαι
σκηνέω|σκηνησαμένου
χρηματίζω|χρηματίσαντες
ἀμφιπονέομαι|ἀμφεπονεῖτο
ἀριστεύω|ἀριστεύοντα|ἀριστεύουσι|ἀριστεύῃσι|ἀριστεύεσκε|ἀριστεύεσκεν|ἀριστεύειν
ὀπτάω|ὤπτησε|ὀπτηθῆναι|ὤπτησάν|ὀπτήσας|ὀπτῆσαι|ὤπτησαν|ὀπτήσαντες|ὀπτῆσαί|ὤπτων|ὄπτησάν
ἀποτρέπω|ἀπετράπετο|ἀποτρέψεις|ἀπετρωπῶντο|ἀπέτραπε|ἀπετράπετ̓|ἀποτραπόμενοι|ἀποτρεπέτω
ἠπεροπεύω|ἠπεροπεύσῃς|ἠπεροπεύεις|ἠπεροπεύει|ἠπερόπευον|ἠπεροπεύειν
εἰσίημι|ἐσιέμεναι
ἐπιδίδωμι|ἐπιδώμεθα|ἐπιδοῦναι|ἐπέδωκε|ἐπιδωσόμεθ̓
μεταλλάω|μετάλλα|μεταλλῆσαι|μεταλλᾷ|μετάλλησάν|μεταλλῆσαί|μεταλλᾷς|μεταλλῶσιν|μεταλλῶ
προτιμωρέω|προυτιμωρήσατε
στερίσκω|στερισκώμεθα|στερισκόμενοι
ἀναπηδάω|ἀμπήδησε
ἀπάγχω|ἀπάγχων
ὠθέω|ὤσασθαι|ὦσαν|ὦσεν|ἔωσε|ὦσαι|ὠσάμεθ̓|ὤσαντο|ὤθεσκε|ὤσασκε|ὦσα|ὤσῃ|ὤσαιτο|ὤσατο|ὤσαιμεν|ὠθεῖ|ὤσαισθε|ὦσε|ὤθει|ὦσας|ὤσαιτ̓
ὀπυίω|ὀπυιομένη|ὀπυιέμεναι|ὀπυίοντες|ὤπυιε|ὄπυιε|ὀπυιέμεν|ὀπυίοι|ὀπυίῃ
ἐξαίνυμαι|ἐξαίνυτο
λωφάω|λωφήσει|λωφήσειε
εἰσαθρέω|ἐσαθρήσειεν
καταδάπτω|καταδάψαι|καταδάπτετ̓|κατέδαψαν
κυκάω|κύκησε|κυκηθήτην|κυκήθησαν|κυκώμενον|ἐκύκα|κυκωμένη|κυκώμενος|κυκόωντι
ἐλέγχω|ἐλέγχει|ἐλέγχειν|ἐλέγξῃς
ἐπανίστημι|ἐπανέστησαν
παρασφάλλω|παρέσφηλεν
γεραίρω|γεραίρεις|γέραιρεν
χηρόω|χήρωσε|χήρωσας
καταβλώσκω|καταβλώσκοντα
ἐμπρήθω|ἐμπρήσειν|ἐνιπρήσωσι|ἐνιπρήσειν|ἐνιπρήσω|ἐνέπρηθον|ἐνιπρήσει|ἐνέπρησάν
παρατεκταίνομαι|παρατεκτήναιτο|παρατεκτήναιο
εὕω|εὗσέ|εὗσαν|εὕοντας|εὑόμενοι|εὗσεν
οἰχνέω|οἴχνεσκον|οἴχνεσκε|οἰχνεῦσιν
νάσσω|ἔναξε
ὑπομνάομαι|ὑπεμνάασθε
κατακλείω|κατέκλῃσε|κατεκλῄσθησαν
ἀραρίσκω|ἀρηρώς|ἀρηρότα|ἀρήρῃ|ἀραρὼν|ἄρσαντες|ἄρσας|ἀραρυῖα|ἄρθεν|ἀρηρός|ἀραρυῖαν|ἀραρόντε|ἀραρυίῃ|ἄραρον|ἀρηρότι|ἀραρυῖαι|ἀρηρότες|ἄρμενον|ἤραρεν|ἄρσε|ἀρηρότος|ἠρήρει|ἀράρῃ|ἀρήρει|ἄρσον|ἤραρε|ἀραρυίας|ἀράρισκε
οἰόομαι|οἰώθη
ἀπολαμβάνω|ἀπελάμβανον|ἀπολαβόντες
εἰσάγω|εἰσάγαγον|εἰσαγαγοῦσα|εἰσαγαγών|ἐσάγουσα|εἰσαγαγόντες|εἰσήγαγ̓|εἰσῆγον
ἄνωγα|ἀνώγῃ|ἀνώγει|ἀνῶξαι|ἀνώχθω|ἠνώγεα|ἀνωγέμεν|ἄνωγεν|ἠνώγει|ἄνωχθι|ἠνώγειν|ἀνώγειν|ἀνώγοιμι|ἀνώγετε|ἄνωγε|ἄνωγον|ἄνωχθε|ἀνώγετον|ἀνώγοι|ἄνωγα|ἠνώγεον|ἤνωγον|ἀνώγοιτ̓|ἀνώξω|ἀνωγέτω|ἄνωγας|ἀνώξομεν
προσβιάζομαι|προσβιασθὲν
καταμάρπτω|κατέμαρπτε|καταμάρψῃ
τλάω|τλῆ|τλαῖεν|τετληυῖα|τετληότες|τετλαίη|ταλάσσῃς|τέτληκας|ταλάσσῃ|τλῆτε|τέτλαθι|τλήτω|ἔτλης|ἔτλη|τέτλαμεν|τέτληκε|τετλάμεναι|ἔτλαν|τλῆμεν|τλήσομ̓|τλαίης|τετληότι|ἔτλην|τλήσομαι|τλαίη|τετλάμεν|τετλάτω|ἔτλητε|τλαίην|ἐτάλασσας
ἐπώχατο|ἐπισχὼν|ἐπέσχε|ἐπεχουσῶν
ἐπισείω|ἐπισσείων|ἐπισσείῃσιν
ἐπιπλέω|ἐπιπλέοντα|ἐπιπλώσας|ἐπιπλέοντες|ἐπιπλώων|ἐπέπλως|ἐπέπλευσαν|ἐπιπλὼς|ἐπιπλεῖν|ἐπέπλεον|ἐπιπλέουσιν
ἀκοντίζω|ἀκόντισεν|ἀκοντίσατ̓|ἀκοντίσσαι|ἀκοντίσαι|ἀκόντισε|ἀκόντιζον|ἀκοντίζω|ἀκοντίσσαντος|ἀκοντίζουσι|ἠκόντισαν|ἀκόντισαν
καταζαίνω|καταζήνασκε
διαφύσσω|διήφυσε|διαφυσσόμενον
θυμηγερέων|θυμηγερέων
δινεύω|δινείσθην|δινεύοντες|δινεύοι|δινεύουσαν|δινηθῆναι|δινεύων|δινήσας|ἐδινεόμεσθα|δινεύεσκ̓|ἐδίνεον|ἐδίνευον|δινηθήτην|δινέομεν|δίνεον
προαπαντάω|προαπαντῆσαι
ὑποδρώω|ὑποδρώωσιν
ἀντιάω|ἀντιόωσαν|ἀντιάσειεν|ἀντιάσας|ἀντιάασθε|ἀντιάσαντες|ἀντιάσεις|ἀντιοώντων|ἀντιάαν|ἀντιόωσα|ἀντιόωντες|ἀντιόωσι|ἀντιόωσιν|ἀντιόων
ἀμφιέπω|ἄμφεπεν|ἄμφεπε|ἀμφιέποντες|ἀμφίεπον|ἄμφεπον
σιφλόω|σιφλώσειε
ἀπισχυρίζομαι|ἀπισχυρισάμενοι
ὑποδείκνυμι|ὑπεδείξατε
ἐπιστέφω|ἐπεστέψαντο
βλώσκω|μέμβλωκε|μολοῦσα|μολόντες|μόλῃ|μολών|μολὼν|μολοῦσαι
προσβαίνω|προσβὰς|προσέβη|προσέβαν|προσβάς|προσεβήσετο
κατέρχομαι|κατήλυθον|κατήλθομεν|κατελθόντ̓|κατερχομένης|κατελθέμεν|κατελθόντες|κατῆλθεν|κατῆλθε|κατῆλθον|κατελεύσομαι|κατέρχεται
ῥοχθέω|ῥοχθεῖ|ῥόχθει
συνεπανίστημι|ξυνεπαναστῶσι
προσεῖπον|προσέειπεν|προτιείποι|προσέειπον|προσέειπε
λύω|ἐλύοντ̓|λύετε|λυσόμενός|λῦτο|λῦσον|λύθεν|λύσασθαί|λύουσι|λελύσθαι|λύσῃ|λύσαντες|λῦσαι|λῦσεν|ἔλυσε|λύσας|λύσει|λύον|λύειν|λύε|λύει|λύωμεν|λύσαιτε|λυόμην|λύμην|λελῦτο|λῦσε|ἔλυσαν|λέλυται|λῦσαν|ἐλύσαο|λύσετε|λύ̓|ἐλύσατο|λύσασ̓|ἔλυον|λύσειεν|ἔλυσα|λύσομαι|λύων|λύοντο|λύσω|λέλυντο|λυώμεθα|λύσαθ̓|λελυκότες|λέλυνται|λύτο|λυσάμενοι|λυσόμενος|λῦσαί|ἔλυσ̓|λύσασθ̓|ἔλυεν|λύεσθαι|λύθη|λύσειαν|λύοντες|λύομεν|λύντο|λύσασθαι
κτερεΐζω|κτερεΐξαι
ἐπικουρέω|ἐπικουρήσοντα
ῥύομαι|ῥύοισθε|ῥύετ̓|ῥύονται|ῥύεται|ῥύσατ̓|ῥύοιτο|ῥύσαιτο|ῥύατ̓|ῥύομ̓|ῥύεταί|ῥυσάμην|ῥυσάσθην|ἔρυσο|ῥύσαιτό|ἐρύετο|ῥῦσθαι|ῥύομαί|ἐρρύσατο|ἔρυτο|ῥῦσαι
ἀποδρύπτω|ἀποδρύψωσι|ἀποδρύφοι|ἀπέδρυφθεν
αἰτιάομαι|αἰτιάασθαι|αἰτιόωνται|ᾐτιόωντο|αἰτιόῳτο|αἰτιασαίμεθα|αἰτιώμενοι|αἰτιόῳο|αἰτιᾶσθαι|ᾐτιάασθε|αἰτιωμένου
περιέργω|περιεῖργον
ὑπερέπτω|ὑπέρεπτε
ἐκστρέφω|ἐξέστρεψε
χρή|χρῆν|χρῆναι|χρὴ|χρή
προκυλίνδομαι|προκυλίνδεται
ἔδω|ἔδοντας|ἔδουσί|ἔδεσκε|ἔδουσ̓|ἔδουσιν|ἔδει|ἐδήδοται|ἔδονται|ἔδοιεν|ἔδεις|ἐδηδώς|ἔδεαι|ἔδουσι|ἔδοι|ἔδοντες|ἔδωμεν|ἔδμεναι|ἔδον|ἔδομαι|ἔδων
δειδίσκομαι|δειδισκόμενος|δειδίσκετο
βάζω|βάζουσι|ἐβάζετε|βάζειν|βέβακται|ἐβάζομεν|βάζει|βάζεις|ἔβαζε
σίζω|σίζ̓
πρόσκειμαι|προσέκειτο
εἰσανάγω|εἰσανάγουσι
διέρχομαι|διῆλθε|διέλθωσιν|διελθέμεν|διελθόντων|διελεύσεσθαι|διέλθοιεν|διῆλθον|διέρχεται|διερχόμενος
ἐξιθύνω|ἐξιθύνει
ἐκτέμνω|ἐκτάμνῃσιν|ἐξέταμον|ἐξέταμ̓|ἔκταμεν|ἐκτάμνοντες|ἐκτάμνειν|ἔκταμ̓
ἠπύω|ἠπύει|ἤπυεν
βιοτεύω|βιοτεύσειν|βιοτεύειν
διάκειμαι|διακεῖσθαι
φθινύθω|φθινύθεσκε|φθίνυθον|φθινύθει|φθινύθουσι|φθινύθουσιν|φθινύθειν|φθινύθω
καίω|καιομένῃσιν|καίοντ̓|κήομεν|κήαντες|καιόμενος|καῖ̓|κήαιεν|ἔκηα|ἔκηαν|κάη|καίεται|καίεο|κείατο|ἔκηε|καῖεν|κήαι|κηαμένω|κῆεν|κηάμενος|κῆαι|ἔκαιον|καίουσιν|καιόντων|ἐκάη|καίοντο|καῖε|καίων|κηάμενοι|ἐκαίετο|καιόμεναί|καίωσι|κῆον|καίετο|καιομένη|καίωμεν|καιομένοιο|καιέμεν|ἔκηεν|κήαντο|καιομένης|καήμεναι|ἔκἠ
ἐπιθέω|ἐπίθωνται|ἐπιθεῖτε
καταδέω|κατέδησε|κατέδησαν|καταδήσῃ|κατέδει|κατέδησ̓
θρασύνω|θρασύνοντες
ἀυτέω|ἀΰτευν|ἀΰτει
κακίζω|κακιζόμενοι|κακιζόμενόν
κατάνομαι|κατάνεται
μωμεύω|μωμεύῃ
μηχανάομαι|μηχανάασθε|μηχανόωντας|μηχανόωνται|μηχανάασθαι|μηχανόωντο|μηχανόῳτο
πελεκάω|πελέκκησεν
ἐξερωέω|ἐξηρώησαν
πειρητίζω|πειρήτιζον|πειρητίζων|πειρήτιζεν|πειρήτιζε
οἰνόω|οἰνωθέντες
ἀπολυμαίνομαι|ἀπελυμαίνοντο|ἀπολυμαίνεσθαι
ἀγάλλω|ἀγάλλεται|ἀγαλλόμεναι|ἀγαλλόμενος|ἀγαλλόμενα|ἀγαλλόμενοι
ἐξάγω|ἐξήχθη|ἐξήγαγε|ἔξαγ̓|ἐξάγαγε|ἐξαγαγόντες|ἐξῆγε|ἔξαγεν|ἐξάγουσιν|ἐξάγαγ̓|ἐξῆγεν|ἔξαγε|ἐξαγάγοις|ἐξαχθεὶς
νίφω|νιφέμεν
παραινέω|παραινούντων|παραινεῖν|παρῄνει
πωτάομαι|πωτῶντο
καναχέω|κανάχησε
ἀμφικαλύπτω|ἀμφικαλύψω|ἀμφικαλύπτοι|ἀμφικαλύπτει|ἀμφεκάλυψε|ἀμφικαλύψειν|ἀμφικαλύψῃ|ἀμφεκάλυψεν|ἀμφικαλύψαι|ἀμφικαλύψας
διασπείρω|διεσπαρμένων
κεράω|κερῶντό|κερόωντό|κερῶντάς|κεράασθε|κερόωντο
ἐξελαύνω|ἐξελάσαι|ἐξέλασε|ἐξελάσαντας|ἐξήλαυνεν|ἐξελάσωσι|ἐξελάαν|ἐξελάσας|ἐξελάσειε|ἐξέλασ̓|ἐξήλασε|ἐξελάων|ἐξελάσαιμι|ἐξήλασσαν
ἀπέχω|ἀπέχειν|ἀποσχέσθαι|ἀφεξόμεθ̓|ἀπέχει|ἀπέχομεν|ἀπέχοντο|ἄπεχε|ἀπεχόμενοι|ἀπεχώμεθα|ἀποσχήσει|ἀπέσχοντο|ἀπόσχῃ|ἀφέξω|ἀπόσχωνται|ἀπέχονται|ἀφέξεαι|ἀφέξομαι
πρίαμαι|πρίατο
ἀμφίστημι|ἀμφέσταν|ἀμφίσταθ̓
βάσκω|βάσκ̓
ἐν-εἰμί|ἐνέσται|ἐνῆσαν|ἐνόντων
ἐφικνέομαι|ἐφίκοντο
ἐπιμίσγω|ἐπιμίσγεται|ἐπιμίσγομαι|ἐπιμισγομένων
παροξύνω|παροξῦναι|παροξύνῃ
ἐφεψιάομαι|ἐφεψιόωντο|ἐφεψιόωνται
πλέω|πλέεν|πλείοντες|ἔπλεον|ἐπλέομεν|πλεῖθ̓|πλεύσεσθ̓|πλέων|ἔπλεεν|πλέοντες|πλέουσα|ἔπλευσαν|πλεῖν|πλώοιεν|πλευσούμεθα|πλεούσας|πλῶον|πλείειν|πλέον|πλεούσαις|πλευσεῖσθε|πλέουσιν|πλέουσαι|πλεύσαντας|πλέομεν|πλέωσι|πλεύσαντες
ἐμβάλλω|ἐμβάλλεο|ἐμβαλέειν|ἔμβαλον|ἐμβάλλετε|ἔμβαλεν|ἐμβάλετ̓|ἔμβαλ̓|ἐμβάλλειν|ἐμβάλοι|ἔμβαλε|ἐνέβαλλε
ἀπωθέω|ἀπεώσαντο|ἀπώσησθε|ἀπῶσεν|ἀπέωσε|ἀπώσεσθε|ἀπώσεαι|ἀπῶσαν|ἀπώσει|ἀπεωσάμεθα|ἀπῶσαι|ἀπώσομεν|ἀπωσάμενον|ἀπώσασθαι|ἀπωσαμένους|ἀπώσεται|ἀπωσάμενοι|ἀπώσατο|ἀπώσω|ἀπωσέμεν
ἐξεῖδον|ἔξιδεν
σπεύδω|σπεύδῃ|σπεύδοντε|σπεύδοντας|σπεύσομεν|σπεύδετον|σπεύδοντές|σπεύσομαι|σπευδόντων|σπεῦσε|σπεύδοντι|σπευδόντεσσιν|σπεύδουσ̓|σπεύδειν|σπεύδοντα|σπεύσατέ|σπευδέμεν|σπεύδουσιν
βομβέω|βόμβησεν|βόμβησαν|βόμβησε
ἀντιπαρασκευάζομαι|ἀντιπαρασκευασόμεθα
ἀπομιμνήσκομαι|ἀπομνήσεσθαι|ἀπεμνήσαντο
προαισθάνομαι|προαισθόμενος
χερνίπτομαι|χερνίψαντο
ἕννυμι|ἕσσαν|ἑσσάμενος|ἕσσο|ἑσσαμένω|ἕεστο|ἕσσαι|ἑσσάμενοι|ἕσθην|ἕσαθ̓|ἕσσαντο|εἱμένα|ἕσσεν|ἕστο|ἑέσσατ̓|ἕννυσθαι|ἑέσσατο|ἕσσατο|ἕσασθαι|ἕσσαθ̓|ἕσσ̓|ἕσσω|εἷμαι|ἕσαντο|ἕσσει|ἕσσε|εἱμένος|εἷται|ἕννυτο|ἕννυτ̓|εἱμένοι
ἁμαρτάνω|ἁμαρτάνῃ|ἁμάρτῃ|ἤμβροτεν|ἡμάρτανε|ἁμαρτάνει|ἁμαρτανόντων|ἁμαρτάνοντες|ἅμαρτεν|ἅμαρτε|ἡμαρτήκασι|ἁμαρτεῖν|ἤμβροτε|ἁμαρτάνοι|ἤμβροτες|ἤμβροτον|ἁμαρτόντες|ἁμάρτωσιν|ἁμαρτών|ἁμαρτὼν|ἁμαρτησομένων|ἅμαρθ̓|ἡμαρτάνομεν|ἁμαρτήσεσθαι
παραγίγνομαι|παραγίγνεσθαι|παρεγένοντο|παρεγένετο|παραγιγνόμεναι|παρεγένεσθε|παρεγίγνετο|παραγίγνονται
μέλλω|μέλλοιμεν|μέλλωσιν|μέλλοντες|μέλλουσι|μελλόντων|μέλλων|μέλλεν|μέλλοι|μέλλοντα|μέλλετ̓|ἔμελλεν|μέλλον|ἔμελλ̓|ἐμέλλησαν|μέλλει|μέλλουσαν|μέλλεις|μέλλετε|ἔμελλες|ἔμελλε|μέλλουσιν|μέλλοντας|ἐμέλλομεν|ἔμελλον|μέλλε|μέλλω|μελλήσομεν|ἐμέλλετε|μέλλοντος
εἴδω|ἴσασιν|εἴσατο|ᾔδεα|ἰδέω|ἠείδης|οἶδεν|εἰδυῖα|εἴσομαι|ἴστέ|εἰδότες|ᾔδεεν|εἰδησέμεν|εἴδετ̓
παραμελέω|παρημέλουν
ἀράω|ἀρημένος|ἀρημένον
προσφέρω|προσέφερε|προσφέρεσθαι|προσέφερον
μεταστένω|μετέστενον
ἀλέομαι|ἀλεύατο|ἀλεύαντο|ἀλεύασθαι|ἀλεύεται|ἀλέασθε|ἀλευάμενοι|ἠλεύατο|ἀλέοντο|ἀλεύατ̓|ἄλευαι|ἀλέηται|ἀλευάμενον|ἀλευάμενος
μαίομαι|μαιομένη|μαίεσθαι|μάσσεται
στρατεύω|στρατευόμενοι|στρατεύσαντες|στρατεύουσιν|ἐστρατεύοντο|στρατεύειν|ἐστράτευσαν|ἐστράτευε|στρατευσάντων
ἐκδιαιτάω|ἐξεδεδιῄτητο
ἕζομαι|ἕσασθαι|ἑζόμενοι|εἷσαν|ἕζεσθε|ἕζεσθαι|ἕζεο|ἐέσσατο|ἕζετ̓|ἕζεαι|ἑζομένη|ἕζεθ̓|ἑζόμεθ̓|ἑζομένω|ἕζευ|ἑζέσθην|ἕζοντο|ἕζετο|ἑζόμενος
θύνω|θῦνε|θυνόντων|θῦνον|θύνοντ̓
ἕπω|ἕποντα|ἕπουσιν|ἕπον
ἀμφιπολεύω|ἀμφιπολεύεις|ἀμφιπολεύειν|ἀμφιπολεύοι
φλύω|ἔφλυε
προίημι|προΐει|προέτω|προέηκεν|προϊεῖσα|προῆκε|προῆσθε|προΐειν|πρόοιντο|προέσθαι|προϊεῖσι|πρόες|προέηκα|πρόεσαν|προέμεν|προΐεις|προΐησι|προέηκε
σαίνω|σαίνωσ̓|σαίνοντάς|ἔσηνε|σαῖνον
κατακείρω|κατέκειραν|κατακείρετε|κατεκείρετε
ἐξαποβαίνω|ἐξαπέβησαν
ὁρίζω|ὁρίζων|ὡρίσθω
τιταίνω|τιταίνετο|τιτήνας|τιταίνοιτ̓|τιταινομένω|ἐτιταίνετο|τιταίνων|ἐτίταινε|τιταίνετον|τιταινόμενος
ἔρρω|ἔρῤ|ἔρρε|ἔρρετε|ἐρρέτω|ἔρροντι|ἔρρων
ἐμπλήσσω|ἐνιπλήξαντες|ἐνιπλήξωμεν|ἐνιπλήξωσι
ἐνήνοθε|ἐπενήνοθεν
προσχωρέω|προσεχώρησαν|προσεχωρήσαμεν
συγγράφω|ξυνέγραψε
ὑπολαμβάνω|ὑπολαβεῖν|ὑπολαβόντες
ἀνοίγνυμι|ἀνῷγεν|ἀναοίγεσκον|ἀνέῳγεν|ἀνέῳγε|ἀνέῳξε
ἐπιτέλλω|ἐπετείλατο|ἐπιτέλλομαι|ἐπιτεῖλαι|ἐπέτελλον|ἐπιτείλας|ἐπετέλλετο|ἐπέτελλεν|ἐπέτελλ̓|ἐπιτέλλεο|ἐπιτειλαμένῳ|ἐπετέλλετ̓|ἐπιτέλλω|ἐπιτέλλεαι|ἐπιτείλω|ἐπέτελλε|ἐπέτειλας|ἐπίτειλον
ἀρέσκω|ἀρεσσόμεθ̓|ἀρέσκηται|ἀρέσκοντές|ἀρεσσάμενοι|ἀρεσάσθω|ἀρέσκομαι|ἀρεσσάσθω|ἀρέσσομαι|ἀρεσσάμενος|ἀρέσαι|ἀρέσκει
ὠμοθετέω|ὠμοθέτησαν|ὠμοθετεῖτο
κροτέω|κροτέοντες
κατά-δύω|καταδύσαντες|καταδύσειαν
ἰδίω|ἴδιον
ἐνθυμέομαι|ἐνθυμεῖται|ἐνθυμώμεθα|ἐντεθύμηται|ἐνθυμηθέντες
προστάσσω|προστεταγμένων
ἐμφορέω|ἐμφορέοντο
λακτίζω|λακτίζων
κικλήσκω|κικλήσκων|κικλήσκοντος|κίκλησκεν|κικλήσκει|κικλήσκεις|κίκλησκον|κικλήσκεται|κικλήσκουσιν|κικλήσκειν|κικλήσκουσι|κικλήσκετο|κικλήσκουσ̓
ἀπονίζω|ἀπονίζουσα|ἀπονίψατε|ἀπονίπτεσθαι|ἀπονίψαντες|ἀπονιψάμενοι|ἀπονιψαμένη|ἀπενίζοντο
διαπορθέω|διαπορθήσας
παίζω|παίσατε|ἔπαιζον|παιζούσας|παιζόντων|παίζουσι
γυιόω|γυιώσειν|γυιώσω
φυσιάω|φυσιόωντας
διαπέταμαι|διέπτατο
κατατίθημι|κατέθετο|καταθεὶς|καταθέντε|καταθήσεσθε|καταθεῖναι|κάτθετ̓|κατθέμεθα|καταθησόμεθα|καταθήσω|κατέθηκ̓|κατθέσθην|καταθέσθαι|κατέθηκαν|κατέθηκεν|κάτθεσαν|κατθέμεν|κάτθετε|κατέθηκε|κατέθεντο|κατέθηκα|κατέθηχ̓|κατέθεντ̓|καταθήσει|καταθέντα|κάτθεμεν|κατθέμενοι|καταθείομεν|καταθείομαι
κινδυνεύω|κινδυνεύεται|κινδυνεύειν|ἐκινδυνεύετο|κινδυνεῦσαι|κινδυνεύοντας|κινδυνεύουσι|κινδυνεύοντες
καταθνήσκω|κατατεθνηῶτι|κατατεθνηῶτας|κάτθανε|καταθνῄσκων|κατατεθνηυίης|κατατεθνηώτων|κάτθαν̓|κατατεθναίη|κατατεθνήκασι|κατατεθνηῶτος
ἀκαχίζω|ἀκαχίζευ|ἀκαχίζεις
πορσύνω|πόρσυνε|πορσανέουσα
συνθάπτω|ξυντεθαμμένῃ
προσγίγνομαι|προσγενόμενον|προσγενέσθαι|προσγεγενημένας|προσγενήσεται
μηνίω|μήνιεν|μήνιε|μήνἰ|μηνίει|ἐμήνιε|μηνίσας
ἀοιδιάω|ἀοιδιάει|ἀοιδιάουσ̓
ἀλαόω|ἀλάωσεν
πλάζω|πλάγξομαι|πλάζων|πλάζετο|πλαγχθέντες|πλαζομένου|πλάγχθη|πλάζ̓|πλάζουσι|πλαζόμενοι|πλαζόμενος|πλάζομαι|πλαγχθέντα|πλάζεσθαι|πλάζε|πλαγχθείς|πλάγξ̓|πλάζει|πλάζετ̓
πλεονεκτέω|πλεονεκτεῖσθαι|ἐπλεονεκτοῦμεν
στασιάζω|στασιάσαντες|στασιάσασα|στασιαζόντων|στασιάζειν
μεθύω|μεθύουσαν|μεθύοντι
ἁφάω|ἁφόωντα
προπαρασκευάζω|προπαρεσκευάζοντο|προπαρεσκευασμένους
δάμνημι|δάμνημ̓|δάμνατο|δάμναται|δάμνασθαι|δάμνησι
ξέω|ἔξεσε|ξέσσε|ἔξεον|ξέσσεν
θεειόω|θεειώσω|θεειοῦται
τανύω|τετάνυστο|τανύω|τανύσσῃ|τανύσῃ|τανύσσειέν|τανυσσάμενος|τανύοντο|ἐτάνυσσα|τάνυσσαν|τανυσθείς|τανυσθεὶς|τάνυσθεν|τανύσσας|τετάνυσται|τάνυσεν|ἐτάνυσσε|τανύουσι|τάνυσε|τάνυσσε|τάνυσσεν|τανύσσαι|τανύειν|ἐτάνυσσεν|τανύων
ἀπαγγέλλω|ἀπαγγέλλεσκε|ἀπαγγεῖλαί|ἀπαγγέλλουσιν|ἀπαγγέλλων|ἀπαγγεῖλαι|ἀπαγγείλειε|ἀπήγγειλεν|ἀπαγγείλῃσι|ἀπαγγείλας
οἰνοχοέω|ἐῳνοχόει|οἰνοχόει|οἰνοχοεῦντες|οἰνοχοῆσαι|ἐοινοχόει
ἄνω|ἄνοιτο|ἦνον|ἄνω|ἄνεται
ληίζομαι|ληΐσσατο|ληΐσσομαι|ληίσσατο|ἐλῄζοντο
ἐπείγω|ἠπείγοντο|ἐπειγομένων|ἐπειγόμενος|ἔπειγον|ἔπειγε|ἐπείγετον|ἐπειγομένους|ἐπειχθέντες|ἐπειγόμενοι|ἐπείγετε|ἐπειγόμενός|ἐπειγέσθω|ἐπείγει|ἐπειγομένοισι|ἐπείγῃ|ἐπειχθῆναι|ἐπειγομένην|ἐπείγετο|ἐπειγομένη
λαμβάνω|λάβον|λαβέτω|λαβὲ|λάβετον|ἔλλαβεν|ἔλαβ̓|λαβών|λαβόντες|λάβοιμεν|λάβοιμι|ἐλάβετε|ληφθεὶς|λαβέτην|λάβῃσιν|λαβόντας|ἔλαβε|λάβητε|λαβεῖν|λαβὼν|λάβωμεν|ἔλαβεν|λαβόντος|λαμβάνει|λάβῃσι|λαβόντι|λαβοῦσα|ἔλλαβ̓|λάβοι|λάβεν|εἰλήφατε|ληψόμενοι|λάβ̓|λάβῃ|ἐλλάβετ̓|ἔλλαβε|λαμβάνων|ἐλάβομεν|ληφθεῖσαι|ἔλαβον|λελαβέσθαι|λάβε
δνοπαλίζω|ἐδνοπάλιζεν|δνοπαλίξεις
ἀποψύχω|ἀποψύχοντα|ἀποψυχθεὶς|ἀπεψύχοντο|ἀποψύχειν
ἀνεγείρω|ἀνέγειρε|ἀνέγειρα|ἀνέγειρεν|ἀνεγείρεις|ἀνεγεῖραι
κορέννυμι|κορέσασθαι|κεκορήμεθ̓|κεκορήμεθα|κορεσσάμεθα|κεκορηότε|κορέσσατο|κορέσωνται|κορέσθην|κορέει|κορέσειεν|κορεσσάμενος|κεκορημένοι|κεκόρησθε|ἐκορέσθην|κορεσαίατο|κορέεις|ἐκορέσσατο
νοσέω|νοσήσας
σημαίνω|σημῆναι|σημαινέτω|σημανέω|σημαίνει|σήμαιν̓|ἐσημήναντο|σημαίνουσιν|σήμαινε|σήμηνε|σημαίνειν|σημαίνων
σύνειμι|ξυνιόντας|ξυνιόντες|συνίτην|ξυνιόντων|ξύνισαν|ξυνέσεσθαι
ἀναπαύω|ἀνέπαυσεν
οἰνίζομαι|οἰνίζοντο|οἰνίζεσθε
ἐκσεύομαι|ἐξέσσυτο
χραισμέω|χραίσμησεν|χραισμεῖν|χραισμῆσαι|χραίσμωσιν|χραῖσμε|ἔχραισμε|χραῖσμ̓|χραίσμῃσι|χραισμήσει|χραίσμῃ|χραισμησέμεν
ἀπολιχμάομαι|ἀπολιχμήσονται
ἐκπέρθω|ἐκπέρσειν|ἐκπέρσῃς|ἐκπέρσουσ̓|ἐκπέρσαντες|ἐκπέρσαντ̓|ἐκπέρσει|ἐξεπράθομεν|ἐκπέρσαντα|ἐκπέρσαι|ἐκπέρσωσ̓
παραβαίνω|παρέβασκε|παρβεβαώς|παραβαίνειν|παρβεβαῶτε
ὑφίστημι|ὑπέστημεν|ὑποστάντες|ὑποστήτω|ὑπέσταν|ὑπέστην|ὑπέστης|ὑπέστη|ὑποσταίη|ὑποστὰς
ὑπερπέτομαι|ὑπέρπτατο
ἁρπάζω|ἁρπάσῃ|ἁρπάξαντε|ἥρπαζον|ἥρπασεν|ἁρπάξας|ἁρπάξαν|ἁρπάξων|ἥρπαξ̓|ἁρπάξασα|ἁρπάζοντε|ἥρπαξε|ἥρπασε
ἐξέρομαι|ἐξερέηται|ἐξείρετο|ἐξερέεσθαι|ἐξερέοιθ̓|ἐξερέοιτο|ἐξερέῃσι
ἀναμένω|ἀνέμεινα|ἀναμένειν
κατακοιμάω|κατακοιμηθήτω|κατεκοιμήθημεν|κατακοιμηθῆναι
ὑπεκπροφεύγω|ὑπεκπροφύγοιμι|ὑπεκπροφυγὼν
ἀολλίζω|ἀολλισθήμεναι|ἀόλλισσαν|ἀολλίσθησαν|ἀολλίσσασα
ναυμαχέω|ναυμαχῆσαι|ναυμαχήσετε|ναυμαχεῖν|ναυμαχοῦντες|ἐναυμάχουν|ναυμαχήσουσιν|ἐναυμάχησαν
νήχω|νήξομ̓|νηχέμεναι|νῆχε|νηχόμενος|νηχομένοισι|νηχόμενοι|νῆχον
προσθέω|προσέθη
ἔχω|ἔχοντες|σχέο|ἑξέμεν|ἔχοντας|ἕξει|σχεθέτω|ἔχοντος|ἔχομεν|ἔχοιεν|ἔχετε|σχόμενος|ἔχετο|σχήσεσθαι|εἶχον|ἔχοντά|ἕξεται|σχήσουσι|σχεῖν|σχοίατ̓|σχήσεις|εἴχετο|ἐχούσας|ἔσχεν|ἔχεσκ̓|σχήσειν|ἔχοιμι|σχέσθε|ἕξουσι|ἔχῃσι|ἔχομαι|ἔχουσί|ἔχοντα|ἔσχεθεν|ἔχητον|εἶχε|ἕξομεν|ἔχῃ|ἔχοντι|σχέτο|ἔχεσθαι|ἐχώμεθα|ἔχοντός|ἔχον|ἐσχεθέτην|σχέθεν|ἔχοντε|ἐχόμην|ἔχωμεν|σχήσουσιν|ἔχεται|ἔχεν|ἔχεο|ἔχοντο|ἔχουσα|ἐχέτην|ἕξουσιν|σχήσομεν|ἐχέτω|ἔχεαι|ἔχων|ἔχοντ̓|ἔχῃσιν|σχέθον|ἕξετε|ἔχει|εἶχεν|ἔων|ἔχῃς|ἕξειν|σχήσω|ἔχουσαν|σχήσεσθ̓|ἔσχε|ἔσχον|ἐχούσῃ|ἔχεσκες|σχῶμεν|ἕξοντες|ἐχομένῳ|σχέθ̓|σχεθέειν|ἔχεθ̓|εἴχοντο|ἔχουσι|ἔχοντί|ἔσχετο|ἔσχεθον|ἔχουσιν|ἐχέμεν|ἔχες|ἔχωσιν|ἔχεσκεν|ἔσχοντο|σχέμεν|ἔχῃσθα|ἔχειν|ἔσχες|ἔχονται|σχέθε|ἔχ̓|ἔχε|ἔχετ̓|σχήσει|σχῶνται|σχήσεσθε|ἔχεσκε|σχομένη|ἔχοις|ἔχοι|σχὼν|ἔσχ̓|ἕξω|ἐχόντων|ἔχουσαι|ἔσχεθε|ἔχεις|ἔχεσκον|ἔχω|ἔχουσ̓|σχέσθαι|εἶχ̓
λελίημαι|λελιημένοι|λελιημένος
κτίζω|κτιζόμενον|ἔκτιζον|κτίσσε|ἐκτίζοντο|ἐκτίσθη
ἀπορριγέω|ἀπερρίγασι
ἐπάγω|ἐπῆγον|ἐπάξονται|ἐπηγάγετο|ἐπαγαγόμενοι|ἐπαγαγεῖν|ἐπήγαγον|ἐπαγομένων|ἐπάγοντες
ἐφαρμόζω|ἐφαρμόσσειε
διαγωνίζομαι|διαγωνίζεσθαι
ὀπαδέω|ὀπηδεῖ|ὀπήδει
ἀποπίπτω|ἀπέπιπτον|ἀποπέσῃσιν
ζωγρέω|ζωγρεῖτ̓|ζωγρεῖν|ζώγρει
ἀλλοτριόω|ἀλλοτριοῦται
κτερίζω|κτερίσειεν|κτεριῶ|κτεριοῦσί|κτεριοῦσιν|κτερίσαιεν
νωμάω|νώμησεν|ἐνώμας|νωμᾷς|νωμᾷ|νώμα|ἐνώμα|νώμησαν|νωμῆσαι|ἐνώμων|νωμῶν
ἀμφέρχομαι|ἀμφήλυθε|ἀμφήλυθεν
περισθενέω|περισθενέων
διαφαίνω|διεφάνη|διεφαίνετο
μογέω|ἐμόγησε|μόγησαν|μογήσῃ|ἐμόγησεν|μόγησας|μογέων|μόγησα|ἐμόγησα|μογέοντες|μογήσας|ἐμόγησαν
βωστρέω|βωστρεῖν
λεαίνω|λειήνας|λειανέω|λείηναν
οἰμώζω|οἰμώξας|οἰμώξειε|ᾤμωξεν|ᾤμωξέν|ᾤμωξαν
ἀνίστημι|ἀνέστησαν|ἀνίστησί|ἄνστησον|ἀναστάς|ἀναστάντες|ἀναστήσαντες|ἀνστάντες|ἀνστήμεναι|ἀνίστατο|ἀναστήσας|ἀνέσταν|ἀνιστάμενοι|ἀνίστη|ἀναστὰς|ἀνστήτην|ἀνστὰς|ἀνστήσεις|ἀνιστάμενος|ἀναστῇ|ἀναστήσονται|ἀνστήσων|ἀναστήσαντές|ἀναστήσειεν|ἀνέστη|ἀνστήσει|ἀνστᾶσα|ἀνέστησεν|ἀνστήσεσθαι|ἀναστήσεσθαι|ἀνστήσασ̓|ἀνισταμένη|ἀναστήσουσιν|ἀναστήτω
συγκατεργάζομαι|ξυγκατεργάσωνται
παρεξέρχομαι|παρεξελθοῦσα|παρεξελθεῖν
ὑπαναχωρέω|ὑπανεχώρουν
καλέω|ἐκάλει|κάλεόν|κάλεον|κέκλημαι|καλέσσατο|καλεσσαμένη|καλεῖ|καλέσσας|καλέεσκε|ἐκλήθησαν|κληθέντες|καλεῖσθαι|κάλεσσε|καλέσειε|κάλει|κάλεσσας|κάλεσσα|καλέω|καλέουσιν|κάλεσον|καλέσασθε|ἐκαλοῦντο|καλέσκετο|καλούμενον|καλέεσκον|καλέει|καλεσσαμένω|καλέσαντο|καλέσαντες|καλεῖται|καλουμένας|καλεῦντες|κεκλημένος|καλέουσ̓|ἐκάλεσσας|κάλεσσον|καλέσαντα|καλέοι|καλέων|ἐκαλέσσατο|καλέσειεν|κάλεσσαν|καλέουσι|καλέσας|καλουμένην|καλήμεναι|καλέονται|κεκλήσῃ|κάλεσσεν|καλεῦντο|καλέσασα|καλοῦνται|καλέουσα|κεκλήατο|κέκληται|καλέεσθαι|καλέσασ̓|κεκλῆσθαι|καλεσσάμενος|καλουμένη|καλεῖσθαί|καλεοίμην|καλέσσαι|καλέσσω
ἀντεπιβουλεύω|ἀντεπιβουλεύειν
εἰσπέμπω|ἐσπέμπει
διδάσκω|δίδαξε|διδασκόμενος|ἐδίδαξε|διδάξας|διδάσκεται|ἐδιδάσκομεν|διδάσκουσιν|διδασκέτω|δεδιδάχθαι|ἐδίδαξαν|διδάξαμεν|διδασκέμεναι|διδασκέμεν
ἀπαξιόω|ἀπαξιούντων
προβαίνω|προβέβηκας|προβεβήκῃ|προύβη|προβέβηκε
γουνάζομαι|γουνάσομαι|γουνάζομαι|γουνάζεο|γουναζέσθην
ἀσθμαίνω|ἀσθμαίνων|ἀσθμαίνοντα|ἀσθμαίνοντε|ἀσθμαίνοντ̓
περιφύομαι|περιφῦσ̓|περιφύς|περιφὺς|περιφῦναι
ἀντί,κατά-ἕζομαι|ἀντικαθεζόμενοι
θάομαι|θησαίατ̓
φορμίζω|φορμίζων
μηκύνω|μηκυνόμενος|ἐμηκύνετο|μηκύνηται
πέτομαι|πέτετο|πετέσθην|ἐπέτοντο|πέτονται|πέτεσθαι|πταμένη|πτάτο|ἔπτατ̓|πέτεται|πέτετ̓|πτῆται|ἔπτατο|πέτοντο
χειρόω|χειρώσονται
ἐπιστοναχέω|ἐπεστονάχησε
ὁμιλέω|ὁμιλέοι|ὁμιλεῖ|ὡμίλευν|ὁμίλεον|ὁμιλεῖν|ὁμιλέομεν|ὁμιλήσωσι|ὡμίλησα|ὁμιλεῖς|ὁμίλει|ὁμιλήσειεν|ὁμιλήσαντες
προσπέμπω|προσπέμψαι
λήγω|λήξειεν|λήξω|λῆξαν|λῆγ̓|λῆγε|λήγεις|λήξαιμι|ληγέμεναι|λήγοντα|λήξειν|ἔληγε
κλύζω|ἐκλύσθη|κλύζεσκον
ἀμφιάζω|ἀμφιέσασθε|ἀμφιέσαιμι|ἀμφιέσασα|ἀμφιέσω
τρέμω|τρέμε|τρέμον|ἔτρεμε
μεταίσσω|μεταΐξας|μεταΐσσων
θέρμω|θέρμετε|θέρμετ̓|θέρμετο
ἀποπροίημι|ἀποπροίει|ἀποπροέηκε
θαρσέω|θαρσήσας|θαρσῶν|θάρσησε|τεθαρσήκασι|θαρσοῦσι|θαρσοῦντας|θάρσει|θαρσοῦν|θαρσοίη
ἡγηλάζω|ἡγηλάζει|ἡγηλάζεις
φυλάσσω|ἐφύλασσον|πεφυλαγμένος|φυλάξεις|φυλασσομένοισι|φυλάσσονται|ἐφύλασσε|φυλάσσειν|φυλάσσοιμεν|φυλάσσοντας|φυλάξων|φύλαξεν|ἐφύλασσεν|φυλάσσει|φυλάσσοις|φυλασσέμεναι|φυλάσσετε|φυλάσσω|φύλασσε|φυλάξω|φυλάσσεις|φυλάξασθαι|φυλασσέμεναί|φυλάσσων
ἀχεύω|ἀκαχοίμεθα|ἀχνύμεθα|ἀκηχεμένη|ἀκάχηται|ἀκάχησε|ἀκάχοιτο|ἀχέουσ̓|ἤκαχε|ἀκαχήμενος|ἀχέων|ἀκάχησθαι|ἀκαχήμενον|ἄχνυτο|ἤκαχ̓|ἀκαχήατο|ἄχομαι|ἀκηχέμεναι|ἀχνυμένω|ἀκαχίζεο|ἀχνύμεναι|ἄχνυνται|ἀχνύμενοί|ἀκαχοίμην|ἀκάχοντο|ἀχνυμένῃ|ἀχνυμένη|ἀκάχημαι|ἀχνύμενον|ἀχέουσά|ἀχνύμενος|ἀχνύμενός|ἄχνυται|ἀχεύων|ἀκαχήμενοι|ἀχνυμένῳ|ἀκηχέδατ̓|ἀχνυμένοις|ἀχνύμενοι
σκεδάννυμι|σκεδασθέντες|σκέδασεν|ἐσκέδασσεν|σκέδασ̓|ἐσκέδασ̓|σκέδασον
ἐξαποτίνω|ἐξαποτίνοις
ἐνειμί|ἔνεστιν
ἐμβαίνω|ἐμβεβαυῖα|ἔμβητον|ἐμβαίνων|ἐμβήῃ|ἔμβαινον|ἐμβέβασαν|ἐμβεβαῶτα|ἔμβη
κρούω|ἐκρούοντο|κρουόμενοι|κρουομένους
προαναλίσκω|προαναλώσειν
ἐλαύνω|ἐλαύνοι|ἐλαύνομεν|ἐλάσειε|ἔλασσεν|ἔλασσαν|ἔλαυνες|ἔλασσε|ἐλάσσαι|ἐλαύνετον|ἐλάσαντες|ἔλασ̓|ἐλαυνόντων|ἔλαυνε|ἐλαύνει|ἐλαύνειν|ἐλασσάμενος|ἐλαύνων|ἐλάσας|ἔλων|ἐλαύνωσιν|ἤλασαν|ἐλάσαντας|ἐλήλαται|ἐλόωσι|ἐλάσωσιν|ἐλάαν|ἐλάσσας|ἐληλέδατ̓|ἐλαυνόμενος|ἔλασαν|ἤλασα|ἤλασεν|ἐλάσεἰ|ἤλασ̓|ἐλάσῃ|ἐλασαίατο|ἐλάσαιο|ἐλάσαι|ἐλαυνομένην|ἤλασε|ἠλασάμεσθα|ἔλασε|ἔλασεν|ἐλάσσῃ|ἠλήλατο|ἐλαύνετε|ἐλάσωσι|ἐλαυνέμεν|ἐλάσασκεν|ἐλαύνοντες|ἐλαύνοντ̓|ἐλήλατο
κελαδέω|κελάδησαν
τορέω|ἔτορε
ἀνίημι|ἀνῆκας|ἀνιεμένους|ἀνήῃ|ἀνιεῖσα|ἀνῆκεν|ἀνήσει|ἄνεσάν|ἀνήη|ἀνεῖναι|ἀνιείης|ἀνῆκε|ἀνέηκεν|ἀνιεῖς|ἀνιεμένη|ἀνέντες|ἀνίησιν|ἀνέντας|ἀνειμένῃ|ἀνίει
ἐκδέω|ἔκδεον|ἐκδῆσαι
πύθω|πύσει|πυθομένων|πύθεται
βουφονέω|βουφόνεον
ἐκτίνω|ἔκτισαν
ἐρεείνω|ἐρεείνετο|ἐρέειν̓|ἐρεείνεις|ἐρέεινον|ἐρέεινεν|ἐρέεινε
πίμπλημι|πλῆθεν|πίμπλαντο|πλῆσαν|πλήσειαν|πλῆσθεν|πιμπλᾶσι|πλῆσε|πλῆντο|πλησαίατο|ἔπληντ̓|πλήσασα|ἐπλήσθη|πλησάμενος|πίμπλαντ̓|πλῆτο|πλησάμενοι|πλῆσεν
παραχέω|παρέχει
μετοκλάζω|μετοκλάζει
ὑποφέρω|ὑπήνεικαν
δύω|δῦτε|δύσκεν|δυσομένου|δύσομαι|δύῃς|δύσω|δύσετό|δῦσαι|δέδυκεν|ἔδυσαν|ἐδύσετο|δύσονται|δυσαίατ̓|ἐδύτην|δυέσθην|δῦνε|δῦναι|δύοντο|ἔδυνεν|ἔδυτε|ἔδυνον|δύσετ̓|δύεται|δύνει|δύοντα|δύων|δῦνον|δύντα|δύντε|δύνεις|ἔδυνε|ἔδυν|ἐδύσαντο|δῦθι|δύσεθ̓|δύσεσθαι|δύῃ|δύσεο|δῦνεν|δύσαντο|δύνοντες|δῦ|δύσεαι|ἔδυ|δύμεναι|δύσετο|δῦν̓|δύτω
πολιορκέω|ἐπολιορκεῖτο|πολιορκουμένης|ἐπολιόρκει|πολιορκοῦνται|πολιορκεῖσθαι|πολιορκοῦντας|πολιορκουμένοις|ἐπολιόρκησαν|ἐπολιόρκουν|πολιορκούμενοι|πολιορκεῖν
τίνυμαι|τίνυται|τίνυνται|τινύμενος|τίνυσθον
ἀποσαλεύω|ἀποσαλεύσας
ὑπουργέω|ὑπουργῶν|ὑπουργοῦντα|ὑπουργεῖν
ὄλλυμι|ὄλετ̓|ὀλέσαντες|ὄλεσεν|ὀλέσῃ|ὤλεσαν|ὄλωνται|ὀλώλῃ|ὀλλυμένους|ὀλλὺς|ὄλοισθε|ὀλλῦσαι|ὄλεσσε|ὀλέσσαι|ὀλέσασα|ὀλλυμένων|ὄλωλε|ὄλωμαι|ὤλεσας|ὤλεο|ὀλλύντάς|ὀλέσσας|ὤλετό|ὄλεσσον|ὀλέεσθαι|ὤλονθ̓|ὄλεσαν|ὀλέσσῃ|ὄλωλας|ὀλέσσεις|ὄληαι|ὄλεθ̓|ὀλέσσει|ὀλέσθαι|ὀλέσσῃς|ὀλέσας|ὤλετ̓|ὄλεσσαν|ὀλόμην|ὀλέσαι|ὀλεῖται|ὀλλύντων|ὤλεσε|ὄλοντο|ὤλετο|ὀλέσῃς|ὀλώλει|ὤλεσα|ὀλέσαντ̓|ὀλλύμενοί|ὀλέσωσιν|ὤλεθ̓|ὀλέσω|ὄλεσε|ὤλεσεν|ὀλέσειε|ὤλεσ̓|ὄλωλεν|ὀλέεσθε|ὄληται|ὄλεσσεν|ὀλλύντ̓
ἄλθομαι|ἄλθετο
διελαύνω|διήλασεν|διήλασε
εἰσείδω|εἴσιδον|εἰσιδέτην|εἰσίδομεν|εἰσιδέειν
περιαιρέω|περιεῖλον|περιελόντες
ὅπλομαι|ὅπλεσθαι
ἀνωθέω|ἀνώσαντες
ἐγγυαλίζω|ἐγγυαλίξει|ἐγγυαλίξω|ἐγγυάλιξεν|ἐγγυαλίξαι|ἐγγυαλίξῃ|ἐγγυάλιξα|ἐγγυάλιξε|ἐγγυαλίζει
εἰσαναβαίνω|εἰσανέβησαν|εἰσαναβαίνοι|εἰσαναβᾶσα|εἰσαναβῆναι|εἰσανέβαινον|εἰσαναβᾶσ̓
καθάπτω|καθαπτόμενοι|καθαπτόμενος|καθάπτετο|καθάπτεσθαι|καταβήμεναι
διοπτεύω|διοπτεύσων
φιλέω|ἐφίλησ̓|φιλήσεαι|ἐφίλατο|φιλεῦντας|φιλέωμεν|ἐφίλησα|φιλέεσκε|φιλέουσά|φιλέεις|φίλατο|φιλήμεναι|φιλέεσκεν|ἐφίλησαν|φίληθεν|φίλησε|φιλέουσ̓|φιλέοντε|φιλέειν|φιλέοντες|φίλησα|φιλέει|φιλήσῃ|φίλει|φίλεον|φιλέουσιν|ἐφίλει|φιλεῖ|φιλέῃσιν|φιλέοντέ|φιλοίη|φιλεόντων|φιλησέμεν|φιλέοι|φῖλαι|φιλέοντι|φιλήσω|φιλέων|ἐφίλησε|φιλεῖν|φίλεόν|φιλέεσθε|φιλῆσαι
ὑποχέω|ὑπέχευε
ἀθρέω|ἀθρήσειε|ἀθρῆσαι
ἀποδέω|ἀποδῶσι
αὐγάζω|αὐγάζομαι
μέλπω|μέλπεσθαι|μέλποντες|ἐμέλπετο|μελπομένῃσιν
ἱλάομαι|ἱλασσάμενοι|ἱλάονται
ὑστερέω|ὑστέρησαν
κνυζόω|κνυζώσω|κνύζωσεν
ἰσάζω|ἰσάζουσ̓|ἰσάσκετο
εἰσάλλομαι|ἐσήλατο|ἐσᾶλτο
ἀμφιμαίομαι|ἀμφιμάσασθε
ἀμφιβάλλω|ἀμφιβαλόντες|ἀμφιβαλέσθαι|ἀμφιβαλόντε|ἀμφιβαλόντι|ἀμφιβαλὼν|ἀμφιβαλεῦμαι
ἐκπαιφάσσω|ἐκπαιφάσσειν
σκοπέω|σκοποῦσι|σκοπεῖ|σκοποῦντί|σκοποῦντι|σκοποῦσί
ἐπιτηρέω|ἐπιτηρεῖν
μέδομαι|μεδώμεθα|μέδηαι|μεδέσθω|μεδοίατο|μέδοντο|μέδεσθαι|μέδηται|μεδήσομαι|μεδέσθην
ὀρέγω|ὀρέγεσθαι|ὠρέξαθ̓|ὠρέξατο|ὀρέγων|ὀρωρέχαται|ὀρεξάμενος|ὀρέξειν|ὀρεξάσθω|ὀρέξω|ὀρέξατ̓|ὀρέξομεν|ὀρέξειαν|ὄρεξας|ὀρεξαμένη|ὀρέξασθαι|ὀρέξατο|ὀρέξῃ|ὀρέγοντας|ὀρωρέχατο|ὤρεξε|ὀρέξαι|ὀρέξῃς
ἄγω|ἄγοντα|ἀγέσθω|ἠγαγόμην|ἄξετε|ἄγωμεν|ἀξέμεναι|ἄγοιμ̓|ἤγετο|ἄγαγον|ἀγάγηται|ἄξομεν|ἀγάγῃ|ἄγοντες|ἤγαγεν|ἀγαγόντες|ἀγέμεν|ἀγαγοῦσα|ἀγάγω|ἄγοιεν|ἀγέτην|ἤγετ̓|ἄγωσι|ἤγαγες|ἀγόμην|ἄγοιτο|ἄγοι|ἄγαγ̓|ἄξω|ἀγαγόνθ̓|ἄξειν|ἄξεις|ἄγοντι|ἄγουσαι|ἀγάγωμι|ἄξοντα|ἄγηται|ἀγάγωμεν|ἤγαγον|ἦγε|ἄγῃσι|ἀγαγὼν|ἦγ̓|ἤγαγ̓|ἀγοίμεθα|ἄγῃ|ἄγω|ἄξοντο|ἄγουσιν|ἄγειν|ἄγεται|ἄγεν|ἄγεσθαι|ἀξέμεν|ἄγων|ἄγον|ἄγοιμι|ἀγάγοι|ἄξεσθε|ἄγεις|ἄξοντ̓|ἄξεθ̓|ἤγομεν|ἤγαγε|ἄγαγεν|ἄγαγε|ἄξεσθαι|ἦγον|ἄγωνται|ἄγ̓|ἄγωμαι|ἠγάγετο|ἠγάγεθ̓|ἀγαγέσθαι|ἄξομαι|ἦγεν|ἄγουσι|ἀγέτω|ἄγοντε|ἀγάγῃσιν|ἄξει|ἄγει|ἄγησι
ἐπιτρέχω|ἐπιδραμέτην|ἐπεδραμέτην|ἐπέτρεχον|ἐπιθρέξαντος|ἐπέδραμεν|ἐπιδέδρομεν|ἐπέδραμον|ἐπέδραμε
σκίδνημι|ἐσκίδναντ̓|σκίδναθ̓|σκίδνασθαι|σκίδναται|ἐσκίδναντο|σκίδνασθ̓
τάσσω|ταξάμενοι|τάξαντες|ταχθεὶς|ἔταξαν|ἐτάξαντο
ἀπογυιόω|ἀπογυιώσῃς
διατρίβω|διατρίψας|διετρίβη|διατρίβω|διατρίβουσιν|διατρίβωμεν|διατρίβειν|διατρίβῃσιν
ἐρύω|εἴρυσθαι|ἐρυσαίατο|ἐρυσσάμενος|εἴρυσσέν|ἐρύοντα|ἐρύσσῃς|ἐρύσσωσ̓|εἰρύατ̓|ἐρύσαιο|ἐρύσσεται|ἐρύσαντό|εἰρύαται|ἐρύσατο|εἰρύατο|εἰρύσσατο|εἰρύσσαιτο|εἰρύσατ̓|εἰρύσσονται|ἐρύσσαι|εἰρυμέναι|εἴρυτο|ἐρύσαιμ̓|ἐρύσσατο|ἐρύσσατε|ἐρύσσαμεν|ἐρύσσεσθαι|ἐρύοντο|εἰρύσσαισθε|ἔρυσάν|ἐρύσαι|ἐρύσσεαι|ἐρύσας|ἐρύσαντας|εἴρυσαν|εἰρυόμεσθα|ἐρύων|ἔρυσεν|ἐρύσαιτ̓|ἔρυσθαι|ἐρύοντι|εἰρύσατο|ἐρύσαιτο|ἐρύουσιν|ἐρύσασθαι|ἐρύσαντες|ἔρυσαν|ἐρύεσθαι|ἐρύσσομεν|ἐρυσαίμεθα|εἰρύσαο|ἐρύσσασθαι|ἐρύειν|ἐρύσαντο|ἔρυσσαν|εἰρύσαθ̓|ἐρύσῃ|εἰρυσάμην|εἰρύσσασθαι|ἔρυον|ἐρύουσι|εἴρυντο|ἐρύσσας|ἐρύσασ̓|εἴρυσσε|εἴρυσε
παρατίθημι|παραθεῖτο|παράθες|παρέθηχ̓|παρέθηκεν|παρέθηκ̓|παρθέμενοι|πάρθεσαν|παραθήσομεν|παρετίθετο|παρτιθεῖ|παραθείμην|παρέθηκε
κολούω|κολούει|κολούετε
σκιρτάω|σκιρτῷεν
ἐρυκανάω|ἐρυκανόωσ̓|ἐρύκανε
ἐκλείπω|ἐκλιπόντες|ἐκλιπεῖν|ἐκλιπόντας|ἐκλιποῦσι|ἐξέλιπον|ἐκλιπόντων
κτυπέω|κτυπέουσαι|κτυπέει|ἔκτυπε|κτύπε|κτυπέων
μεταυδάω|μετηύδα|μετηύδων
καταίρω|καταίροντας
πολεύω|πολεύειν
ἀφορμάω|ἀφορμηθεῖεν|ἀφορμηθέντος
ὑπερφέρω|ὑπερφέρομεν
ἀπογυμνόω|ἀπογυμνωθέντα
κτερείζω|κτερεΐξω|κτερέϊζε|κτερεϊζέμεν
ἁρμόζω|ἥρμοσε|ἥρμοσεν|ἁρμόζεο
ἀλείφω|ἤλειψαν|ἄλειψ̓|ἀλειψαμένη|ἤλειψεν|ἠλείψαντο|ἀλείψατο|ἄλειψα|ἀλειψαμένω|ἄλειψεν|ἀλεῖψαι
ὑμνέω|ὑμνήκασι
μεταφράζω|μεταφρασόμεσθα
πάσχω|πάθῃσι|πάθ̓|παθόντ̓|πάσχει|πάθῃσιν|πάθωμεν|πάσχῃ|πάθῃ|πείσεσθαι|πέποσθε|πάθω|πάσχοντος|παθών|πάθον|πάθετ̓|πάθῃς|πέπονθα|ἔπαθον|πάσχωσιν|πάσχουσα|παθόντων|πάσχουσιν|πάθῃσθα|πάθοιμεν|πείσομαι|ἔπαθόν|πάθεν|πέπονθας|πάθωσιν|πάσχειν|πάσχετε|πεπαθυίῃ|παθόντες|πάθοιεν|πάσχω|πείσεται|πάσχεις|παθεῖν|παθοῦσα|πάσχων|πάθοιμι|πάθες|ἔπασχον|παθὼν|πάθοιτε|παθόντε|ἐπεπόνθει|πάσχομεν|πάθοι|παθόντα|πάσχοντες|παθέειν|πάθομεν
κελεύω|κελευσάντων|κέλευσας|κέλευέ|κέλευσον|κελεύεις|κελεύσας|κέλευεν|ἐκέλευον|κελεύετε|κέλευσε|κελεύουσι|ἐκέλευε|ἐκέλευσαν|κελεύομεν|κέλευε|κέλευον|κέλευσαν|κελεύετέ|κελεύει|κελεύσω|κελεύων|ἐκέλευεν|ἐκέλευες|κελεύουσιν|κελεύοντες|κελεύω|κελεύοντος|κελευόμενοι|ἐκέλευσα|κέλευσέ|κελεύοι|ἐκέλευσεν|κελεύῃς|κελεύσαντος|ἐκέλευσ̓|κελευσέμεναι|ἐκέλευσε|ἐκέλευόν|κέλευσεν
ἀνιάω|ἀνιᾶται|ἀνιήσεις|ἀνιήσει|ἀνιηθεὶς|ἀνιηθέντα
ἀποσκίδναμαι|ἀποσκίδνασθαι
ἀκουάζομαι|ἀκουάζεσθε|ἀκουάζωνται|ἀκουάζεσθον
γηθέω|γηθήσειεν|γηθήσαι|γεγήθει|γηθήσει|ἐγήθεεν|γηθήσειε|ἐγήθεις|γήθησαν|ἐγήθεον|γηθεῖ|γήθησέν|γέγηθε|γήθησε|γήθησεν|γηθήσειν
συσκοτάζω|ξυνεσκόταζε
ἐπιχράομαι|ἐπιχρῆσθαι
βαρύνω|βαρύνεται|ἐβάρυνε|βαρυνθέν|βάρυνε|βαρυνθεὶς
συσσῴζω|ξυνεσώσαμεν
σφάλλω|σφαλῶσιν|σφαλέντα|σφῆλεν|σφαλλώμεθα|σφαλῶμεν|σφῆλαι|σφάλλειν
μεταλαμβάνω|μεταλαβόντες|μεταλαμβάνειν
ἐπέξειμι|ἐπεξιέναι|ἐπεξῄει
εἰσκαταβαίνω|ἐσκαταβαίνων
ἐλεφαίρομαι|ἐλεφαίρονται|ἐλεφηράμενος
ἀναμίμνω|ἀνέμιμνε|ἀνέμιμνον
ἀμείβω|ἀμειβόμεθ̓|ἀμείβεο|ἀμείβοντες|ἀμείψεται|ἀμειβόμενος|ἀμείβετο|ἠμείβετο|ἀμείβεται|ἄμειβε|ἀμειβομένη|ἀμείβεσθον|ἀμειβόμενοι|ἄμειβεν|ἀμειβόμεναι|ἀμείψασθαι|ἄμειβον|ἠμείψατ̓|ἀμειβομένω|ἀμειψάμενος|ἀμείβων|ἀμείψατο|ἠμείβετ̓
ἀπόφημι|ἀπόφημι|ἀπόφασθε
ἀγαίομαι|ἀγαιομένου
κεραίω|κέραιε
μεθορμάομαι|μεθορμηθεὶς
ἀποπέτομαι|ἀποπταμένη|ἀποπτάμενος
ἀντιπολεμέω|ἀντιπολεμούντων
ἀτασθάλλω|ἀτασθάλλουσ̓|ἀτασθάλλων
ἐπικρατέω|ἐπικρατεῖν|ἐπικρατέωσιν|ἐπικρατέουσιν|ἐπεκράτουν|ἐπικρατέουσί|ἐπικρατῆσαι
μητίομαι|μητίσομαι|μητισαίμην|ἐμητίσαντο|μητίσασθαι
ἀμφιποτάομαι|ἀμφεποτᾶτο
ἐριδαίνω|ἐριδαίνετον|ἐρίδαινε|ἐριδήσασθαι|ἐριδαινέμεν|ἐριδαίνομεν
ἀπολύω|ἀπελύοντο|ἀπελύθη|ἀπολυσόμεθ̓|ἀπέλυσε|ἀπολύεται|ἀπέλυσας|ἀπολύσομεν|ἀπέλυσεν|ἀπολυθήσεσθαι|ἀπολυσάμενος
εἰσαγείρω|ἐσαγείρετο|ἐσαγείρατο
αἰχμάζω|αἰχμάσσουσι
στείνω|στεινόμενος|στείνοιτο|στείνοντο
ἀγωνίζομαι|ἀγωνίζεσθαι|ἠγωνίζοντο|ἀγωνιζόμενοι
ἐξαλαόω|ἐξαλάωσας|ἐξαλάωσε|ἐξαλαῶσαι
εἰλαπινάζω|εἰλαπινάζουσιν|εἰλαπινάζων
δίζημαι|διζήμενος|διζησόμεθ̓|δίζηαι|διζημένη
διαδέρκομαι|διαδράκοι
ταρβέω|ταρβήσας|τάρβησέν|τάρβει|ταρβεῖ|τάρβησαν|ταρβεῖς|ταρβήσειεν|ταρβήσαντε
παραμίμνω|παρέμιμνεν|παραμίμνων
διακρίνω|διακρίνῃ|διέκριθεν|διακρίνειε|διακρινέεσθαι|διακρίνωσιν|διέκριναν|διακρινέει|διακρινθέντε|διακρινθῆτε|διέκρινεν|διακεκριμέναι|διεκρίθησαν|διεκέκριτο|διακρινθεῖτε|διακρινθέντας|διακρινθήμεναι
οἰκειόω|οἰκειοῦταί
ἀπίστημι|ἀπέστη
ὑπόκειμαι|ὑπόκεινται
ἐκσῴζω|ἐξεσάωσε|ἐξεσάωσεν
ἵστημι|ἵσταντ̓|ἱστᾶσιν|ἱσταμένοιο|στῆσον|ἑστεῶτ̓|στήσεσθαι|ἵστασο|ἕστηκε|ἔστης|ἕστατε|ἑστήκῃ|στῆσε|ἑσταόθ̓|στήσαντο|ἵσταται|στήῃς|ἵσταντο|ἑστάμεν|ἕστηκεν|στῆμεν|ἕστασαν|ἵστασαν|στάσκε|εἱστήκει|ἱστάντας|ἕστηχ̓|στῆ|στῆσαι|ἕστηκ̓|ἑσταότες|στὰς|στῆσεν|στήσαμεν|ἱστάμενοι|ἔσταν|στήομεν|στὰν|ἔστη|στῆν|ἵστατ̓|στήσωσ̓|στέωμεν|στήμεναι|στήσομαι|ἕσταμεν|στῆναι|στήσειν|ἑσταότων|στᾶσα|ἑσταότα|στάς|ἵσταο|στῆσα|ἑστᾶσ̓|ἕστατον|ἕστηκας|ἐστάθη|στάντε|ἵστασθαι|ἔστησαν|στᾶσ̓|στήτην|ἔστησε|ἑσταότος|στῆσαν|ἱσταμένη|ἵσταμαι|στήσασθαι|ἑσταότ̓|στῆθ̓|στήῃ|ἵστη|στήσασα|στησαμένῃ|ἔστησεν|ἑστεῶτες|στῶμεν|στήσεσθ̓|ἱσταμένῳ|ἵστανται|ἔστην|στάσκεν|ἑστήκειν|στάντες|στῆτ̓|στήσαντες|στησάμενοι|ἑστήκασιν|στήσαντ̓|ἕσταθ̓|ἵστατο|στησαμένη|ἱστάμενος|ἑστήκει|στάντων|σταίη|ἵστασθ̓|ἑστάμεναι|ἵστασχ̓|ἑστᾶσι|στησόμεθ̓|στῆθι|στῆτέ|σταίησαν|ἵστασ̓|ἑσταότας|ἑστᾶσιν|στήσας|ἔστητε|ἵστασθε|ἱστάμεναι
παραμυθέομαι|παραμυθήσασθαι|παραμυθησαίμην
λέπω|ἔλεψε
καταφεύγω|κατέφυγεν|καταφυγόντες
ἐπιβαίνω|ἐπιβήσεο|ἐπεβήσετ̓|ἐπέβην|ἐπέβημεν|ἐπιβήομεν|ἐπιβησόμενον|ἐπιβησομένοισιν|ἐπέβαν|ἐπέβαινον|ἐπέβησ̓|ἐπιβάντ̓|ἐπιβήμεναι|ἐπιβαίην|ἐπιβάντες|ἐπιβήσεαι|ἐπιβήσονται|ἐπιβαῖεν|ἐπέβησε|ἐπιβαίης|ἐπιβῆτον|ἐπιβαινέμεν|ἐπεβήσετο|ἐπιβῆναι|ἐπιβείομεν|ἐπιβησέμεν|ἐπιβήσετε|ἐπίβησον|ἐπιβαίη|ἐπιβᾶσαν|ἐπέβησαν|ἐπιβὰς|ἐπιβᾶσα
μελαίνω|μελαίνετο|μελαίνετ̓
εἴσειμι|εἴσειμι
παραβλώσκω|παρμέμβλωκεν|παρμέμβλωκε
μαστίω|μαστίεται|μάστιε
ἐνέζομαι|ἔνεσαν
ὑποχωρέω|ὑποχωρεῖν|ὑπεχώρει|ὑπεχώρησαν|ὑπεχώρουν
κατανοέω|κατενόησε
εἴλω|ἀλὲν|ἐάλη|ἔλσαν|ἔλσας|εἰλέωσιν|ἔλσαι|εἰλόμενοι|ἀλεὶς|ἄλεν|εἰλεῦντα|ἀλῆναι|ἀλείς|ἀλέντες|ἀλήμεναι|εἰλομένων|ἀλέντων|ἐέλμεθα|εἴλει|ἐέλσαι|ἐελμένος|εἴλεον|ἐελμένοι|εἰλεῦντο
σκέπτομαι|σκέπτετ̓|σκεψάμενοι|σκέψασθαι|σκέψασθε|σκέπτεο|σκεψάμενος
κατά-ἕζομαι|καθέζεσθαι
ὀλέκω|ὀλέκοντο|ὄλεκον|ὀλέκουσιν|ὀλέκονται|ὀλέκουσι|ὀλέκοντα|ὀλέκεσκεν|ὀλέκοντας|ὄλεκεν
συνομολογέω|ξυνομολογοῦντος
παρακαλέω|παρακαλέσαντες|παρακαλούμενος|παρεκάλουν|παρακαλοῦντες|παρεκαλέσατε
ἀμνηστέω|ἀμνηστούμενα
ἐπιβοάω|ἐπιβώσομαι
πημί|φάσθε
ὁρμίζω|ὁρμίζονταί|ὥρμισαν|ὁρμίσσομεν|ὡρμίσαντο|ὁρμίζονται|ὡρμίσαμεν
δίεμαι|δίενται|δίεσθαι
περιπλέω|περιέπλευσαν|περιπλεύσαντες
ὑπολευκαίνομαι|ὑπολευκαίνονται
διαμοιράω|διεμοιρᾶτο
θριγκόω|ἐθρίγκωσεν
ῥαίνω|ἐρράδατ̓|ἐρράδαται|ῥάσσατέ|ῥαίνοντο
μερμηρίζω|μερμήριζε|μερμηρίζων|μερμήριξεν|μερμηρίξαι|μερμήριζον|μερμήριζεν|μερμηρίζεις|μερμήριξα|μερμηρίξας|μερμηρίξω|μερμηρίζω|μερμηρίζει|μερμήριξε
ποιέω|ποιήσατ̓|ποιήσατο|ἐποιησάμην|ποιήσονται|ποιησάμενοι|ποιήσαιμεν|ἐποιήσατο|ποίησεν|ποιῶσι|ἐποίησεν|ποίει|ποίεον|ποιήσετ̓|πεποίηκε|πεποίηται|ποιοῖμεν|ποιήσαντες|ποιοῦμαι|ποιεύμην|ποιήσας|ποίησ̓|ποιήσωνται|ποιεῖται|ποιησόμεθ̓|ἐποιοῦντο|ποιεῖ|ποίησον|ποίησαν|ποιήσουσιν|ποιήσομ̓|ἐποίει|ποιήσειεν|ποιουμένης|ποιούμενος|ποιήσασθαι|ποιῆσαι|ποιήσεται|ἐπεποίηντο|πεποιήκαμεν|ποιησέμεν|ποιήσετε|ποιεῖτ̓|ποιησαμένων|ποιῶν|ποιήσαντο|ποιήσομεν|ποιήσειαν|ἐποιεῖσθε|ποιήσεσθε|ἐποίησαν|ἐποιήσαντο|ποιήσῃ|ποιεῖσθαι|ἐποίησε|ποιῶνται|ποιησόμεθα|ποιεῖν|ποιήσειν|ποίησε
παμφανόων|παμφανόωσαν|παμφανόωντος|παμφανόωντα|παμφανόωσα
ὀνομαίνω|ὀνόμηνεν|ὀνόμηνας|ὀνομήνω|ὀνομήνῃς
ἐνιαύω|ἐνίαυε|ἐνίαυεν
ἐρίζω|ἐρίσαντες|ἐρίζεται|ἐρίζειν|ἐρίζοι|ἐρίζετον|ἐρίσσεται|ἐρίσσειαν|ἐρίζητον|ἤρικε|ἔριζεν|ἐρίσειε|ἐρίσωσιν|ἐρίσσειε|ἐρίζεσκον|ἐριζέμεν|ἐρίσαντε|ἐριζέμεναι
ἀλεόμαι|ἀλέασθαι
συλλαμβάνω|ξυλληφθήσεσθαι|ξυλλήψεσθαι|ξυλληφθῆναι
μείρομαι|εἵμαρτο|μείρεο|ἔμμορε
ἐρημόω|ἐρημωθείη|ἠρημώθησαν
προσκλίνω|προσέκλινε|ποτικέκλιται
ἔπειμι|ἐπίωσι|ἐπῆεν|ἐπῇσαν|ἐπιόντα|ἐπήισαν|ἐπείη|ἐπιείσομαι|ἐπιόντας|ἐπιόντων|ἔπειμι|ἐπιόντι|ἐπιόντες|ἔπεισιν|ἐπέην|ἐπέσσεται|ἐπιών|ἔπεσαν|ἐπήϊεν
θεάομαι|θηήσαιο|θηήσαο|θηεῦντό|θηεῖτο|ἐθηεύμεσθα|θηήσαιτο|θηεῦντο|θηήσαντο|ἐθηήσαντο|θηήσατο|θηήσαντ̓|θηοῖό
λάσκω|λεληκὼς|λάκε|λελακυῖα
ἁλιόω|ἁλιῶσαι|ἁλίωσε
πληρόω|πληροῦν|ἐπλήρουν|ἐπλήρωσαν|πληρώσαντες|πληροῦντες
ἀνακαλέω|ἀνακαλεῖ|ἀνεκάλεσαν
πτήσσω|ἔπτηξαν|πτῆξε
διατμήγω|διέτμαγον|διέτμαγεν|διατμήξας
προκαλέω|προκαλέσσεται|προκάλεσσαι|προκληθέντες|προκαλέσσατο|προκαλούμενον
καταχεύω|κατέχυνθ̓|κατέχευεν|κατέχευε|καταχεῦαι|κατέχευας|καταχεύῃ|κατέχευαν
προποδίζω|προποδίζων
κολῳάω|ἐκολῴα
προσαλείφω|προσάλειφεν
ἀναλύω|ἀλλύεσκον|ἀλλύουσαν|ἀλλύεσκεν|ἀνέλυσαν
ἀνοικίζω|ἀνοικίσασθαι|ἀνῳκισμένοι|ἀνῳκίζοντό
τοξεύω|τοξεύειν
συνοικίζω|ξυνοικισθείσης|ξυνῴκισαν
εἰσπλέω|ἐσπλέοντι
αἰτέω|ᾔτεόν|ᾐτέομεν|ᾔτεεν|αἰτήσουσα|αἰτήσοντα|αἴτει|αἰτήσασα|αἰτήσῃ|ᾔτεε|ᾔτησαν|ᾔτεον|ᾔτεέ|αἰτήσων
πίμπρημι|πρῆσαι|πρήσαντες
ἀρθμέω|ἀρθμήσαντε
διακινδυνεύω|διακινδυνεύσειαν|διακινδυνεύσῃ
ψεύδω|ψεύδἐ|ψευσαμένη|ψευσάμενοι|ψευδόμενοι|ψεύδοντ̓|ψευσθῇ|ψεύσομαι|ψεύδεσθαι
ἄω|ἄσαιμι|ἄσασθαι|ἄσεσθε|ἄεσα|ἄεσαν|ἄσειν|ἄσῃ|ἀέσαμεν|ἄμεναι|ἆσαι
τίκτω|ἔτεχ̓|τέκεν|τέκετο|τέκοι|τέξεσθαι|ἔτεκεν|ἔτεκε|τέκετ̓|τέκε|τίκτῃ|τίκτέ|ἔτεκον|τίκτε|τεκοῦσα|τεκόμεσθα|ἔτικτον|τέκομεν|τέκ̓|τέκον|τίκτει|τεκέσθαι|τέκεθ̓|ἔτεκ̓|τίκτεν|ἔτικτεν|τεκὼν|τέξεις|τεκέειν|τέκῃ|τέκοιεν|ἔτικτε|τέκες|τεκοῦσά|ἔτεκές|τέκωσι
μινύθω|μινύθεσκον|μινύθουσι|μινύθει|μινύθῃ
ἀναστεναχίζω|ἀνεστενάχιζ̓
εἰσφέρω|ἐσφέρεται|ἔσφερον
ἐκδέρκομαι|ἐκδέρκεται
τρίζω|τετριγυῖαι|τετρίγει|τετριγυῖα|τρίζουσαι|τετριγῶτας
ἐπιψαύω|ἐπιψαύῃ
περιοράω|περιορᾶν|περιορᾶτε|περιορῶν|περιόψεσθε|περιόψεσθαι|περιοψόμεθα|περιοψόμενοι
ἀπαλλάσσω|ἀπαλλάξαντα|ἀπήλλακται
ἀποναίω|ἀπενάσσατο|ἀπονάσσωσιν
ἀποφαίνω|ἀποφαίνοντος
ὀνομάζω|ὀνόμαζεν|ὀνόμαζες|ὠνόμασεν|ὀνόμαζε|ὀνομάζειν|ὀνομάζων|ὀνομάζοι|ὀνόμαξε|ὠνόμασας|ὠνομάσθη|ὀνόμαζον
προτεύχω|προτετύχθαι
μέμονα|μέμονε|μέμονεν|μέμονάς|μέμονας|μέμονέν|μέμον̓
ἀνήνοθε|ἀνήνοθεν
μετακλίνομαι|μετακλινθέντος
φαέθω|φαέθων
ὑπέχω|ὑποσχὼν|ὑπέσχετο
φαληριάω|φαληριόωντα
ἐποπτεύω|ἐποπτεύεσκε
πρόοιδα|προειδῆτε|προειδότος
ἔραμαι|ἔραται|ἠρασάμην|ἠράσατ̓|ἠράσσατο|ἔραμαι|ἠράσσατ̓
ἱμείρω|ἱμείρετε|ἱμειρόμενός|ἱμείρων|ἱμείραιτο|ἱμείρεται
ἐπάρχω|ἐπαρξάσθω|ἐπαρξάμενοι|ἐπαρξάμενος
ἀκούω|ἄκουσε|ἀκούεις|ἤκουσε|ἀκούετε|ἀκούοντες|ἀκούω|ἄκουσεν|ἀκούσειαν|ἀκουσομένων|ἀκούσῃς|ἄκουον|ἄκουσαν|ἀκούσας|ἀκούσαι|ἀκούοντος|ἀκούσω|ἄκουσ̓|ἀκούσῃ|ἀκούουσ̓|ἤκουσεν|ἄκουσον|ἀκούων|ἀκούομεν|ἀκούουσαι|ἀκούει|ἀκούειν|ἀκουσάτω|ἀκούσονται|ἀκούσαντες|ἠκούομεν|ἤκουσαν|ἀκουέμεναί|ἄκουεν|ἤκουσ̓|ἀκουούσης|ἀκουέμεναι|ἀκουέμεν|ἀκούσαμεν|ἤκουσα|ἄκουσας|ἄκουε|ἄκουσα|ἀκούσεαι|ἀκούετο|ἀκοῦσαι|ἀκουόντεσσι
χατέω|χατέουσα|χατέουσ̓|χατέουσιν|χατέουσί|χατέοντί
ἐποίχομαι|ἐποιχόμενος|ἐποιχομένης|ἐποιχομένην|ἐποιχόμενοι|ἐποίχεσθαι|ἐποιχομένη|ἐπῴχετο|ἐποιχόμενον
μεθέπω|μέθεπε|μετασπόμενος|μετασπών|μεθέπεις|μετασπὼν
εἰσφορέω|ἐσφόρεον
καθιζάνω|καθίζανον
χαλιφρονέω|χαλιφρονέοντα
ἀντιβολέω|ἀντιβολήσει|ἀντιβολήσαις|ἀντιβολήσας|ἀντεβόλησας|ἀντιβολήσεις|ἀντεβόλησε|ἀντεβόλησεν|ἀντεβόλησαν|ἀντιβολῆσαι
προπροκυλίνδομαι|προπροκυλινδόμενος
προδηλόω|προυδήλου
ἀντελπίζω|ἀντελπίσαντες
προιάπτω|προϊάψειν|προϊάψει|προΐαψεν
συμμητιάομαι|συμμητιάασθαι
παραβάλλω|παραβαλλόμενος|παραβάλοιτο
βαρέω|βεβαρηότες|βεβαρηότα
παρέχω|παρεῖχον|παρέσχεν|παρέχοντας|παρέχουσαι|παρέσχε|παρεσχόμεθα|παρέξει|παρασχέμεν|παρέσχοντο|παρεῖχε|παρέχῃ|παρασχὸν|πάρεχον|παρέχει|παρέχουσιν|παρέχειν|παρέχωσι|παρέχοντες|παρέχεσθαι|παρέξεσθαι|παρασχεῖν|παρέχοιμι|παρέσχον|παρέξω|παράσχῃ
δεδίσκομαι|δεδισκόμενος
ἀνέω|ἀνεῖμεν
κομάω|κομόωντας|κομόωντες|κομόωντε
παραδράω|παραδρώωσι
ἀνύω|ἀνύω|ἤνυσεν|ἀνύσειε|ἀνύσσεσθαι
διαχέω|διέχευαν
πτωχεύω|πτωχεύεσκ̓|πτωχεύω|πτωχεύειν|πτωχεύσων|πτωχεύῃ
ἄφημαι|ἀφήμενος
ἐξοιχνέω|ἐξοιχνεῦσι
ἀποστρέφω|ἀποστρέψασκε|ἀποστρέψαντε|ἀποστρέψοντας|ἀποστρέψῃσιν|ἀποστρέψαντες
συμφράζομαι|συμφράσσομαι|συμφράσσατο
ἄεσα|ἀέσαι|ἄσαμεν
τετίημαι|τετιημέναι|τετιηότι|τετιηότες|τετιημένος|τετιημένη|τετίησθον
ὁμηρέω|ὡμήρησε
συλάω|ἐσύλα|συλήτην|συλήσετε|σύλα|συλήσας|συλήσωσι|συλήσειν|σύλησας|συλήσω|συλήσειε|συλήσων
ὠχράω|ὠχρήσαντα
ἐπεντύνω|ἐπεντύνονται|ἐπέντυε
καίνυμαι|κέκαστο|κέκασσαι|ἐκέκαστο|κεκάσμεθα|ἐκαίνυτο|κεκασμένον|κεκάσθαι|κέκασται|κεκασμένε
συμπλαταγέω|συμπλατάγησεν
παλάσσω|πεπάλασθε|παλαξέμεν|παλάσσετο|πεπαλάσθαι|πεπάλακτο|πεπαλαγμένον
ἐπιλήθω|ἐπιλήσεται|ἐπελήθετο|ἐπέλησεν|ἐπιλήσονται|ἐπιλήσομαι
συρράσσω|ξυνερρώγει|συνέρρηκται
μιμνάζω|μιμνάζειν
ἐντροπαλίζομαι|ἐντροπαλιζομένην|ἐντροπαλιζόμενος|ἐντροπαλιζομένη
κροαίνω|κροαίνων
ἐναρίζω|ἐνάριζε|ἐναρίζων|ἐνάριζεν|ἐνάριξα|ἐναρίζοι|ἐνάριξε|ἐνάριζον
διαπλήσσω|διαπλήσσοντες|διαπλῆξαι
καταδέρκομαι|καταδέρκεται
τίλλω|τίλλοντό|τίλλων|τιλλέσθην|τίλλε
πιφαύσκω|πιφαύσκων|πιφαύσκομαι|πιφαύσκεται|πιφαυσκόμενος|πίφαυσκον|πίφαυσκε|πιφαύσκεαι|πιφαύσκεο|πιφαυσκέμεν
ἀπερύκω|ἀπερύκων|ἀπερύκει|ἀπερύκοι
ἀπόερσε|ἀπόερσε|ἀποέρσῃ
περιτέμνω|περιταμνομένους|περιταμνόμενον
λευκαίνω|λεύκαινον
ἔγκειμαι|ἐγκεισομένους|ἐγκείσονται|ἐνέκειντο|ἐγκείσεαι
βοηθέω|βοηθήσοντες|βοηθήσατε|βοηθῆσαι|βεβοηθηκότες|βοηθεῖν|βοηθοῦντας|ἐβοήθει|ἐβοηθήσατε|ἐβοήθησαν|βοηθοῦντες|βοηθήσετε|βοηθῶσιν|ἐβοήθησάν
ἐρείδω|ἐρειδόμενοι|ἐρηρέδαται|ἐρείδεσθον|ἐρείσας|ἐρείδοντες|ἐρεισάμενος|ἐρειδόμενος|ἐρείδουσαι|ἔρειδε|ἐρείσατο|ἔρεισε|ἐρεισθείς|ἐρειδομένω|ἐρεισθεὶς|ἠρήρειστο|ἐρεῖσαι|ἐρηρέδατ̓|ἐρείσθη
εἶδον|ἴδοιεν|ἴδητ̓|ἰδέειν|ἰδόντας|ἴδες|ἰδοῦσά|ἴδηαι|ἰδοῦσαι|ἴδωσι|ἰδόντ̓|ἴδωμ̓|ἴδωμι|ἴδοι|ἰδώμεθα|ἴδῃς|ἰδοῦσα|εἶδον|ἴδοις|ἴδ̓|ἴδοιμι|ἰδόντι|ἴδον|ἴδηθ̓|ἴδεν|ἰδεῖν|ἰδέσθαι|ἴδηται|ἴδε|ἰδοίατο|εἶδεν|ἴδοιτ̓|ἴδοιτο|ἰδών|ἴδω|ἰδόμην|ἰδόντες|ἴδεσκε|εἰδήσεις|ἴδεσθε|εἶδ̓|ἴδῃ|ἰδέτην|ἴδετο|ἴδωμεν|ἰδοῦσ̓|ἴδησθε|ἴδοντο|ἴδομεν|ἰδόντα|εἶδε|ἴδωμαι|ἰδὼν|εἶδες
αὐερύω|αὐέρυσαν|αὐέρυον|αὐερύοντα
περιχώομαι|περιχώσατο
καταφλέγω|καταφλέξω
ἐκκαλέω|ἐκκαλέσας|ἐξεκαλεῖτο|ἐκκαλέσαντες
λιστρεύω|λιστρεύοντα
ἐνόρνυμι|ἐνῶρσας|ἐνῶρσεν|ἐνόρσας|ἐνῶρτο
ἀναχωρέω|ἀναχωρήσαντες|ἀναχωρήσαντα|ἀναχωρήσειν|ἀνεχώρησαν|ἀνεχώρησεν|ἀναχωρήσας|ἀνεχώρει|ἀναχωρήσουσιν|ἀναχωρείτω|ἀναχωρῆσαι|ἀνεχώρουν
ἐγκαθίστημι|ἐγκαθεστάναι|ἐγκαταστήσας
ὑπέρχομαι|ὑπέλθῃ|ὑπήλθετε|ὑπήλυθε
δεδοκημένος|δεδοκημένος
μηκάομαι|μεμακυῖαι|μεμηκώς|μακών|μέμηκον
ἀμφιτίθημι|ἀμφέθετο|ἀμφιτεθεῖσα
ἐπιλλίζω|ἐπιλλίζουσιν
μελετάω|μελετῆσαι|μελετᾶσθαι|μελετῶντες|μελετῶντι|μελετήσομεν
καταράομαι|καταρῶνται|κατηρᾶτο
πατέω|πάτησαν
ἐπιδεύομαι|ἐπιδευομένους|ἐπιδεύετ̓
καθίστημι|καταστάντος|καθίσταντο|καθιστῶνται|καθέσταμεν|καθειστήκει|καταστησόμενοι|καταστῆσαι|καθεστῶτι|καταστήσαντες|κατεστήσαντο|καταστήσαντας|κατάστησον|καθεστάναι|καθίστα|καταστήσεται|καταστάσης|καθεστώτων|καταστῆναι|καταστήσωμεν|καταστήσαιτε|κατέστησαν|καθεστηκὸς|καταστησάμενοι|καταστάντες|καθεστηκυῖαν|καθεστηκυίας|καθεστῶτος|καταστήσουσι|καθιστάναι|καθιστάντα|καταστήσας|κατέστη|καθισταμένοις
νέομαι|νέομαί|νεῖσθαι|νεώμεθ̓|νεοίατο|νεοίμεθα|νεώμεθα|νέηται|νέηαι|νεέσθων|νεέσθω|νεόμην|νεῖαι|νέεσθαι|νέομαι|νεοίμην|νέοντο|νεῖτ̓|νεῖται|νεῦμαι|νέονται
ἐνορούω|ἐνόρουσε|ἐνορούσῃ|ἐνόρουσ̓
ἐθίζω|εἰθισμένοι
καταβάλλω|καταβαλόντας|καταβάλλοντες|κάββαλεν|κατέβαλλε|κάββαλε|κάββαλ̓
ἀπολάμπω|ἀπελάμπετο|ἀπέλαμπ̓|ἀπέλαμπεν
μαιμάω|μαιμώωσα|μαιμώων|μαιμώωσι|μαιμῶσιν|μαίμησε
ἐξάρχω|ἐξῆρχε|ἐξήρχετο|ἐξάρχοντες|ἐξάρχων
δειπνέω|δειπνήσας|δειπνήσειαν|δεδειπνήκειν|δειπνῆσαι|δείπνησε|ἐδείπνεε|δειπνήσαντας
ἐπερύω|ἐπέρυσσε
ἐξίσχω|ἐξίσχει
ὕω|ὑόμενος|ὗε
σήπω|σαπήῃ|σήπεται|σέσηπε
ὀροθύνω|ὀρόθυνον|ὀρόθυνε|ὀρόθυνεν|ὀροθύνει
ἐμπολάω|ἐμπολόωντο
ἐπιπροίημι|ἐπιπροέηκα|ἐπιπροέηκεν|ἐπιπροέηκε|ἐπιπροέμεν
προδιαφθείρω|προδιαφθαρῇ
ἀνασταυρόω|ἀνεσταυρώθη
συναγείρω|συναγρόμενοι|ξυνάγειρα|συναγείρων|συναγειρόμενοι|ξυναγείρατ̓
προσαραρίσκω|προσαρηρότα
ἀστράπτω|ἀστράπτῃ|ἀστράψας|ἀστράπτων|ἀστράπτει
συνάρχω|ξυνάρχοντες
ἐκπίτνω|ἐκπίπτοντες|ἐκπεσόντος
προσάπτω|προτιάπτω
δρέπω|δρεψάμενοι
σχίζω|ἔσχισεν
κατηγορέω|κατηγορούντων|κατηγορεῖτο|κατηγοροῦντες
ἐφίστημι|ἐφεστάμεναι|ἐπέστη|ἐφεστᾶσιν|ἐφεσταότες|ἐπιστάμενοι|ἐφίστατο|ἐφεστάμεν|ἐπιστάμεθα|ἐφέστασαν|ἐφεσταότος|ἐφεστήκει
περιστέφω|περιστέφει
διασκοπέω|διεσκόπουν
ἐνθρῴσκω|ἔνθορεν
ἐρύομαι|ἔρυσασθαι
συγκαθαιρέω|ξυγκαθελεῖν|ξυγκαθελοῦσαι
εἰσάνειμι|εἰσανιών
ἐπεκβαίνω|ἐπεκβάντες
τύπτω|τύψ̓|τύπτε|τύπτουσιν|τύπτον|τύψῃ|τύψον|τύψε|τύπτετε|τυπτομένων|τετυμμένω|τυπεὶς|τύπτων|τυπείης|τύψας|ἐτύπη
ἐπιτοξάζομαι|ἐπετοξάζοντο
παραδαρθάνω|παραδραθέειν|παρέδραθεν
ὑπονοέω|ὑπονοήσας|ὑπενοεῖτε
ἐγκαταλέγω|ἐγκατελέγησαν
χανδάνω|χαδέειν|χάνδανεν|χάδε|χείσεται|κεχανδότα|κεχάνδει|ἐχάνδανον|ἔχαδε
ἐμποιέω|ἐνεποίεον|ἐνεποίουν
ὑποφαίνω|ὑπέφηνε
συγχέω|σύγχεας|σύγχυτ̓|συγχεῦαι|σύγχει|συνέχευε
κατεφάλλομαι|κατεπάλμενος
θύω|θύων|θύουσι|θύει|θῦε|θύοντα|θῦσε|ἐθύσαμεν|θῦεν|θῦσαι
ἠγερέθομαι|ἠγερέθοντο|ἠγερέθεσθαι|ἠγερέθονται
περιδρύπτω|περιδρύφθη
ἀμφιπεριστρωφάω|ἀμφιπεριστρώφα
προσλαμβάνω|προσληψόμεθα|προσλαβεῖν|προσλαβόντες|προσλαβόντας|προσλάβωσιν
βοάω|βοήσας|βοόωντά|ἐβόησας|βοόωντες|βοάᾳ|βόησαν|βοόων|βοόωσιν|ἐβόησε|βοᾶν|ἐβόησα|ἐβόησεν|βώσαντι
εἰσπίπτω|ἐσέπεσεν|ἐσπίπτει
ἐκμυζάω|ἐκμυζήσας
ἀποπαπταίνω|ἀποπαπτανέουσιν
δεῖ|δεῖ|δέοντα
καθεψιάομαι|καθεψιόωνται
ἀποθνήσκω|ἀποθνῄσκοντας|ἀποθνῄσκων|ἀποτέθνασαν|ἀπέθανον|ἀποθνήσκων|ἀποθανεῖν|ἀπέθνῃσκον|ἀποτεθνηῶτος|ἀποθανόντος|ἀπέθανε
περιδείδω|περιδείσασα|περιδείσαντες|περιδείδια|περίδεισαν|περιδείσασ̓
σηκάζω|σήκασθεν
ἀπορραίω|ἀπορραίσει|ἀπορραῖσαι
συγκινδυνεύω|ξυγκινδυνεύειν
ῥυπάω|ῥυπόωντα|ῥυπόω
παριαύω|παριαύων
ὑλακτέω|ὑλάκτεον|ὑλάκτει
διάγω|διήγαγον|διῆγε
θαμίζω|θάμιζεν|θαμίζων|θαμίζεις
διοιστεύω|διοϊστεύσειας|διοϊστεῦσαί|διοϊστεύσῃ|διοϊστεύσειν
αὐαίνω|αὐανθέν
κελάδω|κελάδων|κελάδοντ̓|κελάδοντα
ἐπιβουλεύω|ἐπιβουλευόμεθα|ἐπιβουλεύοντες|ἐπεβουλεύοντο|ἐπιβουλεύοντας
ἑταιρίζω|ἑταρίσσαιτο|ἑταιρίσσαι
ἀποδατέομαι|ἀποδάσσεσθαι|ἀποδάσσομαι
ἄημι|ἄητο|ἀέντες|ἄη|ἀέντων|ἀῆναι|ἀήμενος|ἀήμεναι
φθίω|φθιμένοιο|ἔφθιτ̓|φθῖσαν|φθίσονται|φθίεται|φθιόμεσθα|φθινόντων|φθινέτω|ἔφθιθεν|ἔφθιεν|φθίνουσιν|φθῖτ̓|φθῖσαι|φθίῃς|φθιμένοισι|ἐφθίαθ̓|φθίμενος|φθίσωμεν|φθίσεσθ̓|φθίσεσθαι|φθίσειν|φθιμένου|φθίσθαι|ἔφθιται|φθίσει|φθίνοντος
ἐντρέχω|ἐντρέχοι
στρατοπεδεύω|ἐστρατοπεδεύοντο|στρατοπεδευομένοις|ἐστρατοπεδεύσαντο
προσπαρακαλέω|προσπαρακαλέσαντες
μεταφωνέω|μετεφώνεεν|μετεφώνεον|μετεφώνεε|μετεφώνει
στέρομαι|στέρεσθαι
ἐφάλλομαι|ἐπάλμενος|ἐπᾶλτο|ἐπάλμενοι|ἐπιάλμενον|ἐπιάλμενος
ἐπαιγίζω|ἐπαιγίζοντα|ἐπαιγίζων
ἀντέχω|ἀντίσχῃ|ἀντέχειν|ἀντίσχοιεν|ἀντείχοντο|ἀντισχεῖν|ἀντίσχεσθε|ἀντεῖχον
δράσσομαι|δεδραγμένος
ἀποθρῴσκω|ἀποθρῴσκοντα|ἀποθρῴσκων
κατατήκω|κατέτηξεν|κατατήκετ̓|κατατήκομαι
ἐπιψηφίζω|ἐπεψήφιζεν
κοιρανέω|κοιρανέων|κοιρανέουσι|κοιρανέουσιν|κοιρανέοντα
ἀπιθέω|ἀπίθησ̓|ἀπίθησε|ἀπιθήσω|ἀπίθησαν|ἀπίθησεν|ἀπιθήσει
δαμάζω|δάμασ̓|δαμήμεναι|δαμεὶς|δεδμήατο|δαμήῃ|δαμέντα|δαμᾷ|δαμάσσω|δαμασαίμεθα|δεδμήμεσθα|ἐδαμάσθην|δαμείς|δαμέντι|δαμάσσομεν|δεδμημένος|δαμέντες|δαμασσάμενοί|δαμασθεὶς|δάμασσαν|δαμασαίμην|δαμείη|δαμέντ̓|δεδμήμην|ἐδάμην|δμηθέντα|δάμασσ̓|ἐδάμασσα|δάμη|δαμάσσῃ|δαμασθείς|δαμήῃς|δαμόωσιν|δαμέντας|δάμασσας|δαμάᾳ|δαμάσῃ|δμηθήτω|ἐδαμάσσατο|ἐδάμημεν|δαμασσάμενος|ἐδάμασσε|δαμάσσας|δάμασσεν|δάμεν|δαμάσσεται|δαμασαίατο|δαμέντων|δεδμημένοι|δαμεῖεν|δαμάσθη|δαμείω|δαμῆναι|δαμάσσατο|δαμέντε|δαμάσαντό|δάμασε|δαμάσαντες|δάμασσε|ἐδάμασσεν|δεδμημένον|δάμασσον|ἐδάμη|δαμάσασθαι|δάμασον|δαμείετε
ἀποείκω|ἀπόεικε
ἐπικλώθω|ἐπέκλωσαν|ἐπέκλωσεν|ἐπεκλώσαντο|ἐπικλώσωνται|ἐπικλώσῃ
ἐξέλκω|ἐξελκομένοιο|ἐξέλκουσα
ἀποτμήγω|ἀποτμήξας|ἀποτμήγουσι|ἀποτμήξαντες|ἀποτμήξαντε
στρεύγομαι|στρεύγεσθαι
μετατίθημι|μετέθηκε
ἰσχύω|ἰσχύοντας|ἰσχύουσα|ἰσχύουσι|ἴσχυον|ἰσχύουσιν|ἰσχύσας|ἰσχυσάντων|ἰσχύομεν|ἰσχύων
συμμαχέω|μαχώμεθ̓|μαχεῖται|ξυμμαχεῖ|ξυνεμάχει|μαχέοιτο|μαχήσονται|ξυμμαχεῖν
ὑπεκφέρω|ὑπεξέφερεν|ὑπέκφερον|ὑπεξέφερον
γηράσκω|γηράς|γηρασκέμεν|ἐγήρα|γηράσκωσι|γηράσκοντα|γηράσκει|γήρασκε
αἰδέομαι|αἰδεσθείς|αἴδετο|αἰδομένη|αἰδέσσεται|αἰδεῖο|αἴδεο|αἰδομένων|αἴδεσθεν|αἰδέομαι|αἰδεῖσθε|αἰδόμενος|αἰδεσθεὶς|ᾐδέσατ̓|αἰδομένω|αἰδεῖται|αἰδέσεται|αἴδεσσαι|αἰδεῖσθαί|αἰδέσσομαι
κρατέω|κρατέουσι|κρατοῦντι|κρατήσαντες|κρατέει|κρατῶσι|ἐκρατοῦντο|κρατήσομεν|ἐκράτει|κρατέειν|ἐκράτησαν|ἐκράτησάν|κρατῶν|κρατέων|κρατέεις|κρατήσαντές|κρατεῖν|ἐκράτησε|κρατοῦντες|ἐκράτουν|κρατοῦντές|κρατέουσιν
ἔχθω|ἤχθεθ̓|ἔχθεσθ̓|ἐχθόμενός|ἤχθετο
ἐφευρίσκω|ἐφεύρομεν|ἐφεύροι|ἐφεύρω
πονέω|πονησόμεθ̓|πονεύμενος|πονεώμεθα|πονεῖτο|ἐπόνουν|πονεύμενον|πονέεσθαι|πονήσομαι|πονησάμενος|ἐπόνει|πονησάμενοι|πονέοιτο|ἐπονεῖτο|πονήσατο|πεπόνητο|πονέοντο
ὑπορρήγνυμι|ὑπερράγη
ἀνακοντίζω|ἀνηκόντιζε
πτοέω|ἐπτοίηθεν
μεταφέρω|μετενεγκεῖν
ἐρέω|ἐρείομεν
εἰσοράω|ἐσόψομαι|ἐσίδεσκεν|εἴσιδε|εἰσορόωντο|εἰσοροώσῃ|εἰσορόωσι|εἰσορόωντες|ἐσιδοῦσα|ἐσόψεται|εἰσεῖδε|εἰσορόωσαν|εἰσοράασθε|εἰσορόωσιν|εἰσορόων|εἰσορόωντα|εἰσορόωντι|εἰσορόωσα|εἰσοράασθαι|ἐσορῶσ̓|ἐσορῶν|εἴσιδ̓|εἰσορόωσαι|ἐσορῶντι|ἐσιδέσθην|ἐσορᾶν|εἰσορόωντας|εἴσιδεν|εἰσορόῳτε
ὄθομαι|ὄθετ̓|ὄθεται|ὄθομαι
παρεκπροφεύγω|παρεκπροφύγῃσιν
ἐπισεύω|ἐπεσσύμενον|ἐπισσεύεσθαι|ἐπέσσυτο|ἐπεσσύμενοι|ἐπισσεύας|ἐπισσεύῃ|ἐπεσσύμενος|ἐπεσσύμεθ̓|ἐπεσσεύοντ̓|ἐπεσσυμένους|ἐπέσσυται
καταρρέω|καταρρέον
θητεύω|θητευέμεν|θητεύσαμεν
κατευνάω|κατευνηθέντα|κατευνήσαιμ̓|κατευνήσαιμι
κατασεύομαι|κατέσσυτο
ἀναείρω|ἀναεῖραι|ἀνάειῤ|ἀνάειρε
περιφαίνομαι|περιφαινομένοιο|περιφαινομένῳ
πολεμέω|πολεμοῦντες|ἐπολέμησαν|πολεμοῦνται|πολεμήσει|πολεμήσαντα|πολεμῆσαι|πολεμοῦντα|πολεμῶσι|πολεμήσειν|πολεμοῦσι|πολεμήσομεν|ἐπολεμήσατε|πολεμήσονται|πολεμήσοντες|πολεμεῖν
γουνόομαι|γουνοῦμαι|γουνοῦσθαι|γουνούμενος|γουνοῦμαί|γουνούμενοι|γουνούμην
ὑποδύομαι|ὑποδύσεαι|ὑποδύντε|ὑπέδυ|ὑποδῦσα|ὑπεδύσετο
ἀφεστήξω|ἀποστῆναι|ἀφεστηκότα|ἀφεστῶτα|ἀφεστηκυίας|ἀποστᾶσι|ἀφίστανται|ἀφιστάναι|ἀφεστᾶσί|ἀποστήσονται|ἀπέστησαν|ἀποστάντες|ἀποστῶσιν|ἀφεστᾶσι|ἀφισταμένοις
νευστάζω|νευστάζων
ὀδύρομαι|ὀδύρονται|ὀδυρόμενοι|ὀδυρόμενος|ὀδύρομαι|ὀδύρετο|ὀδύρονταί|ὀδυρομένῳ|ὠδύροντο|ὀδύρεαι|ὀδυρομένῃ|ὀδυρομένοισι|ὀδύρεο|ὀδυρομένοισιν|ὀδύρεται|ὀδυράμενος|ὀδυρόμενον|ὀδύροντο|ὀδυρομένη|ὀδυρομένην
πάομαι|πέπασθε
περιπλέκω|περιπλέχθη|περιπλεχθεὶς
πόρω|πόροις|πόρε|πόρῃσιν|ἔποῤ|πέπρωται|πόρωσιν|πορών|πορὼν|πεπρωμένον|πόροι|πορόντες|πόῤ|πόρωμεν|πόρον|ἔπορον|πόρεν|πόρῃ
μειλίσσω|μειλισσέμεν|μειλίσσεο
ἐπορέγω|ἐπορεξάμενος
ἐπικλείω|ἐπικλείουσ̓
φυσάω|ἐφύσων|φυσῶντες|φύσει
βιβάω|βιβᾶσα
δίζω|δίζε
ποιόω|ποιούμενοι|ποιοῦντες
συνορίνω|συνορινόμεναι
ῥώομαι|ἐρρώσαντο|ῥώοντ̓|ῥώοντο|ἐρρώοντο
καταλείβω|καλλείψω|καταλειβομένοιο
θαρσύνω|θάρσυνον|θαρσύνονθ̓|θαρσύνων|θάρσυνάς|θάρσυνέ|θαρσύνεσκε|θαρσύνω
δαρδάπτω|δαρδάπτουσιν
τρυγάω|τρυγόωσιν|τρυγόῳεν
σιωπάω|σιωπῆσαί|σιωπήσειαν|σιωπᾶν
ξαίνω|ξαίνειν
μετοίχομαι|μετῴχετο|μετοιχομένη|μετοιχόμενος
ἐπιπρέπω|ἐπιπρέπει
χέω|χεούσῃ|χυθείη|ἐχέοντο|χυμένη|χύντο|χεῦεν|χεῦαν|κέχυθ̓|χέεν|ἔχευεν|χεύωσιν|χεύῃ|χεῦε|ἔχυτ̓|ἔχεεν|χεύατο|χέοντος|χεύαμεν|χεῖσθαι|χέουσ̓|χεόμην|χέοντα|χέουσα|κέχυτ̓|χεύω|χεῦ̓|χεῦαι|χέοντες|ἔχευε|κέχυντο|χέε|χευάντων|ἐκέχυντο|χέοντας|χεύαντες|κέχυτο|χέων|χύτο|ἐχεύατο|ἔχευαν|χεύομεν|χέουσαι|κέχυνται|χέον|χεούσης|κέχυται|χέοντ̓|χέοντο|χέει|χέουσαν|ἔχεαν|χεῦον|χέ̓|ἔχυντο
ἀσκέω|ἤσκηται|ἀσκήσας|ἤσκησαν|ἤσκειν|ἤσκησεν|ἀσκήσασα
μορύσσω|μεμορυγμένα
ὀκριάομαι|ὀκριόωντο
ὑποστρέφω|ὑποστρέψειας|ὑπέστρεφε|ὑποστρέψεσθαι|ὑποστρέψας|ὑποστρεφθείς|ὑποστρέψωσι
ἀνατρέχω|ἀναδέδρομε|ἀνέδραμον|ἀνέδραμεν|ἀνέδραμε
κατερύω|κατείρυσεν|κατειρύσθαι|κατείρυσται
ὑπόρνυμι|ὑπώρορε
κτεατίζω|κτεάτισσα|κτεάτισσεν|κτεατίσσας
πολεμίζω|πολεμίξων|πολεμίξειν|πολέμιξον|πολεμιζέμεν|πολεμίζειν|πτολεμίξω|πολεμίζῃ|πολεμίζετε|πολεμίζει|πολεμίζοι|πολέμιζε|πτολεμίζειν|πτολεμίξομεν|πτολεμίξων|πολεμίζων|πολεμιζέμεναι|πολέμιζον|πολεμίζομεν|πολεμίζω|πολεμίξομεν
γίγνομαι|ἐγένετο|γενήσεται|γενομένης|γεγενημένος|γένετ̓|γενόμην|γένησθε|γενομένου|γένοιθ̓|γίγνοντο|γένοιτ̓|ἐγένοντ̓|γίγνεθ̓|γενομένοις|γεγένηνται|γεγάασι|ἐγενέσθην|γενομένους|γίγνοντ̓|γενόμεσθα|γένηαι|γιγνόμενόν|γένωνται|γεγενημένους|γίγνοιντο|γενομένη|γίγνηται|γίγνετ̓|γένοιτο|γεγαῶτ̓|γένοιτό|γένοιο|γεγαῶτα|γίγνονται|γεγάασιν|γιγνομένῳ|γιγνόμενα|γενοίατο|γενόμενον|γιγνόμενοι|γίγνομαι|γιγνομένους|γενοίμεθα|γίγνετο|γενομένων|γεγονότων|γενέσθαι|γένηται|γίγνωνται|γιγνόμενος|ἐγίγνετο|γιγνομένοισιν|γενέσκετο|ἐγένοντο|γενομένην|γένοισθε|γεγόνει|γεγαῶτας|γενόμενος|γενοίμην|γενόμενοι|γίγνεσθαι|γιγνομένων|γένωμαι|γενήσεσθε|γένεθ̓|γένοντο|γέγον̓|γεγένηται|γιγνομένης|γένετο|γενέσθαί|γενώμεθα|γιγνόμεθα|γενησομένου|γενέσθω|ἐγένεσθε|ἐγίγνοντο|γίγνεται|γενέσθην|γένευ|γενόμενα
ῥοιζέω|ῥοίζησεν
τρύζω|τρύζητε
πειράζω|πειράζειν|πειράζων|πειρᾶσθαι
ἀμφράζομαι|ἀμφράσσαιτο
ψευστέω|ψευστήσεις
διαγιγνώσκω|διαγιγνώσκοντες|διαγιγνώσκωσιν|διαγιγνώσκω|διαγιγνώσκοντας|διεγνωκότας|διαγιγνώσκειν|διέγνωστο|διαγνῶναι
πεδάω|πέδησε|πεδάασκον|πεδῆσαι|πέδησεν|ἐπέδησ̓|πεδάᾳ
περαιόω|περαιούμενοι|περαιοῦσθαι|περαιωθέντες|περαιώσεσθαι
σείω|σείετο|σείων|σείοντ̓|σείσατο|ἐσσείοντο|σειόμεν̓|σεῖσ̓|σεῖον|σειόμενον
ἀποκωλύω|ἀποκωλύοι
ἀραβέω|ἀράβησε
εὐθύνω|ηὐθύνθη
νίσσομαι|νισόμενον|νισσόμεθα|νίσοντο|νίσομαι
ἐμπάσσω|ἐνέπασσεν
περιγίγνομαι|περιγενέσθαι|περιγεγενημένους|περιγίγνεται|περιγίγνονται|περιγιγνόμεθ̓
χράομαι|ἐχρῆτο|χρῆται|χρεώμενος|χρῶνται|χρώμενος|χρῆσθαι
εἶμι|ἰόντ̓|ᾔει|ἰόντι|ἴομεν|ἴτην|ἰούσης|ᾖσαν|ἰόνθ̓|ἴτω|ἰοῦσαι|εἶσ̓|εἴσεται|ἰούσας|ἴτ̓|ἴεν|ἤϊσαν|ἰόντας|ἤια|ἤιεν|ἤἰ|ἰὼν|ἰών|εἶμι|ἴθ̓|ἤϊ̓|ἤιε|ἴῃς|ἴμεν|ἴῃσθα|εἶσι|ἰοῦσιν|ἴσαν|ᾖεν|ἐείσατο|ἴασιν|ἴω|εἶσθα|ἰόντα|ἴοι|ἐεισάσθην|ᾔομεν|ἰόντε|εἶσιν|ἴτε|ἴῃ|ἴῃσιν|ἤϊον|ἤϊεν|ἰόντων|ἰέναι|εἴσατο|εἴσῃ|ᾖε|ἰοῦσα|ἤιομεν|ἴμεναι|ἰούσῃ|ἰείη|ἴε|εἶμ̓|ἰόντες|ἴθι|ἤϊε
συνάγω|ξυνάγοντες|σύναγεν|σύναγον|ξυνάγωμεν|ξυναγαγὼν|ξυναγαγόντι|ξυνάγουσα|ξυνήγαγον
κατακλίνω|κατακλίνας
κατάγω|καταξέμεν|κατήγαγεν|κατήγετο|κατηγαγόμεσθα|κατάγοντο|κατάγων|κατάγειν
ὑπεκπρολύω|ὑπεκπροέλυσαν
ἀράσσω|ἀράξω|ἄρασσεν|ἀράχθη|ἄραξεν|ἄραξ̓|ἄραξε
ὑπεμνήμυκε|ὑπεμνήμυκε
βεβαιόω|βεβαιοῦται|βεβαιοῦμεν|βεβαιούμενα|βεβαιώσασθαι
ἐξερύω|ἐξερύσας|ἐξερύσαι|ἐξέρυσαν|ἐξέρυσ̓|ἐξείρυσσαν|ἐξερύοι|ἐξέρυσεν|ἐξείρυσε|ἐξερύσασκε|ἐξέρυσε
στεφανόω|ἐστεφάνωτο|ἐστεφάνωται
κέλομαι|κελόμην|κέλεσθαί|κελέσθω|κέλονται|ἐκέκλετο|κέλεται|κέκλεθ̓|κέκλετ̓|κέλεσθε|κέλετο|κέλομαι|κελήσεται|κέλεαί|κέκλοντο|κέκλετο|κεκλόμενος|κέλετ̓|κέλεαι|κέλεταί|κέλῃ|κελοίμην|κεκλόμενοι
διαρπάζω|διήρπασαν|διαρπάζουσιν
λίγγω|λίγξε
πταίρω|ἔπταρεν
ἐφοράω|ἐποψόμενος|ἐπόψεαι|ἐφορᾷ|ἐπιόψομαι|ἐφορῶντες|ἐποψόμενον|ἐφορᾷς
προσαπόλλυμι|προσαπόλλυται
διακείρω|διακέρσαι
φρουρέω|ἐφρουρεῖτο|φρουρεῖν|ἐφρούρουν
ἄνειμι|ἀνιόντος|ἄνεισι|ἀνιοῦσαν|ἀνιὼν|ἀνιόντι|ἀνήιον|ἀνιόντες|ἀνιόντα|ἀνιοῦσ̓
ἀνέβραχε|ἀνέβραχεν|ἀνέβραχε
ὑπέκκειμαι|ὑπεξέκειτο
ὀφέλλω|ὤφελλες|ὤφελλε|ὀφέλλεις|ὤφελλ̓|ὄφελλε|ὀφέλλειεν|ὀφέλλετο|ὀφέλλωσίν|ὀφέλλεται|ὀφέλλουσα|ὄφελλον|ὀφέλλειν|ὀφέλλει|ὤφελλον|ὄφελλεν|ὀφέλλετε
ἀπατάω|ἀπάτησας|ἀπατήσω|ἀπάτησεν|ἀπάτησε
δενδίλλω|δενδίλλων
στορέννυμι|στόρεσ̓|στορέσαι|ἔστρωτο|στορέσας|στόρεσον
ἱμάσσω|ἵμασ̓|ἱμάσσῃ|ἵμασεν|ἱμάσσω
ἀνατλῆναι|ἀνέτλη|ἀνέτλημεν|ἀνέτλης
ἀρετάω|ἀρετᾷ|ἀρετῶσι
ἀτίζω|ἀτίζων
χωρέω|χωρεῖ|χωροίη|χωρῆσαι|χωρήσας|ἐχώρει|χώρησεν|χωρήσειεν|χωρήσουσι|κεχωρήκατε|χώρησαν|χωρῶσι|χωροῦσιν|ἐχώρησαν|χωρήσει|χωρήσαντ̓|χωρήσαντες|ἐχώρουν
ἐρέθω|ἐρέθῃσιν|ἔρεθε|ἐρέθουσι|ἐρέθουσιν
κατακτείνω|κατεκτάνομεν|κατέκτα|κατακτείνει|κατακτάνῃ|κατακτείνειε|κατέκτανεν|κατακτενέεσθε|κατάκτανε|κατακτὰς|κατέκτανε|κατακτάμενος|κατακτείνειεν|κατακτείνῃ|κατέκταθεν|κατέκτανον|κατακτανέουσιν|κατακτείνειν|κατέκτανες|κατακτενεῖ|κατακτάς|κατακτεῖναι|κατέκταν|κατακτείναντα|κάκτανε|κατακτείνας|κατακτάμεν|κατακτάμεναι|κατακτείνωσι
ἥκω|ἥκουσιν|ἥκοντας|ἥκω|ἥκομεν|ἥκειν|ἧκον|ἥκοντες|ἥξειν
λείπω|λελείψεται|λίποιτο|λειφθείη|λελείμμην|λιπέτην|λελεῖφθαι|λειπομένην|λίπηται|λεῖπεν|λιπέτω|λειπομένοις|λίπω|ἐλείπετε|λίπεν|ἔλειπεν|λίπες|ἔλειπε|λίπε|λιποῦσα|λέλοιπεν|λίποντο|λείψει|λιποῦσ̓|ἐλείπομεν|λεῖπε|λέλειπται|λεῖπ̓|λίποιτε|λείψω|λιπόμην|ἐλέλειπτο|λιπὼν|λελειμμένοι|λιπόντε|λίπησθε|λίπησθον|λέλειπτο|λείπεσθε|λιπέσθαι|λίποι|λελειμμένος|λίπον|λίπομεν|λείπεις|ἔλιπεν|ἐλίποντο|λιποῦσαν|ἔλιπον|λιπόντα|ἔλειπον|λείπεσθαι|ἔλιπε|λίπεθ̓|λίπ̓|λείψετέ|λείπετ̓|λιποίμην|λείπεσθ̓|λίποιεν|λείπονται|λίπωνται|λείπει|λίπῃ|λίπετ̓|ἔλειπες|λείψειν
ἐπιπίπτω|ἐπιπεσόντες
εἰλύω|εἰλύσω|εἴλυται|εἰλυμένοι|εἴλυτο|εἰλυμένος|εἰλυμένω|εἰλύαται|εἰλυμένα
γεφυρόω|γεφύρωσεν
δισκέω|ἐδίσκεον
διατρέω|διέτρεσαν
μάχομαι|μαχέσκετο|μάχοιτο|μαχησόμενον|μαχόμεσθα|μάχονται|μαχώμεθα|μάχοιο|μαχέσθην|μάχεσθ̓|μάχεσθε|μάχοντο|μάχεαι|μαχοίμην|μαχησόμενοι|μάχεσθαι|μαχήσεται|μαχέονται|μάχωνται|μάχετ̓|μαχήσασθαι|μάχωμαι|μαχειόμενος|μαχεσσαίμην|μάχηαι|μαχοίατο|μαχήσεσθαι|μαχεσσάμεθ̓|μαχέσασθαι|μάχεσθον|μαχήσεαι|μαχησόμενος|μαχησόμεθα|μαχούμεθα|μαχέσσασθαι|μαχησόμεθ̓|μάχηται|μαχησομένους|μαχέσαιτο|μαχέσαιο|μαχέοιντο|μαχεούμενοι|μάχεσθαί|μαχόμην|μαχεούμενον|ἐμάχοντο|μαχήσοντ̓|μαχέσσατο|μαχήσομαι|μαχεσσάμενον|μαχόμεσθ̓|μαχέσθω|μαχεσσαμένω
ἀπολείβω|ἀπολείβεται
ἀπόρνυμι|ἀπορνύμενον
δαίζω|δεδαϊγμένον|δαΐξαι|ἐδαΐζετο|δαϊζόμενος|δαΐζων|ἐδάϊζε|δεδαϊγμένος|δαϊζέμεναι|δεδαϊγμένῳ|δεδαϊγμένοι
ὑπεῖπον|ὑπειπὼν|ὑπείπομεν
νικάω|ἐνίκησας|νικάσκομεν|νικηθέντι|νικᾷς|νίκησε|νίκων|νικᾶν|νικήσεἰ|νικήσας|ἐνίκησα|νίκα|νικησέμεν|νικῶντες|ἐνίκησαν|νενικηκότι|νικήσαντες|νικῆσαι|ἐνίκησεν|ἐνίκα|νικήσαντ̓|νικήσαντι|νικηθῶσιν|νικώμενοι|νικηθέντες|νικηθεὶς|ἐνίκων|νίκησεν|νενικηκότες|νικήσῃ|νικᾷ|νικήσουσι|νίκησα
ἐπικραίνω|ἐπεκραίαινε|ἐπικρήηνον|ἐπικρήνειε
κερτομέω|κερτομέοι|ἐκερτόμεον|κερτομέωσιν|κερτομέοντες|κερτομέων|κερτομέουσαν
βροντάω|βρόντησε|ἐβρόντησεν|ἐβρόντησας|βροντήσας
καταισχύνω|καταισχύνοντα|καταισχύνητέ|καταισχύνειν
ἀποστίλβω|ἀποστίλβοντες
ἀμπέχω|ἄμπεχεν
ἀποπροαιρέω|ἀποπροελὼν
ἐπιπέτομαι|ἐπέπτατο|ἐπιπτέσθαι
χαλκεύω|χάλκευον
ἀπάρχω|ἀπαρχόμενος
κελητίζω|κελητίζειν
κονέω|κονίοντες
ἐπιχέω|ἐπέχυντο|ἐπεχεύατο|ἐπέχευε|ἐπιχεῦαι
μεταχειρίζω|μεταχειρίσαι
ἐντείνω|ἐντέταται|ἐντέτατο
δήω|δήεις|δήομεν|δήετε
ἔργνυμι|ἔρχατο|ἐέρχατο|ἐρχθέντ̓|ἔρχαται|ἐέργνυ|ἐργομένη
προσαυδάω|προσαυδάτω|προσηύδα|προσαυδήτην|προσηύδων
συναντάω|συναντήτην|συναντήσωνται
διεῖπον|δίειπέ|διαειπέμεν|διείπομεν
ὁρμαίνω|ὅρμαινε|ὁρμαίνοντα|ὁρμαίνοντες|ὥρμηναν|ὁρμαίνουσαν|ὁρμαίνουσ̓|ὁρμαίνοντ̓|ὁρμαίνων|ὁρμαίνοντας|ὁρμαίνοντι|ὅρμηνεν|ὥρμαιν̓|ὥρμαινε
ἀμφιχάσκω|ἀμφέχανε
ἐκγελάω|ἐκγελάσας
κατακαλέω|κατακληθείς
κλοτοπεύω|κλοτοπεύειν
θωρήσσω|θωρήσσοιτο|θωρήξομεν|θωρηχθέντες|θωρηχθῆναι|θωρήσσοντο|θωρήσσεσθαι|θωρήσσεσθον|θωρήξομαι|θωρήχθησαν|ἐθωρήσσοντο|θωρῆξαί|θώρηξεν|θωρήσσεο|θωρήσσετο
προσβάλλω|προτιβάλλεαι|προσβάλοιεν|προσέβαλλεν
μνημονεύω|μνημονευόμενα
παραδίδωμι|παρέδοσαν|παραδοῦναι|παραδόντες|παραδοῖεν
ἐχθοδοπέω|ἐχθοδοπῆσαι
πίπτω|πίπτων|πεσέειν|πεσόντος|πέσεν|ἔπεσον|ἔπεσεν|πεπτεῶτ̓|πεσόντα|πεπτηὼς|ἔπιπτον|πεσόντες|πέσωμεν|πῖπτον|πεσέτην|πεπτηῶτες|πέσῃ|ἐπεπτώκεσαν|πέσοι|πεσέονται|πέσοιεν|πιπτόντων|πεσοῦσ̓|πεπτηώς|πέσωσι|ἔπιπτεν|πεσών|πίπτουσιν|ἔπεσ̓|πεσὼν|πίπτει|πέσῃσιν|πέσε|ἔπεσε|πέσῃσι|πεπτεῶτας|πέσον|πεσοῦσα|πῖπτεν|πεσόντ̓|πεσέεσθαι|πίπτωσι|πῖπτε|πέσητον|ἔπιπτε
μακαρίζω|μακαρίζοι
ἐξαγορεύω|ἐξαγόρευεν
ἐναραρίσκω|ἐναρηρός
προβλώσκω|προμολών|πρόμολ̓|προμολοῦσα|προβλωσκέμεν|προμολὼν|προβλώσκειν|πρόμολον
ἐρατίζω|ἐρατίζων
κοναβέω|κονάβησε|κονάβησαν
ὑποτίθημι|ὑποθήσομαι|ὑποθέσθαι|ὑποθήσεται|ὑπετίθει|ὑποθησόμεθ̓|ὑποθήσεαι|ὑπόθευ
παραμείβω|παραμειψάμενος
προχωρέω|προυχώρησε|προυχώρει|προκεχωρηκυιῶν|προχωρεῖν|προχωρησάντων
ἀσχαλάω|ἀσχαλάᾳ|ἀσχαλάαν|ἀσχαλόωσι|ἀσχαλόωντα|ἀσχαλόων
ἀπολαύω|ἀπολαύουσιν
ἀναπρήθω|ἀναπρήσας
ἐπιπροιάλλω|ἐπιπροΐηλε
μετανίστημι|μετανίστατό
ἀναπίμπλημι|ἀναπλήσαντες|ἀναπλῆσαι|ἀναπλήσειν|ἀναπλήσῃς|ἀναπλήσας
ἐκκομίζω|ἐξεκομίσαντο
δορπέω|δορπήσομεν|ἐδόρπεον|δορπῆσαι|δορπείτην|δορπέομέν
λικμάω|λικμώντων
ἐπερωτάω|ἐπηρώτων
περιπέλομαι|περιπλομένου|περιπλομένων|περιπλομένους
μνάομαι|μνάσκετ̓|μνᾶται|μνᾶσθαι|μνώοντ̓|μνάᾳ|μνῶνται|μνώοντο|μνώμενοι|μνάσθω|μνάασθαι|ἐμνώοντο|μνωομένω|μνωομένῳ|μνώμεθ̓
καναχίζω|κανάχιζε
ἐποπίζομαι|ἐποπίζεο
ἀμφιβαίνω|ἀμφιβεβήκῃ|ἀμφιβεβήκει|ἀμφιβέβηκας|ἀμφιβέβηκεν|ἀμφιβέβηκε
οἴχομαι|οἴχεσθαι|ᾤχετ̓|ᾤχεθ̓|οἰχομένην|ᾤχεο|οἴχεσθ̓|οἰχόμενον|οἴχηται|οἴχετ̓|οἴχωνται|οἴχονθ̓|οἰχομένου|οἴχωμαι|ᾤχοντο|οἴχοιτο|οἴχεται|ᾤχοντ̓|ᾤχετο|ᾠχόμεθ̓|οἴχεσθον|οἰχόμεναι|οἰχόμενοι|οἴχονται|οἴχεθ̓|οἰχομένοιο|οἰχομένῳ|οἰχομένη
εὕδω|εὑδέμεναι|εὕδοντας|εὕδεσκ̓|εὗδ̓|εὕδων|εὕδοιμι|εὗδε|εὕδειν|εὕδοντες|εὕδοι|εὕδει|εὗδον|εὕδουσιν|εὕδουσι|εὕδῃσι|εὕδῃ|εὕδεις|εὕδῃσθα|εὕδουσ̓|εὕδοντ̓|εὑδέτω
ἀμφιζάνω|ἀμφίζανε
ἐπιστέλλω|ἐπιστέλλουσι|ἐπεστάλη
μεθαιρέω|μεθέλεσκε
τινάσσω|τινάσσων|τίνασσε|τιναξάσθην|τινάσσοντας|ἐτίνασσε|τινάσσεται|τινάσσετο|τινάξῃ|τίναξε|ἐτίναχθεν|ἐτίναξε|ἐτίναξεν
δάπτω|δάπτουσιν|δαπτέμεν|δάψει|δάπτει|ἔδαψεν|ἔδαψας
τεύχω|τεύχοιμι|τεύχουσαι|ἔτευξα|τεύχων|τεύχοντ̓|τεῦχεν|ἔτευξ̓|τετυγμένα|τεύξας|τεύξειε|ἐτύχθη|τετεύχαται|τεύξει|τετυγμένος|τετεύχατο|τεῦχε|τεύχειν|τεύξασα|ἔτευχε|τεύξειν|ἐτέτυκτο|τευχούσῃ|τεύξουσι|τετύκοντο|τέτυξαι|τετύκοντό|τεύξεἰ|ἔτευξαν|τεῦξε|τετύγμην|τετυγμένον|τεῦξαν|τέτυκται|τετυκοίμεθα|τετυκέσθαι|ἔτευξεν|τετεύξεται|τέτυκτο|τέτυξο|τεύξομεν|τεῦξ̓|τετυκεῖν|ἔτευξε|τεύξῃ|ἐτέτυξο|τετύχθω|τετύχθαι|ἐτεύχετον|τεύξω|ἔτευχεν|τεύχει|τεύξεις|τεύξειεν
ἐκπεράω|ἐκπεράᾳ|ἐξεπέρησεν|ἐξεπέρησε|ἐκπερόωσιν
κρίζω|κρίκε
ἡσυχάω|ἡσυχάσουσι
βρυχάομαι|βεβρυχὼς|ἐβεβρύχει|βέβρυχεν
μετασεύομαι|μετέσσυτο
προσερεύγομαι|προσερεύγεται
προρέω|προρέοντι|προρέοντα|προρέει|προρέειν|προρέουσι|προρέοντος
συνέργω|συνέεργον|συνέεργε
ἀπεῖπον|ἀποείπῃ|ἀπειπόντος|ἀπόειπ̓|ἀπέειπεν|ἀπειπέμεν|ἀποείπω|ἀπέειπε|ἀποειπεῖν|ἀποειπὼν|ἀποείποι
ἀτύζω|ἀτυχθεὶς|ἀτυζομένους|ἀτυζομένω|ἀτυζόμενοι|ἀτυζομένην|ἀτυζομένων|ἀτυζομένῃ|ἀτυζόμεναι
ἄρχω|ἄρξει|ἤρξατο|ἄρξειαν|ἄρχει|ἀρχέτω|ἄρξομαι|ἦρχεν|ἦρχ̓|ἄρχετε|ἄρχε|ἦρξε|ἄρξαιτε|ἀρξάμεναι|ἄρχοιτο|ἄρχοντας|ἄρξωσι|ἀρξάμενος|ἀρχομένους|ἄρχειν|ἄρχῃ|ἦρχε|ἄρξομεν|ἀρχομένην|ἄρχ̓|ἄρξαι|ἦρξα|ἄρχομεν|ἀρξάντων|ἤρχοντο|ἄρχοντα|ἤρξαντο|ἀρχόμενος|ἀρχέμεναι|ἄρχον|ἀρξάμενοι|ἦρχον|ἄρχωσι|ἄρξειεν|ἤρχετο
τολμάω|ἐτόλμησεν|τολμῶμεν|τολμήσεις|τόλμησεν|τολμήσαντα|ἐτόλμας|τολμήσειεν|τολμῶντες|τόλμων|ἐτολμήσαμεν|τολμῆσαι|ἐτόλμα
φθείρω|φθεῖραι|φθείρεσθ̓|φθειρόμενον|φθείρασα|φθείρουσι|ἐφθείροντο|ἐφθαρμένων|ἔφθειρον|ἐφθάρη|ἔφθειραν|ἐφθάρησαν|φθειρομένους
ἀνορούω|ἀνόρουσαν|ἀνόρουσεν|ἀνορούσας|ἀνόρουσε
ἀντεῖπον|ἀντεῖπεν|ἀντείπομεν|ἀντεῖπον
ἅπτω|ἅπτηται|ἥψατο|ἁψαμένη|ἁπτόμενος|ἅπτονται|ἅψασθαι|ἅψεσθαι|ἅπτετ̓|ἥπτετο|ἅψατο|ἁπτόμενον|ἥπτοντο|ἁπτέσθω|ἅπτεσθον|ἅψεται|ἁψάμενοι|ἁψάσθην|ἁπτομένη|ἁπτόμεναι|ἅπτεται|ἅπτεαι|ἁψάμενος|ἅψας|ἅπτεσθαι
δειδίσσομαι|δειδίξασθαι|δειδίξεσθαι|δειδίσσεο|δειδίσσεαι|δειδισσέσθω|δειδίσσεσθαι|δειδίσσετο
περιάγνυμι|περιάγνυται
ἀνιάζω|ἀνιάζων|ἀνιάζουσιν|ἀνίαζ̓|ἀνιάζῃ|ἀνίαζον|ἀνιάζει
πλύνω|πλυνέουσαι|πλύνεσκον|πλυνούσῃ|πλῦνάν|πλύνασ̓|πλυνέουσα
κιρνάω|κιρνὰς|ἐκίρνα|κίρνη
ἀναιρέω|ἀνελόντες|ἀνελέσθαι|ἀνέλοιο|ἀνελοίμην|ἀνεῖλε|ἀνείλοντο|ἀναιρήσεσθαι|ἀνεῖλεν|ἀνελόμενοι|ἀνείλετο|ἀναιρεθεισῶν|ἀνέληται|ἀνέλοντο|ἀνελόντα|ἀνελὼν
ἀμάω|ἀμῷεν|ἀμήσαντες|ἀμησάμενος|ἤμων
δέομαι|ἐδέοντο|δεῖται|δεομένῳ|δεόμεθα
βαίνω|βείω|βαῖνε|βήσεται|ἔβαιν̓|βάν|βῆσαν|βῶσιν|ἔβαινεν|βεβαῶτα|ἔβαν|βῆμεν|βὰς|βαίην|βαίνοντ̓|ἐβεβήκει|ἐβήτην|βεβαώς|βῆν|ἐβήσαμεν|βάντε|ἔβης|βήτην|ἔβαινε|βήσαμεν|βαίνει|βάντες|βήσομεν|βέβασαν|βέβηκε|βῆναι|βέβηκας|βαῖν̓|βεβῶσα|ἔβησαν|ἔβημεν|βεβήκει|βαῖνον|βεβάασι|βάντα|βὰν|βαίνομεν|βῆσε|βάτην|βῆσεν|ἔβη|βάνθ̓|βήμεναι|βαινέτω|βῆ|ἐβήσετο|βήσετο|ἔβην|ἔβαινον|βαίνων|βεβάμεν
πτύω|πτύοντα
συμπήγνυμι|συνέπηξεν
ὑπνάω|ὑπνώοντας
νηκουστέω|νηκούστησε
ἐκτελέω|ἐκτελέεσθαι|ἐξετέλεσσε|ἐξετέλεσσαν|ἐκτελέωμεν|ἐκτετέλεσται|ἐκτελέσαντες|ἐκτελέειν|ἐκτελέσω|ἐκτελέσας|ἐκτελέω|ἐκτελέουσιν|ἐξετέλεσσα|ἐξετέλεσσεν|ἐξετέλειον|ἐκτελέει|ἐξετελεῦντο|ἐκτελέσωσι|ἐκτελέσειεν
ἐπινέμω|ἐπένειμε
οἰκέω|οἰκουμέναις|ᾤκησαν|ᾤκηθεν|οἰκοῦσιν|οἰκέομεν|ᾤκει|οἰκῶμεν|οἰκοῦντες|οἰκουμένων|οἰκέοιτο|οἰκεῖον|ᾤκεον|ᾤκουν|οἴκεον
ὀχλέω|ὀχλεῦνται
γάνυμαι|γάνυνται|γανύσσεται|γάνυται
κιχάνω|κιχείομεν|κιχήσατο|κιχήσεται|ἐκίχεις|κίχανε|ἔκιχεν|κίχεν|κιχήμεναι|κιχήσεαι|κιχείω|κίχανεν|κιχήμενον|ἐκίχανον|κιχανόμενοι|κιχήσομαι|κιχάνω|κίχον|κιχάνεται|κιχείη|κιχήσεσθαι|ἐκίχανεν|ἐκίχημεν|κιχάνετε|κιχῆναι|κιχὼν|ἐκίχανε|κιχάνει|κιχεὶς|κίχανον|κιχησόμεθα|κιχήτην|κιχάνομαι|κίχῃσι|ἐκίχαν̓
ἀποθαυμάζω|ἀπεθαύμασ̓
συνεπαιτιάομαι|ξυνεπῃτιῶντο
κοναβίζω|κονάβιζεν|κονάβιζε
ἀμφιλαχαίνω|ἀμφελάχαινε
δαμνάω|δαμναμένους|δάμνα|δαμνᾷ|ἐδάμνα
ἀμφιστρατάομαι|ἀμφεστρατόωντο
εὐνομέομαι|ηὐνομήθη
ἀπινύσσω|ἀπινύσσων|ἀπινύσσειν
ἐκπάλλω|ἔκπαλθ̓
προσκοπέω|προσκοπεῖν
πολεμησείω|πολεμησείοντας
μετοχλίζω|μετοχλίσσειεν|μετοχλίσσειε
κορέω|κορήσατε
προστέρπω|ποτιτερπέτω
διαφέρω|διαφέροντας|διαφέρειν|διενεχθέντες|διέφερον|διαφερόντων|διενεχθέντας
προφεύγω|προφυγεῖν|προφυγόντα|προφύγῃ|προφυγὼν|προφύγοισθα
νέμω|νέμων|ἐνέμοντ̓|νέμε|νέμετε|νεῖμε|νέμεσθαι|νεμόμενα|νεῖμαν|ἐνέμοντο|νέμοιτο|νεμόμενοί|ἔνειμε|νέμει|νέμοντας|νέμοντο|νέμηαι|νεῖμον|νεμόμεσθα|νέμεται|νέμονται|ἔνειμαν|νέμεαι|νεμόμεσθ̓|νεμόμεθα|νεῖμεν|ἔνεμον
ὀλολύζω|ὀλόλυξαν|ὀλόλυζε|ὀλόλυξε|ὀλολύξαι
φράσσω|φράξε|φράξαντες|φράξαντο|φραχθέντες
παρακλίνω|παρακλίνας
πεζομαχέω|ἐπεζομάχησαν
ἀείδω|ἀειδούσης|ἀείδοντες|ἄειδε|ἄειδεν|ἄεισε|ἀεισόμενος|ἀείδοιεν|ἤειδε|ἀείδῃ|ἀειδέμεναι|ἀείδει|ἀείδῃσιν|ἄεισον|ἤειδεν|ἀεῖσαι|ἀείδων|ἄειδον|ἀείδεις|ἀείδω|ἀείδειν
κομίζω|κομιοῦνται|κόμισαί|ἐκόμιζε|ἐκομίσσατο|κομιζέμεν|κομίζει|κομισθῶσιν|κόμιζε|κομίζῃ|κομίζεσθαι|κομίσσῃ|κόμισαν|κομίσαντο|κομισθήσονται|κόμισεν|κόμισσα|κομιζόμενός|κομίσσατο|κομίζειν|κομισθῆναι|κομίσαιο|κόμισσον|κομιεῖν|ἐκόμισσε|κόμισσε|κόμισε|κομίζω|κομιῶ
ἀπεχθάνομαι|ἀπήχθεσθε|ἀπήχθετο|ἀπεχθέσθαι|ἀπέχθηαι|ἀπεχθάνεαι|ἀπεχθομένοισί
προκινδυνεύω|προκινδυνεῦσαι
ἀλγέω|ἀλγήσας|ἀλγήσετε
μεταβαίνω|μετάβηθι
ἐκφέρω|ἐκφερέμεν|ἐξοίσουσιν|ἐκφέροι|ἐξέφερον|ἔκφερον|ἔκφερεν|ἐξέφερεν|ἐξενεχθέντα|ἔκφεῤ
ἐνιζάνω|ἐνίζανον
ἵζω|ἵζε|ἵζεσκεν|ἕσσα|εἷσεν|ἵζοντο|εἷσέ|ἵζ̓|εἷσον|εἷσε|ἵξετ̓|ἵζοντ̓|ἕσασα|εἷσ̓|ἵζεσκε|ἷζεν|ἵζευ|ἕσσον|ἕσσας|ἕσας|ἷζε|ἷζον|εἷσαν|ἱζόντων|ἕσσε|ἵζει|ἵζοιτο
διαθρύπτω|διατρυφὲν
καταβρόχω|καταβρόξειεν
προέρχομαι|προελθόντος|προῆλθον|προελθόντες|προελθεῖν
θαυμαίνω|θαυμανέοντες
διαρρίπτω|διαρρίπτασκεν
δέψω|δεψήσας
ματεύω|ματεύσομεν
ἐπαγλαίζω|ἐπαγλαϊεῖσθαι
βίβημι|βιβάντα|βιβάς
προτιμάω|προτιμῶνται|προτιμηθείη
δίδωμι|δόσκεν|διδώσειν|δῶκαν|δότω|διδόντα|δώῃσιν|δώσω|δοῖμεν|δοῦναι|δῶκ̓|δίδοσαν|διδοῖσθα|δώσουσι|ἔδομεν|δός|δῶκα|δόμεναι|διδοῖεν|δίδομεν|ἔδωκε|δωσέμεν|διδοῖ|δοίη|δῶκε|διδόασι|διδόντες|δόσκον|ἔδωκεν|δῷσι|δοῖεν|διδομένης|διδοῦσα|δώσει|δῷς|δὸς|διδόναι|διδόντος|δότ̓|ἔδωκαν|δεδομένην|δῶχ̓|διδοῖς|δίδωθι|δῶσιν|δῶκας|δίδωμι|διδοῦσιν|δωσέμεναι|δίδωσιν|ἔδωκας|δώῃ|δόντος|δοίης|διδόντων|δώομεν|δοῦσα|δώωσιν|ἐδίδους|διδομένην|δώσειν|δίδωσι|δότε|διδοὺς|διδούς|ἔδοσαν|δόντες|δόμεν|δόσαν|δώσεις|δοίην|δοθείη|δώσουσιν|διδώσομεν|δώσουσ̓|ἔδωκ̓|ἐδίδου|ἔδωκα|δέδοται|δῶκέν|δόμεναί|διδοῦσι|ἔδωχ̓|διδοῦναι|δῶμεν|διδοῖτε|δίδου|ἔδοσάν|δώωσ̓|δῶκεν
ἐπιθρῴσκω|ἐπιθρῴσκων
σίνομαι|σινέσκοντο|σίνοιτό|σίνηαι|σίνεται
ἀγαπάζω|ἀγαπαξόμεναι|ἀγαπαζόμεναι|ἀγαπαζόμενοι|ἀγαπαζέμεν|ἀγαπάζῃ
προκαταλαμβάνω|προκαταλαμβάνοντας|προκαταλαμβάνειν|προκαταλήψονται
προμανθάνω|προμαθὼν
ἐπιάχω|ἐπίαχον
προμάχομαι|προμάχεσθαι
εἴκω|εἴκουσι|εἴξατέ|εἴξαντες|εἶκε|εἴξαντος|εἴξῃ|εἴξειε|εἴκοι|εἴξασκε|εἶξε|εἴξοντες|εἶξαι|εἴξασα|εἶξαν|εἴκειν|εἴξας|εἴκοιεν|εἴξειαν|εἴκων|εἴκομεν|εἴξωσι|εἶξαί
ὑπείκω|ὑπόειξεν|ὑπόεικον|ὑποείξομαι|ὑπείξεαι|ὑπείκειν|ὑπόεικε|ὑποείξομεν|ὑπόειξε|ὑποείκειν|ὑπείξομαι|ὑποείξω
ἐνστάζω|ἐνέστακται
καθέζομαι|καθεζομένω|καθεζόμενοι|καθεζόμενος|καθεζώμεσθα|καθεζομένη|καθέζετο
κλέω|ἔκλἐ|κλέομαι
σωφρονέω|σωφρονῶμεν|σωφρονοῦσι
κορθύνω|κορθύεται
ἐπιπταίρω|ἐπέπταρε
καθέννυμι|καταειμένον|καταείνυσαν
ἀναφαίνω|ἀναφαίνων|ἀναφαίνεις|ἀναφαίνεται|ἀνεφαίνετο|ἀνέφαινον|ἀναφαίνειν|ἀναφῆναι
τῆ|τῆ
καταδύω|καδδῦσαι|κατεδύσεθ̓|καταδὺς|καταδῦσα|καταδῦναι|καταδύντα|καταδυσόμεθ̓|κατέδυ|κατεδύσετο|καταδύσεο|καταδύντες|καταδύντι|καταδύμεναι
συνεξέρχομαι|ξυνεξῆλθον
ἰαύω|ἰαύεσκεν|ἰαύεσκον|ἴαυον|ἰαύων|ἰαῦσαι|ἰαύειν|ἰαύεις
ἀνατίθημι|ἀντίθεόν|ἀναθήσει|ἀνέθηκε|ἀνέθεσαν
δείδω|δείδοικα|δειδίμεν|δεδίασιν|δειδιότα|δείσεσθαι|δείσας|δείσαντες|ἔδεισαν|δείδιθ̓|δείσεἰ|δείδοικας|δείσαντας|δείδιτε|ἔδεισεν|δείδισαν|δειδιότας|ἔδεισε|δειδιότων|δείσαντε|δείδιας|ἔδεισας|δεδιέναι|δείδια|δειδιότες|δείδοικε|δείσητ̓|ἐδείδιμεν|δεδιὸς|ἐδείδισαν|δέδοικα|δείσετ̓|δείδιε|ἐδείσατε|δείδω|δείσασ̓|δείσῃ|δείσειε|δεδιότες|δείδιθι|δεῖσαν|δεῖσε|δεδιώς|δείδιμεν|δεισάντων
ἀμαθύνω|ἀμαθύνει
ἔθω|εἰωθὼς|εἰωθότες|εἰώθαμεν|ἔωθεν|εἰώθεσαν|εἰωθότι|εἰωθότα|ἔθων|εἰώθασιν|ἔθοντες|εἰωθόσιν|εἴωθε
συνίημι|ξύνες|ξυνέηχ̓|ξύνιεν|ξύνετο|ξυνίεσαν|ξυνέηκε|ξυνίει|συνώμεθα
ὁμοκλέω|ὁμόκλησάν|ὁμόκλα|ὁμοκλήσαντες|ὁμοκλήσειεν|ὁμοκλήσας|ὁμοκλήσασκέ|ὁμόκλεον|ὁμόκλησαν|ὁμοκλέομεν
ἐκδιδράσκω|ἐκδιδράσκουσιν
ἀντιφέρω|ἀντεφέροντο|ἀντιφέρεσθαι
διακοσμέω|διακοσμοῦντι|διεκοσμήσαντο|διακοσμηθεῖμεν|διεκόσμεον
προσπίπτω|ποτιπεπτηυῖαι
πημαίνω|πημανθῆναι|πημήνειαν|πημαίνει|πημάνθη|πημανέειν
ἀμφινέμομαι|ἀμφινέμονται|ἀμφενέμοντο
εὐνάω|εὔνησε|εὐνηθῆναι|εὐνηθέντες|εὐνηθέντε|εὐνηθεῖσα
καταπροδίδωμι|καταπροδιδῶμεν
συγχωρέω|ξυγχωρήσετε
ὁρμέω|ὁρμηθέντες|ὥρμουν
πληκτίζομαι|πληκτίζεσθ̓
συναφίστημι|ξυναποστάντες|ξυναπέστησαν|ξυναποστήσωσι|ξυναποστῆναι|ξυναφεστῶτα
πτύσσω|πτύξασ̓|πτύξασα|ἐπτύσσοντο|πτύξασά
κατακρύπτω|κατακρύψειν|κατακρύπτουσιν|κατακρύψασ̓|κατακρύπτων|κατακρύψασα|κατακρύψας
ἀποτειχίζω|ἀποτειχισθείσης|ἀποτειχίσαντες|ἀπετείχισε
φωνέω|φώνησέν|φωνήσαντε|φωνήσαντος|φωνήσαντες|φωνήσασα|φωνήσασ̓|φωνήσας|ἐφώνησεν|φωνησάσης
ἐπαναχωρέω|ἐπαναχωρῶν|ἐπανεχώρει|ἐπανεχώρουν
ἐφομαρτέω|ἐφομαρτεῖτον|ἐφομαρτεῖτε
ἡγεμονεύω|ἡγεμονεύῃ|ἡγεμόνευεν|ἡγεμονεύσω|ἡγεμονεύειν|ἡγεμόνεὐ|ἡγεμόνευε|ἡγεμονεύει|ἡγεμονεύῃς|ἡγεμονεύσει
μεταποιέω|μεταποιεῖσθαι
ξενίζω|ξείνισσας|ξείνισσε|ξεινίσσομεν|ξείνισ̓|ξεινίσαι|ξεινίζειν|ξείνισσεν|ἐξείνισσα|ξείνισας
ἐπιτηδεύω|ἐπετήδευσαν
σύγκειμαι|ξύγκειται
ἀτυχέω|ἀτυχῶσιν
κατορθόω|κατωρθώθη|κατορθοῦντας
προσδέομαι|προσδέονται|προσέδει
ὀργίζω|ὀργισθῆναι|ὀργισθεὶς|ὀργίζεσθαι|ὀργισθέντας|ὀργίζονται
στρατηγέω|ἐστρατήγει|στρατηγοῦντος
πείρω|πεῖραν|πεῖράν|ἔπειρε|πείροντες|πειρώμεσθα|ἔπειρεν|πείρων|ἔπειρον|πεπαρμένος|πεῖρε|ἔπειραν|πεῖρεν|πεπαρμένον|πεπαρμένη
σύνοιδα|ξύνιστε|ξυνειδότων
δέατο|δέατ̓
παραβοηθέω|παραβεβοηθηκότες
ὑποφεύγω|ὑποφεύγειν
ἀρτύνω|ἀρτύνετο|ἀρτύνοντας|ἀρτύναντες|ἠρτύναντο|ἀρτυνέουσιν|ἤρτυνον|ἀρτύναντε|ἀρτύνθη
ἐγρήσσω|ἐγρήσσοντα|ἐγρήσσεις|ἐγρήσσοντες
κατερύκω|κατερύκανε|κατερύκεται|κατέρυκες|κατερύκει|κατερύκομαι|κατερύκω|κατέρυκε
κνώσσω|κνώσσουσ̓
γαμέω|γῆμεν|ἔγημε|γῆμαι|γήμας|γῆμ̓|γήμασθαι|γαμέοντί|γήμασθ̓|ἔγημεν|γαμέεσθαι|γαμέειν|γημαμένη|ἐγεγαμήκει|γήμαιθ̓|γήμαντα|γαμέω
ἀναισχυντέω|ἀναισχυντῶσιν
πυρακτέω|ἐπυράκτεον
ἀπολέπω|ἀπολεψέμεν
ὁδεύω|ὁδεύειν
προκατάρχομαι|προκαταρχόμενοι
οὐτάζω|οὔταζον|οὐτάσῃ|οὐτάζοντο|οὐτάζων|οὔτασε|οὔτασεν|οὔτασται|οὐτασμένος|οὐτάσαι|οὔτασ̓
ἐξαποδίω|ἐξαποδίωμαι
ἀπόμνυμι|ἀπώμνυ|ἀπώμοσα|ἀπώμνυεν|ἀπώμνυον
ἐπεγείρω|ἐπεγρόμενος|ἐπέγρετο|ἐπέγειρε
βυσσοδομεύω|βυσσοδομεύων|βυσσοδόμευον
ἀκέομαι|ἀκέοντό|ἀκεώμεθα|ἠκέσατ̓|ἀκειόμενον|ἄκεσσαι|ἀκέσασθε|ἀκειόμενοι
ἀπαρέσκω|ἀπαρέσσασθαι|ἀπαρέσκοιμεν
παραφεύγω|παρφυγέειν
δυσωρέομαι|δυσωρήσωνται
φορύνω|φορύνετο
μαστίζω|μάστιξέν|μάστιξεν
ἴσχω|ἴσχε|ἴσχωσι|ἰσχέμεν|ἴσχεσθ̓|ἴσχειν|ἴσχων|ἴσχεο|ἴσχεσθε|ἴσχεν|ἴσχουσ̓|ἰσχέμεναί|ἴσχει|ἴσχεσθαι|ἴσχετο|ἴσχον
θοόω|ἐθόωσα
παφλάζω|παφλάζοντα
προσπαρέχω|προσπαρασχών
ἀπομόργνυμι|ἀπομόρξατο|ἀπομόργνυ|ἀπομορξαμένω
προσμυθέομαι|προτιμυθήσασθαι
διαμέλλω|διαμέλλωσιν|διαμέλλετε
περιηχέω|περιήχησεν
βαστάζω|βαστάζοντα|ἐβάστασε
ἔννυμι|ἕσσο
ἀρχεύω|ἀρχεύειν|ἄρχεὐ
θερμαίνω|θερμήνῃ|θερμαίνοιτο
συναιρέω|σύνελεν|ξυνελὼν|συνελὼν
ὑποζεύγνυμι|ὑποζεύξω
τολυπεύω|τολυπεύω|τολύπευσε|τολυπεύειν|τολύπευσα|τολύπευσεν
παρελαύνω|παρελάσσαι|παρήλασε|παρέλασσ̓|παρήλασαν
δυσμενέων|δυσμενέοντες
ἐπιθαρσύνω|ἐπιθαρσύνων
παρακρεμάννυμι|παρακρεμάσας
μέτειμι|μετέσσεται|μετείην|μετείω|μετέῃσιν|μετέασι|μέτεισι|μετέσσομαι|μέτειμι|μετὸν|μετείη|μετεῖναι|μετέω|μετέμμεναι
προσέρχομαι|προσελθόντων|προσελθόντες
φράζω|πέφραδε|φράζευ|φράζεσθαι|φραζώμεθ̓|πέφραδ̓|φραζέσθω|φρασσόμεθ̓|πεφραγμένοι|φράζεσθ̓|φράσεται|πεφραδέμεν|φράζεο|φραζόμεθ̓|φράσαι|φράζεσθον|φράζετο|φραζώμεθα|ἐφράσαθ̓|ἐπέφραδον|πεφράδοι|φρασάμην|φράσσαντ̓|φράζονται|φράζει|φραζομένῳ|φράσσομαι|φράσε|φράζωνται|φραζέσθην|πεφραδέειν|φραζοίμεθα|ἐφράσατο|πέφραδέ|ἔφρασε|ἐφρασάμην|φράσσαντο|φράσσονται|ἐπέφραδε|φραζώμεσθ̓|ἐφράσθης|φράζεσθε|ἐφράσσαντο|φράσσατο|φράσατο|φράσσαντό|φράσομαι|ἐπέφραδεν|φράζεαι|φραζομένη|φράσσεται|ἐφράσσατο
χατίζω|χατίζεις|χατίζων|χατίζει
ὁμαρτέω|ὁμαρτήσανθ̓|ὁμαρτήσειεν|ὁμαρτήσαντες|ὁμαρτέων
οἰκίζω|οἰκιοῦντες|ᾠκίσθησαν|οἰκισθείσης|οἰκίζοντες|ᾤκισαν
προσστείχω|προσέστιχε
διαζώννυμι|διεζωμένοι
συμφέρω|ξυνενεχθῆναι|ξυμφέροντα|ξυμφέρον|συνοισόμεθα|ξυμφέρει|συμφερόμεσθα|ξυμφέροιεν|ξυνηνέχθη
ὑποφθάνω|ὑποφθὰς|ὑποφθαμένη|ὑποφθάμενος
φθέγγομαι|φθέγξατο|φθεγξαμένη|φθέγγοντο|φθέγξομ̓|φθεγξαμένου|φθεγξάμενος|φθέγξατ̓|φθεγγομένου|φθεγγώμεθα|φθεγξάμενός|φθέγγεο
διαμάχομαι|διαμάχεσθαι
ἀπολούω|ἀπολούσομαι
ἀποστείχω|ἀπέστιχον|ἀπέστιχε|ἀπόστιχε|ἀποστείχειν
τιθαιβώσσω|τιθαιβώσσουσι
περάω|περήσῃς|περῆσαι|περόωσι|περησέμεναι|ἐπέρησε|περήσω|πέρασαν|περάαν|ἐπέρασσε|περάασκε|περήσαμεν|περήσειν|ἐπέρησεν|περῶντα|περάσητε|ἐπέρασσας|πέρησε|περόωσιν|ἐπέρησα|πέραον|ἐπέρασσα|περάσειε|ἐπέρασσαν|πέρησεν
ἐποχέομαι|ἐποχήσεται
δύναμαι|δυνάμενοι|δυνήσεται|δυνήσατο|δυνάμεσθα|δύνανται|δυνήσεαι|δύναιτό|δυναμένοιο|ἐδυνήσατο|δυνηθῶσιν|δύνατο|ἐδυνάσθη|δυνάσθη|δύναντο|δύνασθαι|δυνησόμεθ̓|δυναίμην|ἐδύνατο|δύναται|δύνασθε|δυνήσομαι|δυναμένους|δύναμαι|δύνατ̓|δύνασαί|δύναταί|ἐδύναντο|δυνάμενος|δυνάμην|δύναμ̓|δύνωνται|δύνασαι|δύναιο|ἐδύνασθε|δύνηαι
ἀφίημι|ἀφεῖτε|ἀφέντες|ἀφιέναι|ἀφιεῖσαι|ἀφέηκεν|ἀφῶσιν|ἀφέῃ|ἀφήσομεν|ἀφεῖναι|ἀφέηκε|ἀφῆκεν|ἀφίετο|ἀφήσω|ἀφείη|ἀφέτην|ἀφήῃ|ἀφῆκε|ἀφίει
προσδέρκομαι|προσεδέρκετο|ποτιδέρκεται
θηρεύω|θηρεύοντ̓
ἀμφιτρομέω|ἀμφιτρομέω
αὐξάνω|ηὔξετο|ηὐξήθησαν|αὐξηθῆναι|αὔξειν
προγίγνομαι|προγένοντο|προγεγενημένα|προυγεγένηντο|προυγεγένητο|προγεγενημένων
στρέφω|στρεφθέντος|ἔστρεφε|στρέψ̓|στρεφθέντε|στρέψαντα|στρεφθέντι|στρέψασκον|στρέψεσθ̓|στρέψαι|στρέψαντες|στρεφθεὶς|ἐστρέφετ̓|στρέψας|στρέψαν|ἔστρεφον|στρέφει|στρεφθεῖσ̓|στρέφεται
εἰσακούω|ἐσακούωσιν|ἐσακούωσι|ἐσάκουσε|ἐσακούωσί
ἐσθίω|ἔδονται|ἔσθἰ|ἤσθιεν|ἐσθιέμεν|ἐσθίετε|ἔσθιε|ἐσθίει|ἤσθιε|ἐσθίεταί|ἤσθιον
διαλέγω|διελέξατο
πορθέω|ἐπόρθεον|πόρθεον|πορθεῖν
διέπω|διέπουσ̓|δίεπε|δίεπ̓
ἐγείρω|ἔγροιτο|ἐγείρομεν|ἔγειρε|ἤγειραν|ἐγεῖραι|ἐγρήγορθαι|ἔγρεο|ἐγείρει|ἐγειρομένων|ἐγρόμενος|ἔγειρεν|ἐγείρῃσιν|ἐγείρειαν|ἐγρηγόρθασι|ἐγείρῃ|ἐγρήγορθε|ἤγειρας|ἔγρετο
πορεύω|πορεύεσθαι|πορευθεὶς|ἐπορεύθησαν|πορευθῆναι|ἐπορεύοντο|πορευόμενοι|πορευομένοις|πορευόμενον
πήγνυμι|ἐπεπήγει|πῆξαι|πῆξεν|πάγη|ἔπηξε|πήξῃ|πῆξε|πεπήγει|πάγεν|πήγνυτ̓|πέπηγεν|πήγνυται|ἐπάγη|πήξαμεν|ἔπηξεν|πῆξαί|πήξεις|πῆχθεν|πήξας|πήξαντ̓
ἀποσκεδάννυμι|ἀπεσκέδασ̓|ἀπεσκέδασεν
ἀπάλαλκε|ἀπαλάλκοι|ἀπάλαλκε
ἀνανέομαι|ἀννεῖται
αἴρω|ἄροιο|ἄρασθαι|ἄρηται|ἤρατο|ἄροιτο|ἀρόμην|ἄραντες|ἤρἀ|ἤρατ̓|αἴροντας|ἤρθη|ἀραμένοις|ἀρέσθ̓|ἀραμένους|ἄρησθε|ἄρωσιν|ἀρέσθαι|ἠράμεθα|ᾔρετο|ἀρθείς|ἄροντο|ἀρθεὶς|ἦρτο|ἀροίμην|ἄρετ̓|ἄρηαι
μεγαίρω|μεγήρῃς|μέγηρε|μεγήρας|μεγαίρω
καταπήγνυμι|κατέπηξαν|κατέπηκτο|κατέπηξεν
ἀμφιπένομαι|ἀμφεπένοντο|ἀμφιπένονται
ποτιπτύσσω|προσπτύξομαι|ποτιπτυσσοίμεθα|προσπτύξεται|προσπτύξατο
πηδάω|πηδῆσαι|ἐπήδα
τέτμον|ἔτετμε|τέτμεν|τέτμῃς|ἔτετμεν|τέμει
ἀπαμάω|ἀπαμήσειε
αἰνέω|ᾔνεον|αἰνεῖτον|αἴνεε|αἰνήσωσι|ᾔνησ̓|αἰνεῖτ̓|αἰνήσουσιν|αἰνήσωσιν
ὑποκλοπέομαι|ὑποκλοπέοιτο
ἐπικόπτω|ἐπικόψων
πάρημαι|παρήμενον|παρημένω|παρήμενος|παρήμενοι
ἀπερωέω|ἀπερωήσειας
ζώω|ζώεις|ζώοντος|ζωόντων|ζώω|ζώοντός|ζώουσι|ζώουσ̓|ζωέμεν|ζώουσιν|ζώοντας|ζωέμεναι|ἔζωον|ζώοντες|ζώει|ζώειν|ζώοντε
ὀιστεύω|ὀΐστευσον|ὀιστεύσας|ὀϊστεύοντα|ὀϊστεύσας
ἐκφθίνω|ἐξέφθιτο
διαμετρέω|διεμέτρεον
διαπορεύω|διαπορεύσονται
κευθάνω|ἐκεύθανον
ἑάφθη|ἑάφθη
ἔκφημι|ἐκφάσθαι
εὑρίσκω|εὕρωσιν|εὑρίσκεσθαι|ηὗρον|εὕρῃσι|εὗρεν|εὑρεῖν|ηὕρισκον|εὗρε|εὕρομεν|εὕρωμεν|εὑρὼν|εὕροιμι|εὕρητε|ηὕροντο|εὕρετο|εὑρίσκω|ηὗρεν|ηὑρῆσθαι|εὗῤ|εὗρον|ηὑρίσκετο|εὕροιτε|εὑροίμην|εὑρέμεναι|εὕρεο|εὕρῃ|εὕροιμεν
ἀναρρίπτω|ἀνερρίπτουν|ἀνέρριψαν|ἀναρρίπτειν
ἐπορούω|ἐπόρουσα|ἐπορούσας|ἐπόρουσαν|ἐπόρουσε|ἐπόρουσεν
ὀλιγοδρανέων|ὀλιγοδρανέων
φυλάζω|φυλάξομεν
ἀντάω|ἀντήσειε|ἤντεον|ἀντήσω|ἀντήσομεν|ἤντησ̓|ἤντησας|ἠντήσατε
κάτειμι|κατιοῦσαν|κάτειμι|κάτεισι|κατιοῦσα|κατίμεν|κατήιεν|κατιόντα
περιγνάμπτω|περιγνάμπτοντα
περιποιέω|περιποιησάμενον|περιεποιήσαντο
ἀποθρώσκω|ἀποθρῴσκοντα
ἀελπτέω|ἀελπτέοντες
βιβρώσκω|βεβρώσεται|βεβρωκὼς|βεβρώθοις
σκηνόω|ἐσκήνωσαν
ἐγκονέω|ἐγκονέουσαι
ἀμφιπέλομαι|ἀμφιπέληται
εὐρύνω|εὔρυναν
ἐπαγείρω|ἐπαγείρειν
μεταγράφω|μεταγράψαι
ἀνθέω|ἤνθησαν|ἀνθῆσαι
ἐπέοικε|ἐπέοικε|ἐπέοικεν|ἐπεῴκει|ἐπέοιχ̓
ὑπερικταίνομαι|ὑπερικταίνοντο
ἐπηπύω|ἐπήπυον
κατηπιάω|κατηπιόωντο
στρωφάω|στρωφᾶτ̓|στρωφῶσα|στρωφᾶσθ̓|στρωφῶσιν|στρωφᾶσθαι|στρωφῶσ̓
ἐκγίγνομαι|ἐξεγένοντο|ἐκγεγάτην|ἐκγεγαυῖα|ἐκγεγαῶτι|ἐκγεγάμεν
ζεύγνυμι|ζεῦξεν|ζεῦξ̓|ζεύγνυον|ζεύξαθ̓|ζεύξῃ|ζεύγνυσθ̓|ζεύγνυσαν|ζευγνύμεναι|ζευγνῦμεν|ζεῦξαι|ζεῦξαν|ζευγνύσθην|ἔζευξαν|ζεῦξον|ἐζευγμέναι|ζευγνύμεν|ζεύξαντές|ζεῦξάν|ζεύγνυντ̓|ζεύξειεν|ζεύξασ̓
περιμαιμάω|περιμαιμώωσα
ἐπιχειρέω|ἐπεχείρησεν|ἐπεχείρεον|ἐπιχειρῆσαι|ἐπεχείρησε|ἐπιχειρήσειν|ἐπιχειρεῖν
ἐπικαλέω|ἐπεκαλοῦντο|ἐπικαλοῦντες|ἐπεκαλέσαντο|ἐπικαλοῦνται
ἐπέρχομαι|ἐπερχομένη|ἐπελθὼν|ἐπέρχονται|ἐπέλθῃ|ἐπελθόντες|ἐπερχομένους|ἐπήλυθε|ἐπῆλθεν|ἐπῆλθε|ἐπέρχεαι|ἐπέλθωσιν|ἐπελθών|ἐπέλθῃσιν|ἐπήλυθεν|ἐπερχόμενον|ἐπελεύσεσθαι|ἐπερχόμεναι|ἐπελθεῖν|ἐπέρχεται|ἐπήλυθον|ἐπέλθω|ἐπῆλθον|ἐπελήλυθα|ἐπέλθοι|ἐπερχομένων
συναγωνίζομαι|ξυναγωνιουμένης|ξυναγωνίζεσθαι
βιόω|βιώτω|βιῶναι
τηλεθάω|τηλεθόωντα|τηλεθάον|τηλεθόωσαν|τηλεθόωσα|τηλεθόωσαι|τηλεθάοντας
ἀνέρχομαι|ἀνελθὼν|ἀνερχομένῳ|ἀνελθών|ἀνερχόμενον|ἀνήλυθεν
ἐντύνω|ἐντυναμένη|ἐντύνοντο|ἔντυνον|ἐντυνόμενοι|ἐντυνώμεθα|ἐντύνεαι|ἐντύνασαν
ἀποξύνω|ἀποξύνουσιν|ἀποξῦναι
ἧμαι|εἵατο|ἥσθην|ἥμην|ἥμεθ̓|ἥατ̓|ἕατ̓|εἵαθ̓|ἧστ̓|ἧσται|ἧμαι|ἧσθαι|ἥμεθα|ἧσθ̓|ἥμενοι|εἵατ̓|ἧσο|ἧσαι|ἧστο|ἧσ̓|ἕαται|εἵαται|ἥμενος|ἥατο|ἧστό|ἥμεναι|ἥμενον|ἡμένη
δειελιάω|δειελιήσας
μεταγιγνώσκω|μετέγνωσαν
εἶπον|εἰπόντος|εἰπόντι|εἶπέ|εἰπέμεν|εἰπέμεναι|εἰπέμεναί|εἴποιμ̓|εἴποιμι|ἔειπες|εἰπὼν|εἰπόντα|εἰπόντας|εἶπας|εἴπαθ̓|εἰπόντ̓|εἴπεσκε|εἴπῃσιν|εἰπόνθ̓|εἶπον|εἴποις|ἔσπετε|εἴφ̓|εἴπ̓|εἶπεν|εἰποῦσιν|εἴπῃ|εἰποῦσα|εἰπέ|εἴπω|εἰπὲ|εἰπών|εἶπες|εἰπόντε|εἴπῃς|εἴπομεν|εἴπῃσι|εἰπὸν|εἴπῃσθα|ἔειπον|εἰποῦσ̓|εἴπεσκεν|εἰπόντες|εἴπατε|εἴποι|εἰπεῖν|ἔειπεν|ἔειπε|εἶπε|εἴπωμι
ἀναδέχομαι|ἀνεδέγμεθ̓|ἀνεδέξατο
πελεμίζω|πελεμίχθη|πελεμίξαι|πελεμίζετ̓|πελεμιζέμεν|πελέμιξεν|πελέμιζεν
ὑπεξάγω|ὑπεξαγάγοι
διάημι|διάει|διάη
ἰαίνω|ἰαίνει|ἰανθῇς|ἰάνθη|ἰάνθης|ἰήνατε|ἰαίνεται|ἰανθῇ|ἰαίνετο|ἰήνῃ|ἰαίνομαι
ἐπαρκέω|ἐπήρκεσε|ἐπήρκεσεν
ἐγκύρω|ἐνέκυρσε
θάπτω|θάπτουσιν|ἐτέθαπτο|θάπτοι|θάπτειν|θάψαν|θάπτέ|θάπτομεν|θάπτωσιν|θάπτοιμεν|θάπτον
ὑποτρέω|ὑποτρέσαι|ὑπέτρεσαν|ὑπέτρεσας
μετασσεύομαι|μετεσσεύοντο
ὑποσείω|ὑποσσείουσιν
παρίημι|παριέναι|παρῶμεν|παρείθη
κάθημαι|κάθησο|καθήμεναι|καθῆστο|καθήμενοι|ἧντ̓|καθήατο|καθημένω|καθήμενος|ἧμαι|καθήμενον
διαβαίνω|διέβησαν|διαβεβηκότος|διαβήμεναι|διαβάς|διαβὰς|διαβάντες|διαβαινέμεν
ὀμόργνυμι|ὠμόργνυντο|ὀμορξαμένην|ὀμορξάμενος|ὀμόργνυ|ὀμορξάμενον
ὑπεκπροθέω|ὑπεκπροθέει|ὑπεκπροθέοντα|ὑπεκπροθέων
ἀποδιδράσκω|ἀποδράς|ἀπέδρασαν|ἀποδρὰς
χαλεπαίνω|χαλεπαίνοι|χαλεπαίνει|χαλεπήνῃ|χαλεπαίνειν|χαλεπῆναι|χαλέπαινε|ἐχαλέπαινον|χαλεπαίνων
ἀνασπάω|ἀνεσπάσατ̓
ἰδυῖα|ἰδυῖα|ἰδυίῃσι
κομέω|ἐκόμει|κομέειν|κομείτων|κομέεσκεν|κομέουσι|κομέουσιν|κομείτην
συναείρω|συναείρεται
προσφωνέω|προσεφώνεον|προσεφώνεεν|προσεφώνεε
ὑφηγέομαι|ὑφηγῆσθε
αἴνυμαι|αἰνυμένους|αἴνυτο|ᾔνυτο|αἰνυμένῳ|αἰνύμενος|αἴνυται|αἰνύμενοι|αἴνυτ̓|αἰνύμεναι
παραίσσω|παρήϊξαν|παρήϊξεν|παραΐσσοντος
ἐκποτάομαι|ἐκποτέονται
δίω|δίε|δίοιτο|δίεσθαι|δίωμαι|δίωνται
ἐγγείνωνται|ἐγγείνωνται
ἀνασκευάζω|ἀνασκευασάμενοι
ξηραίνω|ξηράνας|ἐξηράνθη
κροταλίζω|κροτάλιζον
διαγλάφω|διαγλάψασ̓
προίστημι|προστήσας
διαβιβάζω|διεβίβασαν
ἱκετεύω|ἱκέτευσα|ἱκέτευσας|ἱκέτευσε|ἱκέτευσ̓|ἱκέτευεν
ἀγοράομαι|ἀγορήσατο|ἀγοράασθε|ἠγοράασθε|ἠγορόωντο
μαραίνω|ἐμαράνθη|ἐμαραίνετο
βιάω|βιῴατο|βεβίηκεν|ἐβιήσατο|βιόωντό|βιησάμενος|βιόωνται|βιήσεται|βιασάμενοι|βιήσατο
συγκυρέω|συγκύρσειαν
ὀαρίζω|ὀάριζε|ὀαρίζετον|ὀαριζέμεναι
καταπτώσσω|καταπτώσσοντ̓|καταπτώσσοντες|καταπτώσσουσι|καταπτώσσειν
χώομαι|χώεο|χωόμενον|χωομένη|χωόμενος|χωόμενός|χωσαμένη|χώσατ̓|χωομένου|χωομένῳ|χώεται|χώσεται|χώσατο|χωομένης|χωομένοιο|χώετο|χωσάμενος|χωόμενοι|ἐχώσατο
καπύω|ἐκάπυσσε
κατεργάζομαι|κατεργάζεσθαι
κατεπείγω|κατήπειγεν
ἐπιδημέω|ἐπιδημῶν
φεύγω|φύγοιμεν|φύγοι|φύγῃ|ἔφυγες|φύγοιμι|φυγόντι|φύγον|πεφευγότες|φεύγοντος|φεύγοντες|φευγέμεναι|πεφυγμένος|φεύγεσκεν|φεύξεσθαι|φεύξομαι|φεῦγε|φυγέειν|φεύγοντας|φεύγεις|φεύγοντι|φεύγω|φεύγειν|πεφυγμένον|φύγομεν|φύγῃσι|φεύγετε|φυγόντε|φεῦγον|ἔφευγε|φύγεσκε|φεύξονται|φυγόντες|φύγε|φυγεῖν|φεύγων|πεφεύγοι|φύγῃσιν|φεύγει|φύγωμεν|φεῦγ̓|φευγέμεν|φευγόντων|πεφυζότες|φύγεν|φυγὼν|ἔφυγον|φεύγοντα|φεύγωμεν|φυγόντα|φεύξεσθ̓|φεύγοντ̓
κήδω|κήδων|κηδόμενόν|κηδομένῳ|κεκαδησόμεθ̓|κήδεσθαι|κηδόμενοί|κήδετο|κήδοιτό|ἔκηδε|κήδοι|κηδομένη|κηδέσκετο|κήδεται|κηδήσοντες|κήδει|κήδονται|κήδειν|κῆδε|κήδῃ|κήδοντο|κήδεαι|κήδεσκον|κηδόμενός
ἐξευρίσκω|ἐξεύροι
ἐπικέλλω|ἐπικέλσαι|ἐπικέλσαντας|ἐπέκελσεν
ἐξυπανίστημι|ἐξυπανέστη
ἀναστρέφω|ἀνστρέψειαν|ἀναστρέφομαι
ἀποστυφελίζω|ἀπεστυφέλιξεν|ἀπεστυφέλιξαν
ποντοπορέω|ποντοπορούσης
ἐρεύθω|ἐρεύθων|ἐρεῦσαι
ἐξαίρω|ἐξήρατ̓|ἐξήρατο
κατέδω|κατέδουσι|κατέδων|κατεδόντων|κατέδουσιν|κατέδονται
προκαταφεύγω|προκαταφυγεῖν
ἀντιπαρατάσσομαι|ἀντιπαρετάξαντο|ἀντιπαρετάσσοντο
ὑποκλονέομαι|ὑποκλονέεσθαι
κατεῖδον|κατιδόντες|κατεῖδον
ἐφέλκω|ἐφέλκετο|ἐφέλκεται|ἐφέλκεσθαι|ἐφελκομένοισι
ἐκπέμπω|ἐκπέμπειν|ἐξεπέμποντο|ἐξέπεμψαν|ἐξέπεμψε|ἐκπέμπονται|ἐκπέμψῃσι|ἐκπέμπουσιν|ἐκπέμπεις|ἐκπέμψειε|ἐκπέμψασθε|ἔκπεμψάν|ἐκπεμφθεῖεν|ἔκπεμπε|ἐξεπέμφθη
ἀγνοέω|ἀγνώσασκε|ἀγνοοῦντες|ἠγνοίησεν|ἀγνοιῇσι|ἀγνοιήσασ̓
ἐπιγνάμπτω|ἐπιγνάμψας|ἐπέγναμψεν|ἐπιγνάμψασα|ἐπιγνάμπτει
ἐπιγίγνομαι|ἐπιγιγνόμενα|ἐπιγιγνομένοις|ἐπιγίγνεται|ἐπεγένετο
ἀναβρόχω|ἀναβροχέν|ἀναβρόξειε
ἀνδραποδίζω|ἠνδραπόδισαν|ἀνδραποδίσαντες
ἀποδειροτομέω|ἀποδειροτομήσω|ἀπεδειροτόμησα|ἀποδειροτομήσειν
στυφελίζω|στυφελίξαι|ἐστυφέλιξεν|στυφελίζειν|στυφελιζομένους|στυφελίζετε|ἐστυφέλιξε|στυφελίξῃ|στυφέλιξε|ἐστυφέλιξαν
φάσκω|ἔφασκες|φάσκεν|ἐφάσκεθ̓|φάσκ̓|φάσχ̓|φάσκε|ἔφασκεν|ἔφασκον|φασκόντων|ἔφασκε
λάω|λάων|λῆθ̓|λάε
βούλομαι|βουληθέντες|βούλεαι|βουλήσονται|βούλεσθ̓|βούλοντο|βόλεται|βούλοιντο|βουλόμεθα|ἐβούλοντο|βούλετο|βούλομ̓|βουλομένων|βουλόμενος|βουλόμενον|βούλεται|βουλόμενοι|ἐβόλοντο|βούλονται|βουλοίμην|ἐβουλήθησαν|βούλεο|βουλομένοις|βούλεσθαι|ἐβούλετο|βούλομαι|βόλεσθε|βούλεσθε
εἰσπέτομαι|εἰσέπτατο
γράφω|γραφέντα|γράφειν|γράψεν|ἔγραψα|γράψας
κολάζω|κολάζειν|κολάζεσθαι
ἠλασκάζω|ἠλασκάζει|ἠλασκάζων
κεῖμαι|κέσκετ̓|κειμένῳ|κεῖσθαι|κεῖταί|κείμεν̓|κείσεθ̓|κεῖτ̓|κείμενος|κείμην|κεῖντο|ἔκειτο|κείμενον|κειμένου|κείμεθα|κείσοντ̓|ἐκείμην|ἐκείμεθα|κεῖτο|κείσθω|κεῖται|κέατο|κείσομαι|κέων|κείσεαι|κείσεταί|κέατ̓|κείμενα|κείμεθ̓|κειμένη|κείσεται|κεῖθ̓|κεῖσο|κείσομ̓|κέαται|κεῖσαι|κείατ̓|κέονται|κεῖμαι
ἀμφαγείρομαι|ἀμφαγέροντο
καταπλέω|κατεπλέομεν|κατέπλεον|καταπλεόντων
προυπάρχω|προϋπάρχουσαν
συντίθημι|σύνθετο|ξυνέθεσαν|σύνθεο|ξυνθέμενοι|σύνθεσθ̓|ξυνετίθεσαν
γανόω|γανόωντες
ἐκτείνω|ἔκτειναν
ἐμφύω|ἐμπεφύασι|ἐμπεφυυῖα|ἐνέφυσεν
κωλύω|κωλύσονται|κωλύει|κωλύοιντο|κωλύειν|ἐκώλυον|κωλύσοντες|κωλύσειν|κεκωλύσθω|κωλύομεν|κωλύωνται
ἐπελαύνω|ἐπέλασσε|ἐπέλασσαν|ἐπέλασσέ|ἐπέλασσεν|ἐπελήλατο|ἐπέλασσα
πετάννυμι|πέπτατο|πετάσειε|πέπτανται|πέτασσαν|πετασθεῖσαι|πεπταμένας|πετάσθησαν|πετάσσας|πέτασαν|πέπταται|πέτασ̓
ἀντεπιτειχίζομαι|ἀντεπιτετειχισμένων
θαμβέω|θάμβησαν|θάμβησεν|ἐθάμβεον|θάμβησέν|θαμβήσαντ̓|θάμβησάν|θαμβήσασα|θάμβησε
ὑποβάλλω|ὑββάλλειν|ὑπέβαλλεν
ἐνδίημι|ἐνδίεσαν
προβιβάζω|προβιβῶντι|προβιβῶντος
καρκαίρω|κάρκαιρε
ὀρούω|ὄρουσαν|ὄρουσ̓|ὄρουσεν|ὄρουσε|ὀρούσας
ἀλύω|ἀλύων|ἀλύουσ̓|ἀλύεις
πειράω|πειρήσεσθε|ἐπειρήσαντο|πειρήσαιτο|πειρήσατο|ἐπειρήσαντ̓|πειρήσαντο|πειρήσεαι|πειρήσεσθαι|πειρωμένη|πεπείρανται|πειρῶντο|πείρησαι|πειρηθεῖμεν|πειρηθείης|πειρηθῶμεν|πειρησαίμεθα|πειρήσεσθον|πείρα|πειράσαντες|πειρῷντ̓|πειρηθῆναι|πειρώμενος|πειρηθήτω|πειρῷντο|πειρηθῆτον|πειρήσασθε|πειρηθήμεναι|πειρῶσιν|πειρᾶσθε|πεπείρημαι|πειρήσομαι|πειράτω|ἐπειρῶντ̓|ἐπειρᾶτο|ἐπειρήσανθ̓|πειρήθη|πειρᾷ|πειρήσαιτ̓|πειρήσεται|πειρήσοντα|πειρᾶται|πειρᾶν|πειρήσομ̓|πειρασόμεθα|πειρήσω
ἀνέχω|ἀνέσχεν|ἀνέχει|ἀνασχέμεν|ἀνέσχετο|ἀνασχόμενος|ἀνασχών|ἀνέσχον|ἀνεχοίμην|ἀνέσχε|ἀνασχὼν|ἀνέσχεθε|ἄνεχ̓|ἀνασχέσθαι|ἀνασχόμενοι|ἀνέξομαι|ἀνίσχοντες|ἀνεσχέθομεν|ἀνέχεσθαι|ἀνέχῃσι|ἀνασχομένω|ἀνέχουσιν|ἀνασχοίμην|ἀνάσχεο|ἀνέχοιτο|ἀνέχονται|ἠνείχοντο|ἄνσχεο|ἀνσχεθέειν|ἀνσχήσεσθαι|ἀνασχεῖν
στεῦμαι|στεῦτ̓|στεῦτο|στεῦται
σκεπάω|σκεπόωσι
ἐξεργάζομαι|ἐξείργασται|ἐξείργασθέ
ἀπαμείβομαι|ἀπαμειβόμενος|ἀπαμειβόμενον|ἀπαμειβόμενοι|ἀπαμείβετο
κυκλέω|κυκλήσομεν
ἐξαπονέομαι|ἐξαπονέεσθαι
ἐπιρρέω|ἐπιρρέει|ἐπέρρεον
ἐπιμαίομαι|ἐπεμάσσατ̓|ἐπιμαίεο|ἐπεμαίετ̓|ἐπιμασσάμενος|ἐπιμασσαμένη|ἐπεμαίετο
θρυλίσσω|θρυλίχθη
ἀμφικεάζω|ἀμφικεάσσας
ἀπείργαθον|ἀποέργαθεν|ἀποέργαθε
δοκόω|δοκοῦντα|δοκοῦν
ἐπιταλαιπωρέω|ἐπιταλαιπωρεῖν
τορνόομαι|τορνώσαντο|τορνώσεται
καταδιώκω|καταδιώξαντες|κατεδίωξαν
ἐπιλάμπω|ἐπέλαμψε
φοβέω|φοβηθεὶς|πεφόβημαι|φοβοῦντες|φοβηθείς|ἐφόβησας|πεφοβημένοι|φοβουμένων|φοβηθέντες|φόβηθεν|φοβήσομαι|φοβῆσαί|φοβέειν|φόβησεν|ἐφόβησε|φοβέεσθαι|φοβεῖ|ἐφοβήθησαν|ἐφόβηθεν|φοβεύμενος|ἐφοβοῦντο|φοβέουσι|φοβούμενοι|φοβῆσαι|ἐφοβεῖτο|φοβέοντο|φοβεῖται|φοβηθῆναι|φοβῆσον|πεφοβημένος|πεφοβήατο
ἀποφέρω|ἀποίσειν|ἀπένεικας|ἀπένεικαν|ἀποίσετον
καινόω|κεκαίνωται
ἀνηκουστέω|ἀνηκούστησεν|ἀνηκουστεῖν
κόπτω|κόψε|κόπτοντες|κεκοπὼς|κεκόπων|κόψας|κόψατο|κόψεν|κόψ̓|ἔκοψα|κόπτων|κόπτον|κόπτε|κόπτ̓
τειχίζω|ἐτειχίσαντο|τειχίζεταί|ἐτειχίσθησαν|τειχίζειν|τετείχισται|ἐτειχίσσαντο|ἐτείχισαν
ἀλέξω|ἀλεξήσεις|ἀλεξέμεναι|ἀλεξήσειν|ἀλεξέμεν|ἀλεξόμενοι|ἀλέξασθαι|ἀλεξώμεσθα|ἀλεξήσοντα|ἀλεξήσειε
τετραίνω|τέτρηνεν|τέτρηνε|τέτρηνα
βιώσκομαι|ἐβιώσαο
ἀποβάλλω|ἀποβαλών
σφηκόω|ἐσφήκωντο
τρύχω|τρυχόμενοι|τρυχόμενός|τρυχώμεθα|τρύξοντα|τρύχουσι
ὑπαλύσκω|ὑπάλυξε|ὑπάλυξας|ὑπαλύξαι|ὑπαλύξας|ὑπάλυξεν
ἐπαυρέω|ἐπαύρωνται|ἐπαυρίσκοντ̓|ἐπαύρῃ|ἐπαύρηαι|ἐπαυρεῖν|ἐπαυρέμεν|ἐπαυρήσεσθαι
κιθαρίζω|κιθάριζε
σφάζω|σφάξ̓|ἔσφαξαν|σφάζουσι|ἔσφαξάν|ἐσφαγμένα|σφάξεν|σφαζομένων|σφαζόμενοι|ἔσφαζον
ἀπαράσσω|ἀπάραξε|ἀπήραξεν
σφαραγέομαι|σφαραγεῦντο
ἀφαιρέω|ἀφέλεσθέ|ἀφαιρήσεται|ἀφαιρήσεσθαι|ἀφέλοντο|ἀφελὼν|ἀφείλεο|ἀφαιρεθέντες|ἀφαιρήσομεν|ἀφαιρεθείη|ἀποαιρεῖσθαι|ἀφεῖλον|ἀφαιρεῖται|ἀφέλωμαι|ἀφεῖλε|ἀφελοίμεθα|ἀφείλετο|ἀφελώμεθα|ἀφελέσθαι
λιάζομαι|λίασθεν|ἐλιάσθη|λιάσθης|λιασθείς|λιασθεὶς|λιαζόμενον|λιάσθη|λιάζετο
ἐξέργω|ἐξειργόμενοι
ἐλασσόω|ἐλασσωθῶσιν|ἐλασσούμενοι
πατέομαι|πάσασθαι|πασσάμενος|πασάμην|πάσσασθαι|πασσαμένω|πεπάσμην|πάσαντο|ἐπασσάμεθ̓
ζώννυμι|ζώσαντες|ζώσατο|ζώννυσθαι|ζωννύσκετο|ζῶσαι|ζώννυνταί|ζώννυθ̓|ζωσαμένω
ἀπαλλαξείω|ἀπήλλαξαν|ἀπηλλάχθαι|ἀπήλλακτο|ἀπαλλαξείοντες
ἀνταίρω|ἀνταιρόμενοι
ἀκροκελαινιάω|ἀκροκελαινιόων
ἐμπίμπρημι|ἐνέπρησαν|ἐνέπρησεν|ἐνιπρῆσαι
ἐρῶ|εἴρηται|ἐρέουσιν|ἐρέοντε|εἰρημένα|ἐρέουσ̓|εἰρήσεται|εἴρηκεν|ἐρέων|ῥηθήσεται|ἐρέειν|εἰρήκασι|εἴρηθ̓|εἰρημένον|εἴρηκε|ἐρέει|εἰρημένος|ἔρειο|εἴρητο|ἐρεῖν|ἐρέω|ἐρέοντα|ἐρέουσα|εἰρημένων|ἐρέοιμεν|ῥηθέντι|ἐρέοιμι
ὑπεξαλεύω|ὑπεξαλέασθαι
λείβω|λείψαντε|λεῖψαι|λείβειν|λείβων|λεῖβον|λεῖβε
ἐπιρρώομαι|ἐπερρώοντο|ἐπερρώσαντο
ὀρχέομαι|ὠρχείσθην|ὀρχεῦντ̓|ὀρχήσασθαι
θλίβω|θλίψεται
δηριάομαι|δηριαάσθων|δηριάασθον|δηρινθήτην|δηριάασθαι|δηριόωντο|δηρίσαντο
ἐπόρνυμι|ἐπῶρσε|ἔπορσον|ἐπῶρτ̓|ἐπόρσειαν|ἐπόρνυε|ἐπῶρσ̓
χρίω|χρισάμεναι|χρῖσέν|χρῖεν|χρῖσόν|χρίεται|χρῖσαί|χρίσομαι|χρῖσεν|χρίεσθαι|χρῖον|ἔχρισεν|χρῖσαν
παπταίνω|παπτήνασ̓|παπταίνοντι|παπταίνων|παπταίνοντε|παπτήναντα|παπτήνας|παπταίνοντες|πάπτηνεν|παπτήνασα|παπταίνετον
ὀπάζω|ὀπάσσομεν|ὀπάσσαι|ὤπαζε|ὀπάσσατο|ὀπάζειν|ὄπασσε|ὀπάσσω|ὀπάζων|ὀπάσσεαι|ὄπασσα|ὀπάσσει|ὀπάσσας|ὤπαζον|ὄπαζεν|ὤπασαν|ὄπασσεν|ὄπασσον|ὤπασε|ὀπασσάμενος|ὤπασα|ὀπαζόμενος|ὄπαζε|ὀπάσαιμι|ὀπάσειαν|ὀπάζει
περιφρονέω|περιφρονοῦντες
παλύνω|πάλυνε|πάλυνεν|παλύνειν|παλύνας|πάλυνον|ἐπάλυνεν
τελέθω|τελέθουσι|τελέθουσιν|τελέθοντες|τελέθει
κεκαφηώς|κεκαφηότα
ἐπικέλομαι|ἐπεκέκλετ̓
ζητέω|ζητῆσαί|ζήτει
μενοινάω|μενοίνεον|μενοίνα|μενοινάᾳ|μενοινᾷ|μενοινήσεἰ|μενοινῶν|μενοίνησεν|μενοινᾷς|μενοινήσωσι|μενοινήῃσί|μενοινώω
ἀποφθίνω|ἀποφθιμένου|ἀποφθίμενον|ἀποφθίμην|ἀπέφθιθεν|ἀποφθίσθω|ἀπέφθιτο|ἀποφθιμένοιο|ἀποφθιμένη
μεδέων|μεδέων
ἐπευφημέω|ἐπευφήμησαν
μεταβουλεύω|μετεβούλευσαν
ἐλεαίρω|ἐλεαίρεις|ἐλέαιρε|ἐλεαίροντες|ἐλεαίρων|ἐλέαιρον|ἐλεαίρεσκον|ἐλέαιρεν|ἐλεαίρει
ἐπιμαίνομαι|ἐπεμήνατο
διαλείπω|διαλιπόντων
ἐναμέλγω|ἐνάμελγεν
ἐνδέχομαι|ἐνδέχεται
καταπτήσσω|καταπτήξας
ἔξεστι|ἐξῆν|ἔξεστι|ἐξῇ|ἐξέμμεναι|ἐξέμεναι|ἐξεῖναι|ἐξιόντες
ματάω|ἐμάτησε|μάτησεν|ματήσετον
προεῖπον|προείπομεν|προεῖπον
ἀπεράω|ἀπεροῦσιν|ἀπεροῦντα
κατείργω|κατείργεσθαι
μεθάλλομαι|μετάλμενος
ὄνομαι|ὀνόσσεσθαι|ὀνοσσάμενος|ὀνόσσεται|ὄνονται|ὀνόσασθ̓|ὠνοσάμην|ὄνοιτο|ὄνοσαι|ὀνόσαιτ̓|ὀνόσαιτο|ὤνατο
ἐπεμβαίνω|ἐπεμβεβαὼς
ἔγρω|ἔγρεσθαι
ἀναμετρέω|ἀναμετρήσαιμι
ἀπαίσσω|ἀπαΐξας
δεικανάω|δεικανόωντ̓|δεικανόωντο
ὑποστεναχίζω|ὑπεστενάχιζε
ἀναμαιμάω|ἀναμαιμάει
ἀεικίζω|ἀεικίσσωσι|ἀεικίζει|ἀεικίσσασθαι|ἀεικισθήμεναι|ἀεικισσαίμεθ̓|ἀείκιζεν|ἀεικιῶ
πρόσειμι|πρόσεισι|προσιόντι|προσιόντα|προσιόντες|προσιόντος|προσῄει
ὑποτρομέω|ὑποτρομέεσκον|ὑποτρομέουσιν
προτιόσσομαι|προτιόσσομαι|προτιόσσετο|προτιόσσεο|προτιόσσετ̓
καταλείπω|κατελείπομεν|καλλείπειν|κάλλιπον|καταλείπειν|κατέλειπον|καταλείψουσιν|καλλιπέειν|κάλλιφ̓|καλλείψειν|κάλλιπ̓|κατέλειπεν|κάλλιπες|καταλείψομεν|κάλλιπεν|καταλείπετε
ἐξαναβαίνω|ἐξαναβᾶσαι
ἀνατρέπω|ἀνετράπετ̓
ἐπιρράσσω|ἐπιρρήσσεσκον|ἐπιρρήσσεσκε
ἀμέλγω|ἤμελγεν|ἤμελγε|ἀμελγόμεναι
κείω|κείοντες|κειέμεν|κείουσα|κείω|κείων
περίοιδα|περιίδμεναι|περιῄδη|περίοιδε
ὄζω|ὀδώδει
θεραπεύω|ἐθεράπευσε|τεθεραπευκότα|θεραπεύοντες|θεράπευον
διεξερέομαι|διεξερέεσθε
ἀπαυράω|ἀποέρσειε|ἀπούρας|ἀπηύρα|ἀπηύρων|ἀπηύρας
στέλλω|στέλλοντα|στείλαντο|στέλλεσθε|στέλλοντας|στέλλοιμι|στείλαντα|στεῖλα|στεῖλαν|στελέω
πλεονάζω|πλεονάζων
πρόειμι|προϊὼν|προϊόντες
πινύσκω|ἐπίνυσσεν
ἔλπω|ἔλποιτο|ἔολπας|ἔολπε|ἔολπα|ἔλποντο|ἐέλπεται|ἐλπόμενοι|ἔλπομαι|ἔλπῃ|ἐλπόμενος|ἐελποίμην|ἔλπετ̓|ἔλποιο|ἐώλπει|ἤλπετ̓|ἐλπόμενον|ἔλπεο|ἐλπομένω|ἔλποιτό|ἔλπεαι|ἔλπεσθ̓|ἐέλπετο|ἔλπομ̓|ἔλπετο|ἔλπεται|ἔλπει
ἀποβλύζω|ἀποβλύζων
ἐκφεύγω|ἐκφυγέειν|ἔκφυγε|ἐξέφυγον|ἐκφύγομεν|ἔκφυγεν
ἐπονομάζω|ἐπωνόμασαν
περίειμι|περίεσσι|περίειμι|περιέσεσθαι|περιιόντι|περιοῦσαν|περιεσόμεθα|περιῆσαν
τείρω|ἔτειρε|τειρόμενός|ἐτείρετο|τειρόμενον|τεῖρε|τειρομένοιο|τειρομένους|τείροντο|τειρόμενος|τείρουσ̓|τείρουσι|τείρει|τείρετο|τείροντ̓|τειρομένοις|τείρεσθαι|τείρεσθ̓|τειρόμενοι|τειρόμενοί|τείρεθ̓|ἔτειρεν
ἐξάλλομαι|ἐξάλλεται|ἐξάλμενος
καθιστάω|καθίστασαν|καθισταμένου|καθίστησιν
ἀφύσσω|ἀφύσσων|ἀφυσσάμενοι|ἀφυσσόμενος|ἤφυσ̓|ἠφυσάμην|ἄφυσσον|ἀφυσσάμεθ̓|ἀφύσσατο|ἀφύσσας|ἀφυσσόμενοι|ἄφυσσεν|ἀφύξειν|ἠφύσαμεν|ἠφύσσετο|ἄφυσσε
κίνυμαι|κινύμενος|κινυμένοιο|κινυμένων|κίνυντο
μέλω|μέλειν|μέλει|μέμηλε|μελήσουσιν|ἔμελέν|μέλουσα|μέλω|μεμήλῃ|μελήσεται|μελήσει|μέμβλετο|μέλε|μελήσῃ|μελέσθω|μεμηλώς|μελησέμεν|μελέμεν|μέλουσί|μελόντων|μέμβλετ̓|μεμήλει|μελέτω|μέμηλεν
κύπτω|κύψας|κύψεἰ|κύψαντι
λάμπω|λαμπομενάων|λαμπομένης|λαμπόμενος|ἐλάμπετο|λάμπ̓|λάμφ̓|λάμπε|λάμπετον|λαμπόμενοι|ἔλαμπε|λαμπέσθην|λάμπετο|λαμπόμενον
σκυδμαίνω|σκυδμαινέμεν
μοχθίζω|μοχθίζοντα
προφέρω|προφέρωμεν|προφέρονται|προφέρετε|προφέρουσα|προφέρουσαι|πρόφερε|προφέρῃσι|προφέρηται|προφέροις|προφέρειν
ἡγέομαι|ἡγήσαντο|ἡγεῖτ̓|ἡγουμένου|ἡγοῦμαι|ἡγησάμενος|ἡγουμένων|ἡγήσαιτο|ἡγεόμην|ἡγησάμενοι|ἡγησάσθην|ἡγεῖθ̓|ἡγεῖτο|ἡγήσαιο|ἡγήσατο|ἡγούμενοι|ἡγεῖσθαι|ἡγησάσθω|ἡγήσασθαι|ἡγήσομαι|ἡγοῦντο|ἡγείσθω|ἡγείσθην|ἡγοῦνται|ἡγήσατ̓
στόρνυμι|στορέσαι|στόρεσαν|ἐστόρεσεν
προκαλίζομαι|προκαλίζεο|προκαλίζετο
προσοικέω|προσοικοῦσι
διατελέω|διατελοίη
ἐπιθύω|ἐπιθύσαντες|ἐπιθύουσι
ἀνακυμβαλιάζω|ἀνακυμβαλίαζον
θάλπω|θάλπων|θάλποντες
καταναγκάζω|καταναγκάζεσθαι|κατηναγκάσθημεν
καταθάπτω|κατθάψαι|καταθάπτειν
προφασίζομαι|προυφασίζετο
διαπέμπω|διέπεμψεν|διαπέμψαι
ἐσχατάω|ἐσχατόωντα|ἐσχατόωσαν|ἐσχατόωσα
προμίγνυμι|προμιγῆναι
κελευτιάω|κελευτιόων|κελευτιόωντ̓
φαίνω|φαίνεσθαι|ἔφανεν|φανεῖσθαι|φάνης|φαείνων|φαίνεθ̓|φανείη|φανήτω|φήνωσι|φανῆναι|φαῖνε|φαινέτω|φανεὶς|φάνεσκε|φαάνθη|φανέντα|φανήῃς|φαινομένηφι|φανεῖσα|ἐφαίνετο|φάνεσκεν|φαινομένηφιν|φάνεν|φάνηθι|φανήτην|φαίνει|φαίνεις|φαείνοι|φαῖν̓|φήνειε|φαινομένων|φανεῖται|φαίνων|πεφήσεται|φάνη|φαίνετο|φαείνω|φαινομένη|φάεινε|φαίνοιτο|φαίνετ̓|ἔφαινον|φάανθεν|φαίνηται|φαίνοντ̓|φάνημεν|φανήῃ|φαίνονθ̓|φαινέμεν|φαίνοντες|φαίνοιτ̓|φαινέσκετο|ἔφηνε|φαίνεται|ἐφάνη|φαείνοιεν|φανήμεναι|φανῇ|φαίνονται
ἐπί-τροπεύω|ἐπετρόπευεν
ἀνακόπτω|ἀνέκοπτεν
ἐμβασιλεύω|ἐμβασίλευε|ἐμβασίλευεν
ἀίσθω|ἄϊσθε|ἀΐσθων
πορφύρω|πορφύρῃ|πόρφυρε
ἀμφιφοβέομαι|ἀμφεφόβηθεν
πταίω|πταίει
εἰσαφικνέομαι|εἰσαφικέσθαι|εἰσαφίκηαι|εἰσαφίκοιτο|εἰσαφίκηται
συγκρούω|ξυγκρούειν
ἐπιρρέζω|ἐπιρρέζεσκον
ὁμολογέω|ὡμολόγησαν
καταβαίνω|καταβᾶσα|κατεβαίνομεν|καταβὰς|καταβάντας|καταβήσεται|καταβῆναι|κατέβαν|καταβήμεναι|καταβάς|κατάβηθι|κατεβήσετο|καταβήσεο|κατέβαιν̓|καταβήομεν|κατέβησαν|κατέβην
ἀχλύω|ἤχλυσε
περιμένω|περιμένοντας|περιμείνασι
ἐφίημι|ἐφιεὶς|ἐφιέμενος|ἐφέηκε|ἐφέηκεν|ἐφιεμένῃ|ἐφῆκεν|ἐφίεσαν|ἐφείω|ἐφέηκα|ἐφήσω|ἐφίετε|ἐφίει|ἐφείη|ἐπίωμεν|ἐφῆκα|ἐφήσεις|ἐφιέμενοι|ἔφες|ἐφήσομαι|ἐφήσει|ἐφῆκε|ἐφείην
δαπανάω|δαπανήσομεν|δαπανῶντες
λαγχάνω|λελάχωσι|λάχῃσιν|λάχεν|λάχε|λάγχανον|ἐλάγχανον|λαχόντα|ἔλαχόν|λελόγχασιν|λαχεῖν|λάχον|ἔλαχον|λάχ̓|ἔλαχε|λελάχητε|λάχομεν|ἔλαχ̓|λαχὼν|λάχῃ
ἀντιδίδωμι|ἀντιδοθῆναι
ἀμφαγαπάζω|ἀμφαγάπαζον|ἀμφαγαπαζόμενος
ζάω|ζῶντος|ζώοντ̓|ζῶντας
κατερητύω|κατερήτυον|κατερήτυε|κατερήτυεν
ῥυστάζω|ῥυστάζεσκεν|ῥυστάζοντας
ὑποπερκάζω|ὑποπερκάζουσιν
παρίζω|παρῖζεν
κηρύσσω|κηρύσσειν|κηρύσσων|κηρύσσοντες|ἐκήρυσσον
τέμνω|τάμνον|ταμνομένη|τάμνε|τάμωμεν|ταμνομένους|τάμον|τάμοι|ταμέσθαι|τάμῃ|ἔταμνεν|τέμνειν|τετμημένον|τάμῃσι|τάμε|ταμέειν|τεμοῦμεν|τάμνων|τάμνοντ̓|τάμνετο|τάμητε|ταμόντες|τάμνῃ|ταμὼν|τάμνεν|τάμῃσιν|τμηθῆναι|ἔταμνον|ταμόνθ̓|ἔτεμον|τάμνετε|τέμωμεν
μανθάνω|μαθόντων|μαθεῖν|μαθὼν|ἔμμαθεν|μάθον|μάθοιτε|ἔμμαθες
θρηνέω|θρήνεον|ἐθρήνεον
πιστεύω|ἐπίστευσαν|πιστεῦσαι|πιστεύσαντες|πιστεύειν|πιστεύων|πιστεύσαντας|πιστεύοντες
λάζομαι|λαζοίατο|λέλασται|λάζετο|λελασμένος|ἐλάζετο|λελάσμεθα|λελασμένον
πυκάζω|πυκάσαι|πεπυκασμένα|πυκάσας|πεπυκασμένος|πυκάσασα|πύκασεν|πύκασε|πυκάζοιεν
κατεναίρομαι|κατενήρατο
ἀνερωτάω|ἀνηρώτων
ἀφαμαρτάνω|ἀφάμαρθ̓|ἀφάμαρτεν|ἀπήμβροτε|ἀφαμαρτούσῃ|ἀφάμαρτε|ἀπήμβροτεν
ἐπιορκέω|ἐπιορκήσω
ἀμέρδω|ἄμερσε|ἀμέρδεαι|ἀμέρδει|ἄμερδεν|ἀμέρσαι|ἀμερθῇς
οἰμάω|οἴμησε|οἴμησεν
ἀποδοχμόω|ἀποδοχμώσας
μεταστρέφω|μεταστρεφθείς|μεταστρεφθέντι|μεταστρέψῃ|μεταστρέψωσιν|μεταστρεφθέντε|μεταστρεφθέντα|μεταστρέψεις|μεταστρεφθεὶς|μεταστρέψειε
παραπλάζω|παρεπλάγχθη|παραπλάγξασα|παρέπλαγξεν
περιτρέχω|περίδραμον
αὐχμέω|αὐχμεῖς
θάω|θῆσθαι|θήσατο
θέρω|θερσόμενος|θέρηται|θέρεσθαι|θέρωνται|θερέω
ἐπιφθονέω|ἐπιφθονέῃς
διακλάω|διακλάσσας
καθέζετο|καθέζετ̓
ἐξόλλυμι|ἐξολέσειε
δουπέω|δουπῆσαι|δεδουπότος|ἐγδούπησαν|δούπησεν
ἀναδέρκομαι|ἀνέδρακεν
ἰσοφαρίζω|ἰσοφαρίζοι|ἰσοφαρίζειν|ἰσοφαρίζεις|ἰσοφαρίζει
μαντεύομαι|μαντεύεαι|μαντεύεται|μαντεύετο|μαντεύομαι|μαντευόμενος|μαντεύεσθαι|μαντεύσατο|μαντεύσομαι|μαντεύεο
ἀποχράομαι|ἀποχρῆσθαι
ἐξανύω|ἐξανύω|ἐξήνυσε
ὑπεκφεύγω|ὑπεξέφυγεν|ὑπέκφυγε|ὑπεξέφυγε|ὑπεκφύγοι|ὑπεξέφυγον|ὑπέκφυγες|ὑπεκφυγέειν|ὑπέκφυγον
ἀποδύνω|ἀπέδυνε|ἀπέδυσε|ἀποδὺς
ἀλέγω|ἀλέγουσιν|ἀλέγοντες|ἀλέγει|ἀλεγούσας|ἀλέγουσι|ἀλέγω
τίθημι|θέσθε|ἔθεμεν|θήκατο|θέτο|θῆαι|ἔθηκα|τίθενται|θέσθαι|θῆκε|ἔθεντο|ἔθηκας|θεμένη|θησέμεναι|θήσετε|θέμεναι|θέσαν|θέσθω|θείην|θεῖμεν|ἔθεσαν|ἔθηκεν|τίθεσθαι|τίθησθα|θέσθ̓|τίθεται|ἐτίθει|τιθεὶς|ἔθηχ̓|ἔθηκαν|θῆκεν|θήσει|θείη|θέντες|τίθει|τιθέμεσθα|ἐτίθεντο|τεθῆναι|θεῖσα|τίθεσαν|θήσεις|τίθεσθε|θήσουσ̓|θῆκαν|θεῖτο|θήσειν|ἔθεσθε|θέωμεν|θῆκ̓|θὲς|θεῖναι|ἔθηκ̓|τίθεντο|θήῃ|θήσεσθαι|θήῃς|θέμεν|θέμενος|θῆχ̓|θήσω|τιθεῖσι|θῇσιν|θείω|ἔθετ̓|θείῃ|τιθήμενον|θήσονται|θείομεν|θέτ̓|τίθησι|θέο|ἔθηκε|θείης|θέντων|τιθέντες|τιθήμεναι|τιθεῖ|θεῖεν|τίθεσθ̓
δικαιόω|δικαιῶ
ἀποσεύω|ἀπεσσύμεθ̓|ἀπεσσύμενον|ἀπέσσυτο
ἀφανδάνω|ἀφανδάνει
θοινάω|θοινηθῆναι
διακωλύω|διεκωλύθησαν|διακωλύειν
ποθέω|ποθήμεναι|πόθεσαν|ποθέοντε|ποθέων|ποθέεσκε|ποθέεις|ποθέω|ποθέοντες|ποθέουσα|πόθει|πόθεον|ποθέσαι|πόθεόν
μένω|ἔμενον|μενόντων|μένουσι|μεῖναί|μένει|μενέω|μένεν|μένοντα|μένοντε|μένον|μένω|μένωμεν|ἔμεν̓|ἔμεινε|μενέουσιν|ἔμειναν|μένῃσι|μείναμεν|μενέουσ̓|μενέεις|μενέουσι|μενέειν|μένε|μεῖναι|μενέτω|μένετ̓|μενέτην|μείνειας|μένοντι|μεῖν̓|μένομεν|ἔμεινας|ἐμείναμεν|μένῃ|μένοις|μένετε|μένειν|μεῖνα|μένουσ̓|μένοντες|μείνῃ|μένομέν|μέν̓|μένεσκον|μένων|ἔμεινα|μένοιεν|μεῖνε|μενέμεν|μένουσιν|μενοῦμεν|μείνατ̓
προσπλέω|προσπλεούσας|προσπλέοντας
ῥυπόομαι|ῥερυπωμένα
περιέχω|περισχόμεθ̓|περίσχεο
σπέρχω|σπερχοίατ̓|σπερχομένους|σπέρχοιεν|σπέρχωσιν|σπερχομένη|σπερχομένοιο|σπερχόμενος|σπερχόμενός
παραείρω|παρηέρθη
ὑπερβαίνω|ὑπερβήῃ|ὑπέρβασαν|ὑπέρβη|ὑπερβαίνειν
ἐνῆμαι|ἐνήμεθα
μινυρίζω|μινύριζε|μινύριζον
περιναιετάω|περιναιετάουσιν|περιναιετάουσι
προσομιλέω|προσομιλήσας
ἰδνόομαι|ἰδνωθεὶς|ἰδνώθη|ἰδνωθείς
ἀρκέω|ἤρκεσ̓|ἀρκέσειν|ἀρκέσει|ἀρκεῖν|ἤρκεσε|ἤρκει
ἀποπλάζω|ἀποπλαγχθεὶς|ἀποπλαγχθέντες|ἀπεπλάγχθης|ἀποπλαγχθέντας|ἀποπλαγχθεῖσα|ἀπεπλάγχθη
ὑπαίσσω|ὑπαΐξας|ὑπαΐξει
καθοράω|καθορώμενος|καθορῶσι|καθορῶν
φθάνω|φθήῃ|φθῆ|ἔφθης|φθάμενός|φθὰν|φθάσαι|φθῇσιν|φθήσονται|φθέωσι|φθάμενος|ἔφθη|φθαίη|φθέωμεν|φθάνει
οὐτάω|οὐτάμενοί|οὔτασκε|οὐτάμεναι|οὐτάμεν|οὔταε|οὐταμένην|οὐτηθείς|οὐτήσασκε|οὖτά|οὖτα|οὔτησε|οὐτάμενοι
ἀρνέομαι|ἀρνεῖται|ἀρνήσασθαι|ἀρνείσθω|ἀρνήσαιο|ἠρνεῖτο
μετεῖπον|μετέειπεν|μετέειπε|μετέειφ̓|μετέειπον
συμβαίνω|ξυνέβησαν|ξυμβῇ|ξυμβάντος|ξυμβῆναι|ξυμβαίνει|ξυνέβη|ξυμβῶσιν|ξυμβεβηκότα
δεύω|δευέσθω|δεύσω|δευόμενον|δευέσθην|δεύεσκον|ἐδεύησεν|δευήσεσθαι|δεύει|δεύονθ̓|δευοίατο|δεύεται|δεύεαι|δεύεσθαι|ἔδευεν|δεύοντο|δεύετο|δευήσεαι|δεῦε|ἐδεύεο
ἀπορούω|ἀπόρουσεν|ἀπόρουσε
διέξειμι|διεξίμεναι
οἰκοδομέω|οἰκοδομούμενα|ᾠκοδόμησαν|οἰκοδομεῖν
κατάρχω|κατήρχετο
μοχθόω|μοχθοῦσι
ἀπονέομαι|ἀπονεοίμην|ἀπονέοντο|ἀπονέεσθαι
θάλλω|τεθήλει|τεθαλυῖαν|τεθαλυῖά|τεθηλώς|τεθαλυίῃ
τρέω|τρεῖν|τρεῖτ̓|τρέσσε|τρέε|τρεῖ|ἔτρεσαν|τρέσε|τρέσσαι|τρέσσαν|τρεσσάντων|ἔτρεσε
ἐρείπω|ἤριπεν|ἐριπὼν|ἐριποῦσ̓|ἐρέριπτο|ἐριποῦσα|ἤριπε|ἐρίπῃσιν|ἐρείπων|ἔρειπε|ἐριπών|ἔρειπον|ἔριπ̓
ἐπισκύζομαι|ἐπισκύσσαιτο|ἐπισκύζωνται
προερέω|προεροῦντα|προειρημένα
ἀγρώσσω|ἀγρώσσων
ἀναλίσκω|ἀνηλοῦτο|ἀναλωθέντα
ἐγκρύπτω|ἐνέκρυψε
εἰσαγγέλλω|ἐσηγγέλλετο|ἐσαγγελθέντων
διαρραίω|διαρραίσεσθαι|διαρραίσουσι|διαρραίουσι|διαρραίσει|διαρραῖσαι
διαμνημονεύω|διαμνημονεῦσαι
παρατροπέω|παρατροπέων
ἐμπίπτω|ἐμπέσῃ|ἔμπεσ̓|ἔμπεσε|ἔμπεσεν
κυμαίνω|κυμαίνοντα
ἐφορμάω|ἐφορμᾶσθαι|ἐφορμήσας|ἐφορμηθεῖσα|ἐφορμηθέντα|ἐφορμηθέντε|ἐφορμούσας|ἐφορμηθέντες|ἐφορμηθῆναι|ἐφορμηθεῖεν|ἐφορμᾶται|ἐφορμουσῶν|ἐφορμεῖσθαι|ἐφωρμήθη|ἐφώρμησαν|ἐφωρμήθην|ἐφορμηθεὶς
ἐκπορίζω|ἐκπορίζεσθαι|ἐκποριζώμεθα
πελάζω|πελάσῃ|πλῆτο|πελάσσαι|πελασαίατο|πέλασεν|πελάσσομεν|πέλασάν|πελάσσατε|πελάσαι|πλῆντ̓|πέλασσε|πελάζειν|πέλασθεν|πέλασσεν|πεπλημένος|πελάσῃς|πελάσθη|πελάσσῃ|πέλασαν|πέλασε
παραπνέω|παραπνεύσῃ
πτώσσω|πτώσσων|πτώσσοντας|πτώσσουσαι|πτώσσοιμεν|πτώσσουσι|πτώσσεις|πτῶσσον|πτώσσειν
ἀντιτορέω|ἀντιτορήσας|ἀντετόρησεν
κομπέω|κόμπει
ἀναρρήγνυμι|ἀναρρήξαντε|ἀναρρήξειε|ἀναρρήξας
ὑποκύομαι|ὑποκυσάμεναι|ὑποκυσαμένη
χάσκω|κεχηνότα|χάνοι|χανὼν|χανών
περιτέλλομαι|περιτελλομένων|περιτελλομένους|περιτελλομένου
μειδάω|μείδησεν|μείδησε|μειδήσασα
ἀγείρω|ἀγείροντες|ἀγρομένοισι|ἀγηγέραθ̓|ἀγρόμεναι|ἀγρομένῃσι|ἄγερθεν|ἀγρομένοισιν|ἀγέροντο|ἤγειρε|ἀγειρόντων|ἀγέρθη|ἀγείρω|ἄγειρα|ἀγεῖραι|ἀγρομένων|ἀγείρομεν|ἀγειρόμενοι|ἠγείροντο|ἄγειρεν|ἀγρόμενοι|ἀγείρων|ἀγείρετο|ἀγείρας|ἀγειρούσῃ|ἀγείροι|ἄγειραν|ἤγερθεν|ἤγειρα|ἀγηγέρατ̓|ἀγέρεσθαι
συγκαλέω|συγκαλέσας
ῥήγνυμι|ῥηξάμενος|ῥήξειν|ῥήγνυσκε|ἔρρηξ̓|ῥήγνυτο|ῥηξόμεθα|ῥήξας|ἐρρήξαντο|ῥήξω|ῥηξάμενοι|ῥηγνῦσι|ῥηγνύμενον|ῥήγνυσθαι|ῥῆξεν|ῥήξαντο|ῥήξασθαι|ῥῆξαι|ἔρρηξεν|ῥῆξαί|ῥήγνυντο|ῥήγνυσθε|ῥήξαντες|ῥῆξ̓|ῥηξαμένῳ|ῥήσσοντες|ῥῆξε
συμπίτνω|ξυνέπεσεν
βόσκω|βοσκομένας|βοσκομένης|βόσκουσι|βοσκομενάων|βοσκόμενος|βόσκοι|βοσκέσκονθ̓|βόσκειν|βόσκ̓|βόσκοντ̓|βόσκει|βοσκήσεις|βοσκομένη
ἐνεῖδον|ἐνεῖδον
δραίνω|δραίνεις
πνέω|πνέει|πνείει|πνείοντος|πνείοντε|πνείουσα|ἔπνευσ̓|πνείουσαν|πεπνῦσθαι|πνείοντας|πνεύσῃ|πνείοντες
ἀπαφίσκω|ἀπαφίσκει|ἀπάφοιτο|ἤπαφε
κατασχεθεῖν|κάσχεθε
ὑπερωέω|ὑπερώησαν
φαρμάσσω|φαρμάσσων
συμμένω|ξυνέμεινεν
ἐπιμένω|ἐπέμενον|ἐπιμεῖναι|ἐπίμεινον
φορέω|φορέοις|φορέεσκον|φορέεσκε|φορέῃσιν|ἐφόρεον|φόρει|φορέουσα|φορέῃσι|φορέειν|φοροίη|φορήμεναι|φοροῦντες|φορῆναι|φορεούσας|φορέουσιν|φορέει|ἐφόρει|φορέοντες|φορέεις|φόρεον|φορέουσι|φόρησεν
ἀναρροιβδέω|ἀναροιβδεῖ|ἀνερροίβδησε|ἀναρροιβδεῖ
ὑποτοπέω|ὑποτοπήσαντες
μεταβάλλω|μετέβαλον|μεταβάλλειν|μεταβαλλόμενοι|μεταβάλοιτε
ἐκπολιορκέω|ἐκπολιορκηθεὶς|ἐξεπολιορκήθησαν|ἐξεπολιόρκησαν
φοιτάω|φοιτῶντές|φοιτᾷ|ἐφοίτων|φοιτήτην|φοιτῶντε|ἐφοίτα|φοιτῶντες|φοιτήσασα|φοίτων|φοίτα|φοιτῶσ̓
μαργαίνω|μαργαίνειν
ποιπνύω|ποιπνύοντα|ποίπνυον|ἐποίπνυον|ποιπνύσασαι|ποιπνύσαντι
κατασκιάω|κατεσκίαον
σαλπίζω|σάλπιγξεν
ἀποκαίνυμαι|ἀπεκαίνυτο
στέργω|στεργόμεθα
ἐλευθερόω|ἐλευθερῶν|ἠλευθέρωσαν|ἐλευθερώσωμεν|ἠλευθέρωντο
τρωχάω|τρωχῶσι|τρώχων
παραφθάνω|παραφθάμενος|παραφθὰς|παραφθαίησι
ἕλκω|ἑλκόντων|ἕλκων|ἑλκέμεναι|ἕλκεο|ἕλκετ̓|ἕλκοντ̓|ἕλκωσ̓|ἑλκέμεν|ἕλχ̓|ἑλκομένοιο|ἕλκει|ἕλκ̓|ἑλκόμενος|ἕλκεσθαι|ἑλκόμενον|ἑλκομένας|ἑλκόμενα|ἕλκητον|ἕλκῃσιν|ἑλκομενάων|ἕλκετο|ἕλκεν|ἕλκωσι|ἕλκωμεν|ἕλκε|ἕλκομεν|ἕλκεται|εἷλκον|ἕλκον|ἕλκῃ
πατάσσω|πατάσσει|πάτασσε|πάτασσεν
διαθειόω|διεθείωσεν
ἀλλοφρονέω|ἀλλοφρονέων|ἀλλοφρονέοντα
ἀλέω|ἀλέαιτο|ἄλεσσαν|ἀλεώμεθα|ἀλέασθαι
ἀποτρωπάω|ἀποτρωπῶμεν|ἀποτρωπῶσι
ἀνακομίζω|ἀνεκομίσθη
γελάω|γελάσασα|γελάσσας|ἐγέλασσε|γελώοντες|γελοίων|γέλασσαν|ἐγέλασσαν|γελάσαι|γέλασσε|ἐγέλασσεν|γελόω|γέλασαν|γελάσας|γελοίωντες|γελόωντες
προφαίνω|προύφαινε|προπέφανται|προυφαίνετ̓|προφανέντ̓|προφανέντε|προὐφαίνετο|προύφαινον
ἀνανεύω|ἀνένευσε|ἀνένευε
εἰσελαύνω|εἰσέλασαν|εἰσελάσαντες|εἰσελάων
πολιτεύω|πολιτεύσουσι
ἀλαλύκτημαι|ἀλαλύκτημαι
ἥδομαι|ἥσατο|ἥσθη|ἡδόμενον
ἐπαλάομαι|ἐπαληθεὶς|ἐπαληθῇ|ἐπαληθείς
καθεύδω|καθεῦδ̓|καθεύδετον|καθεύδειν|καθεῦδε
ἀναπάλλω|ἀνεπᾶλτο|ἀμπεπαλὼν|ἀναπάλλεται|ἀνέπαλτο|ἀνέπαλτ̓
μεταδίδωμι|μεταδώσετε
ἀντερῶ|ἀντεροῦντες
ὄσσομαι|ὀσσομένη|ὄσσετο|ὀσσόμενον|ὀσσόμενος|ὄσσοντο
προβιβάω|προβιβάντα|προβιβάς
δέμω|ἔδειμαν|δείμομεν|δείμαθ̓|ἐδέδμητο|ἐδείματο|δέδμητο|δέμον|ἔδειμε|ἔδειμα
παρέζομαι|παρεζόμενος|παρέζετο|παρέζεο
ἐπικείρω|ἐπέκερσε
προγράφω|προύγραψα
περιτίθημι|περιθεῖεν
προβέβουλα|προβέβουλα
καταστυγέω|κατέστυγε
εἰσανεῖδον|εἰσανιδών
ἀνακλίνω|ἀνακλῖναι|ἀνακλινθεῖσα|ἀγκλίνας|ἀνακλίνας|ἀνακλινθεὶς|ἀνακλινθέντες
ὑπερηφανέω|ὑπερηφανέοντες
καταστορέννυμι|κατεστόρεσαν
λαφύσσω|λαφύσσετον|λαφύσσει
ἐπιρρίπτω|ἐπέρριψαν
ἀμύνω|ἀμυνέμεν|ἤμυνε|ἀμύνουσιν|ἀμυνώμεθα|ἄμυνεν|ἀμύνῃς|ἀμυνούμεθα|ἀμυνόμενος|ἀμύνοιτ̓|ἀμύνων|ἀμυναίμην|ἀμυνομένων|ἀμύνει|ἠμυνόμην|ἄμυνον|ἀμυνόμενοι|ἀμυνόμενον|ἀμυνομένῳ|ἀμῦναι|ἀμυνέμεναι|ἀμύνειν|ἀμύνοι|ἄμυνε|ἀμύνωσι|ἠμύνοντο|ἀμύνονται|ἀμύναι|ἀμύνω|ἀμύνετε|ἀμύνεις|ἀμύνεσθαι|ἀμύνετο
βρίθω|βρῖθον|βρίσαντες|βέβριθε|βρίθουσαν|βεβριθυῖα|βρίθῃσι|βεβρίθασιν|βρίσας|βριθομένη|βεβρίθει|ἔβρισαν
εἰσεῖδον|εἰσιδέειν
ἀποπτύω|ἀποπτύει|ἀποπτύων
πρόκειμαι|προκειμένης|προκείμενα
ἵκω|ἷξε|ἵκω|ἷξον|ἷξεν|ἷκε|ἵκει|ἵκοι
προσίημι|προσιέναι
ἐμμένω|ἐμμεμένηκεν
μετέχω|μετέχειν|μετέχει|μετέσχετε
ἀναβέβρυχε|ἀναβέβροχεν
ἀλδαίνω|ἤλδανε
ὀχθέω|ὄχθησαν|ὀχθήσας
ἀποφθινύθω|ἀποφθινύθουσι
ἴπτομαι|ἴψαο|ἴψεται
τοξάζομαι|τοξάζεσθαι|τοξαζοίμεθ̓|τοξάσσαιτο|τοξάσσεται|τοξάζεαι|τοξαζοίατο
μάρπτω|ἔμαρψεν|ἔμαρπτε|μάρψει|ἔμαρπτεν|μάρπτῃσι|μάρψας|μάρπτε|μάρψαι|μάρψῃ
κατασκευάζω|κατασκευάσασθαι|κατεσκευάζοντο
διακομίζω|διεκομίζοντο|διακομίζεται
πρήθω|ἔπρησεν|πρῆσε|πρῆσεν
ἔοικα|ἔοικέ|εἶκε|ἔοικα|ἔϊκτο|ἔοικ̓|εἰκότα|ἐοικότα|ἤικτο|εἰοικυῖαι|ἐοικὼς|ἐοικότες|ἔοικε|ἐίκτην|ἐοικότας|ἔικτον|ἔοικας|ἤϊκτο|ἐοικότι|ἐοικώς|ἐοίκεσαν|ἐοικότε|ἐΐκτην|ἐῴκει|ἔοικεν
γνάμπτω|γνάμψεν
ῥέπω|ῥέπε
φύρω|πεφυρμένη|πεφυρμένον|φύρσω|ἔφυρον
λέγω|λέξον|λέξατο|λεξάσθων|λέγειν|ἔλεξα|ἔλεκτο|λεγόμεναι|ἔλεξε|λέξομαι|λέξαιτο|λεγόμενα|λέγονται|ἔλεγ̓|λέγοντες|ἔλεξεν|λέγοντο|λέγουσι|λέγοντος|λέγε|λέγομεν|λέξεται|λέγεσθαι|λεχθέντων|λέκτο|λέγει|λέξας|λέγωσιν|ἐλέγεσθε|λεγομένων|ἐλέξατο|λέγων|λεξαίμην|λεγόντων|ἔλεξαν|λεξάσθην|λέξο|λέξοντες|λέξεαι|λέγεται|λέγεσθε|λεγοίμεθα|λέγ̓|λέγωμεν|ἐείλεον|λέξασθαι|λεγώμεθα|ἔλεγον|λέγουσιν|ἐλέγμην|ἐλέχθην|λέξεο
ἐπιτελέω|ἐπιτελῶσι|ἐπιτελέσαι
ἐξαφύω|ἐξαφύοντες
θρῴσκω|θορόντες|θόῤ|θόρε|θόρον|θρῴσκωσιν|θρῴσκοντας|θρῴσκων|ἔθοῤ|θορόντα|ἔθορε|θοροῦσα|θόρωσι|θρῷσκον|θορὼν
δηλόω|δηλοῖ|ἐδηλώσαμεν|δηλῶσαι|δηλοῦται|δηλοῦντας|δηλοῦντες|δηλωθέντος|δηλοῦσι|δηλῶν|δηλώσας|δηλώσαντος|δεδήλωκεν|ἐδήλου|δηλώσει|δεδήλωται|δηλωθήσεται
σύν-λέγω|ξυλλέξαντες
γεύω|γεύσασθαι|γεύσεται|γεύσεσθαι|γευσόμεθ̓
διαίνω|διαίνετο|ἐδίην̓|δίαινε|ἐδίηνε
κορύσσω|κορύσσεαι|κορυσσάμενος|κορυσσέσθην|κεκορυθμένοι|κορυσσόμενον|κεκορυθμένος|κορυσσόμενος|κορύσσων|κορύσσετο|κεκορυθμένον|κεκορυθμένα|κόρυσσε|κορύσσεται
ἐγγίγνομαι|ἐγγεγάασιν|ἐγγεγάασι|ἐγγενομένου|ἐγγιγνομένου|ἐγγιγνόμεναι
γυμνάζω|γυμνάζεσθαι
σώζω|σώζων|σῴζεσθαι|σαῷς|σάωσε|σαώσετον|σαώσει|σαώσεαι|σαώσω|ἐσάωσα|σαώσῃ|ἔσωσε|σώσας|σαωθήτω|σαώσετε|ἐσάωσε|σαῷ|σῴζειν|σαώσειαν|σάωσας|σάωσον|ἐσάωσαν|σαῶσι|ἐσώθησαν|σαώσομεν|σαώσῃς|ἐσάωθεν|ἐσάωσεν|σαώσατε|σαωσέμεναι|ἔσωσας|σαώσειας|σαώσαι|σαωθῆναι|σάω|ἐσάωσ̓|σαῶσαι|σώσει|σαώσεις|σαωσέμεν
ἐμπνέω|ἐνέπνευσεν|ἐνέπνευσε|ἐμπνείοντε|ἐμπνύνθη|ἔμπνυτο|ἔμπνευσε|ἐμπνεύσῃσι
διαπέρθω|διεπέρσαμεν|διαπέρσομεν|διέπραθον|διαπέρσαι|διαπραθέειν|διέπερσε|διεπράθετο|διεπράθομέν
ἀναστρωφάω|ἀναστρωφῶν
χρίμπτω|χριμφθεὶς
προσδέχομαι|ποτιδέγμενος|ποτιδέγμενον|ποτιδεγμένω|ποτιδέγμεναι|προσδεχόμενοι|προσεδέξαντο|ποτιδέγμενοι|προσδέχεσθαι
οἶδα|ᾔδησθ̓|ᾔδη|ἰδυίῃ|ἰδῇς|εἰδῇς|εἰδότος|οἶδεν|ἴσασι|εἰδότα|ἰδυίας|εἰδόθ̓|ἴσθ̓|εἴσεται|ἴδμεναι|εἴσομ̓|οἶσθ̓|εἴδετε|ἴσασιν|οἶδέ|εἰδὼς|ἰδυίῃσι|εἴδομεν|εἴσεαι|οἶδε|ἴστε|ἠείδη|οἶδ̓|εἰδῇ|οἶδας|ἴσθι|οἶδα|εἰδότε|εἰδῶσι|εἴδετ̓|ᾔδεσαν|ἴσμεν|ἴσασ̓|ἰδῇ|οἶσθα|εἰδείη|εἰδῶ|ἰδυῖαν|ᾔδἐ|εἰδέω|εἰδόσιν|εἰδήσειν|ἴδμεν|εἰδότ̓|ᾔδεε|εἰδείης|εἰδόσι|ἴστω|εἴσομαι|εἰδώς|εἰδότες|εἰδότας|ᾔδεεν|εἰδέναι
δικάζω|δίκαζον|δίκασαν|δικαζέτω|δικαζέμεν|δικάζεσθαι|δικασθῇ|δικαζομένων|δικάσσατε|δικαζόμενος|δικάσω
ἐπίσταμαι|ἐπίστασθαι|ἐπιστάμεναι|ἐπισταίμεσθα|ἐπιστάμενος|ἐπιστάμενοι|ἐπισταμένου|ἐπίσταιτο|ἐπιστάμεθα|ἐπιστήσονται|ἐπισταμένῳ|ἐπίστηται|ἐπίστατο|ἐπίσταμαι|ἐπισταμένοισι
ἐξεῖπον|ἐξείπῃ|ἐξείπω|ἐξείποι
ἀκμάζω|ἀκμάζοντές
ἐπέλπομαι|ἐπιελπόμενος|ἐπιέλπεο
ὑπίσχομαι|ὑπισχόμεναι|ὑπίσχεο
δείκνυμι|δείξειας|δεῖξεν|δεῖξαι|δεῖξ̓|δεικνὺς|ἔδειξεν|δείξαντος|δείξω|δεῖξε|δείξειε|δεῖξον|δεικνύμενος|ἔδειξε|δείξας|ἐδείξαμεν|δεικνύναι|δεξαμένους|δεξαμένῳ
κατευνάζω|κατεύνασθεν
ἐξαπόλλυμι|ἐξαπόλωλε|ἐξαπολοίατ̓
ἅζομαι|ἅζεο|ἁζόμενοι|ἅζετο|ἅζομαι|ἅζευ
συγκατασκευάζω|ξυγκατεσκεύαζεν
μεγαλίζομαι|μεγαλίζεο|μεγαλίζομαι
ἀντί-ἴσχω|ἀντίσχειν|ἀντίσχουσαν
ἀντιποιέω|ἀντιποιοῦνται
βουκολέω|βουκολέων|βουκολέοντο|βουκολέοντι|βουκολέεσκες
ὑπισχνέομαι|ὑποσχόμενος|ὑπίσχεται|ὑπισχνῇ|ὑπισχνεῖτο|ὑποσχομένου|ὑπίσχομαι|ὑπέσχετο|ὑπίσχετο|ὑπόσχεο|ὑπόσχηται|ὑπέσχεο|ὑπόσχωνται|ὑποσχέσθαι|ὑποσχόμενοι|ὑπόσχωμαι|ὑπέσχοντο
προχέω|προχέοντο|προχέειν
ἀκηδέω|ἀκήδεις|ἀκήδεσεν
ἀνταποδίδωμι|ἀνταπόδοτε
πιλνάω|πίλνατο|πίλναται
ἑψιάομαι|ἑψιαάσθων|ἑψιάασθαι
ἀποτρίβω|ἀποτρίψουσι
πεσσεύω|ἐπεσσεύοντο|ἐπέσσευεν
ἀπολογέομαι|ἀπολογησομένους
τάνυμαι|τάνυται
ὀφείλω|ὀφείλεται|ὄφελες|ὄφελεν|ὄφελέν|ὄφελ̓|ὤφελες|ὄφελόν|ὤφελεν|ὄφελον|ὀφείλετ̓|ὄφειλον|ὠφέλετ̓
τιμάω|τιμῆσαι|τιμήσομεν|τιμῶσαι|τίμησας|ἐτιμήσασθ̓|ἐτίμα|τιμήσουσι|τιμήσασθαι|τετιμῆσθαι|τιμήσαντο|τιμήσῃ|τετιμήμεσθα|τιμήσουσιν|τιμῶσιν|τιμῶν|τιμῶσι|τιμᾷ|τίμα|τετίμηταί|ἐτιμήσατε|τιμήσῃς|τίμησόν|ἐτιμήσασθε
ἀπαιτίζω|ἀπαιτίζοντες
ἄχθομαι|ἤχθοντο|ἀχθομένην|ἤχθετο|ἄχθομαι|ἀχθεσθέντες
γενειάω|γενειήσαντα
ἀποκόπτω|ἀπέκοψα|ἀποκόψειν|ἀπέκοψε
νηπιαχεύω|νηπιαχεύων
τμήγω|τμήξας|τμάγεν
ἡβάω|ἡβώοντα|ἡβῷμ̓|ἡβήσαντε|ἡβῶν|ἡβώωσα|ἡβώοντες|ἡβήσῃ|ἡβήσας|ἡβώοιμι
ἄγνυμι|ἔαξεν|ἆξαι|ἔαξαν|ἄξῃς|ἦξε|ἄξῃ|ἔαξε|ἀγνυμενάων|ἄγνυτον|ἄξαντ̓|ἄγη|ἐάγη|ἐάγῃ|ἆξον
νεύω|νεύοντα|νεῦσεν|νευόντων|νεῦον|νεύσω|νεύοιεν|νεῦσε|ἔνευεν|νεῦσ̓
ἐπιμύζω|ἐπέμυξαν
στενάχω|στενάχων|στενάχοντος|στενάχουσι|στενάχω|στενάχοντα|στενάχοντο|στενάχοντες|στενάχεσχ̓|στενάχοντι
μιστύλλω|μίστυλλε|μίστυλλόν|μίστυλλέν
παραπέμπω|παραπέμψαι|παρέπεμψεν
ἐξονομαίνω|ἐξονομήνῃς|ἐξονομῆναι
ἐξαρτύω|ἐξαρτυσόμεθα|ἐξηρτυμένα|ἐξηρτύοντο|ἐξηρτύετο|ἐξήρτυνται|ἐξαρτύεσθαι
συνάγνυμι|συνέαξε|ξυνέαξε|ξυνέαξαν
ἑλκυστάζω|ἑλκυστάζων
διικνέομαι|διίξομαι|διίκεο
περιρρέω|περίρρεε
εἰλυφάζω|εἰλυφάζει|εἰλυφόων
κεράννυμι|κεράσσατο|κερασσάμενος|κέρασσε|κεράσασα|κέρωνται|κέρασσεν|κεκράαντο
εἰσχέω|ἐσέχυντο
θλάω|ἔθλασεν|θλάσσε
ἀλφάνω|ἄλφοι|ἦλφον
εἴβω|εἴβοι|εἶβε|εἴβων|εἴβεις|εἶβεν|εἴβει|εἶβον
κεάζω|κεάσαιμι|κεκεασμένα|κέασσε|κεάσθη|κεάσσαι|ἐκέασσε|κέασε|κέασαν
προσπίλναμαι|προσεπίλνατο
νεωτερίζω|νεωτερίζειν|νεωτερίσωσι|νεωτερίσαι|νεωτερίζοντας
συνέπομαι|ξυνέσποντο
ἀωτέω|ἀωτεῖς|ἀωτεῖτε
τύφω|τύψεν
ἐπόμνυμι|ἐπώμνυον|ἐπώμοσε
κατακύπτω|κατέκυψε
ἰάπτω|ἰάπτῃ|ἰάπτῃς
νύσσω|νυσσομένων|νύξεν|νύξ̓|νύξε|νύσσοντες|νύξας|νύσσων
κατανεύω|κατανεῦσαι|κατένευσας|κατένευσεν|κατανεύσομαι|κατανεύων|καννεύσας|κατανεύσω|κατάνευσον|κατένευσα|κατένευσε
προάγω|προήγαγον|προαγαγεῖν
ἐξεναρίζω|ἐξενάριξας|ἐξεναρίξας|ἐξενάριξαν|ἐξενάριξεν|ἐξεναρίξῃς|ἐξεναρίξαι|ἐξενάριζεν|ἐξενάριξε|ἐξεναρίζεις|ἐξεναρίξει|ἐξεναρίξων|ἐξεναρίζων|ἐξενάριξα
ἐκπίνω|ἔκπιεν|ἔκπιον|ἐκπέποται
ἐπιτειχίζω|ἐπιτειχίζειν
ἐπινηνέω|ἐπενήνοθε|ἐπινήνεον
ἱδρύω|ἱδρύσασα|ἱδρύνθησαν|ἱδρυθεὶς|ἵδρυσεν|ἵδρυε|ἵδρυσε
ἐκκλύω|ἐξέκλυες
ἀπέχθομαι|ἀπέχθηται|ἀπεχθόμενος|ἀπέχθωνται
συμμίγνυμι|συμμίσγεται|ξυνέμειξαν|ξυμμείξαντες|ξυνέμισγον
καταφωράω|καταφωρᾶν
μορμύρω|μορμύροντα|μορμύρων
γείνομαι|ἐγείνατο|γεινομένῳ|γείνασθαι|γείνατο|γείνεαι|γεινόμεθ̓|γείνατ̓|ἐγείναο
διανοέω|διανοεῖσθαι
προλέγω|προλελεγμένοι|προύλεγον
φύω|πεφύασι|ἔφυσε|πεφυυῖα|πεφυῶτας|φῦ|φύονται|πεφύασιν|φύει|πεφύκει|φύντες|ἔφυν|φύεν|πεφυκέναι|ἔφυ|πεφύκασι|φύοντο
ἵημι|ἱεμένῳ|ἱεῖσαι|ἵεται|ἥσειν|ἵησιν|ἱεμένω|ἱεμένην|ἧκ̓|ἵεσθε|ἵεντ̓|ἵεν|ἧκεν|ἱεμένων|ἕσαν|ἱέμενόν|ἥσω|ἱέσθην|ἵει|ἧκε|ἱεμένη|ἧκα|ἱέμεναι|εἵη|ἕηκε|εἷναι|ἱέμενοί|ἱέμενός|ἱεῖσι|ἱεμένους|ἱέντες|ἱέμενον|ἥσει|ἧκαν|ἵησι|ἵετο|ἱέμενος|ἕντο|ἧκέ|εἵην|ἵετ̓|ἱέμενοι|ἵενται|ἱεμένοιο
ὀρθόω|ὤρθωσεν|ὤρθωσε|ὀρθωθείς|ὀρθωθεὶς
ὑποδείδω|ὑπέδεισαν|ὑπεδείδισαν|ὑποδείσαντες|ὑποδείσατε|ὑποδείσας|ὑποδείσασα|ὑποδείδἰ
ἀλιταίνω|ἀλιτέσθαι|ἤλιτεν|ἀλίτοντο|ἀλίτηται|ἀλίτωμαι|ἀλιτήμενός
ἀθερίζω|ἀθερίζω|ἀθέριζον
πεύθομαι|πεύθομαι|ἐπεύθετο|πευθόμενος|πεύθετ̓|πευθόμεθ̓|πεύθετο|ἐπευθόμεθα|πευθοίαθ̓|πευθέσθω|πεύθεσθαι
διασεύομαι|διέσσυτο
περισαίνω|περίσσαινον|περισσαίνοντες|περισσαίνουσι
προσέχω|προσεῖχον|προσσχόντες|προσεχόμενον
ἀναμορμύρω|ἀναμορμύρεσκε
ἐπίκειμαι|ἐπικείσετ̓|ἐπέκειντο
ἐκδιώκω|ἐξεδίωξε
περιστένω|περιστένεται
μετατροπαλίζομαι|μετατροπαλίζεο
ἐξέρχομαι|ἐξελθόντας|ἔξελθε|ἐξέλθωμεν|ἐξελθοῦσα|ἐξῆλθε|ἐξελθόντε|ἐξελθὼν|ἐξελθόντες|ἐξελθόντα|ἐξέρχονται|ἐξελθεῖν|ἐξελθών|ἐξελθέμεναι|ἐξῆλθον
ὑποδέχομαι|ὑπεδέξαντο|ὑπεδέξατο|ὑπέδεκτο|ὑπεδέξασθε|ὑποδέξομαι|ὑποδέξεαι|ὑπέδεξο|ὑποδέγμενος|ὑποδέχθαι
ὑπαλεύομαι|ὑπαλευάμενος
ἕωμεν|ἕωμεν
ἐρωέω|ἐρωεῖ|ἐρωήσει|ἐρώει|ἐρωήσουσι|ἐρωήσαιτ̓|ἐρωείτω|ἠρώησαν|ἐρωῆσαι
χραύω|χραύσῃ|ἔχραε
καταδέομαι|κατέδησεν
ἀπολιμπάνω|ἀπολείποντες
στρεφεδινέω|στρεφεδίνηθεν
μηνύω|μεμηνῦσθαι
ὑπομένω|ὑπέμειναν|ὑπέμεινεν|ὑπέμενον|ὑπομείναντες|ὑπέμεινε|ὑπέμεινα|ὑπομεῖναι
τρωπάω|τρωπάσκετο|τρωπῶντο|τρωπᾶσθαι|τρωπῶσα|τρωπᾶσθε
καταδημοβορέω|καταδημοβορῆσαι
σπένδω|σπείσας|σπεῖσάν|σπένδοντας|σπένδοντ̓|σπεῖσαι|σπεῖσον|σπένδεσκον|ἔσπεισαν|ἐσπεισάμεθα|σπένδεσκε|σπείσαντες|σπείσασκε|σπένδῃ|σπενδόμενοι|σπείσῃς|σπείσομεν|σπένδῃσθα|σπένδοντες|σπένδων
μιγάζομαι|μιγαζομένους
ἐρεθίζω|ἐρεθίζων|ἐρέθιζον|ἐρέθιζε|ἐρεθιζέμεν|ἐρεθίζω
δηθύνω|δηθύνῃσθα|δήθυνεν|δηθύνειν|δηθύνοντ̓|δηθύνων
ὀρίνω|ὤρινεν|ὤρινάς|ὀρίναις|ὀρινθέντες|ὀρινομένῳ|ὀρίνων|ὀρίνει|ὀρινομένη|ὀρινομένους|ὄρινεν|ὀρίνῃς|ὀρινόμενον|ὤρινε|ὀρίνθη|ὄρινα|ὠρίνθη|ὀρίνετον|ὀρίνονται|ὀρίνω|ὄρινε|ὀρινόμενοι|ὄρινας|ὀρινθείη|ὠρίνετο
ἐπιχειμάζω|ἐπιχειμάσαντες
ἐξακέομαι|ἐξακέσαιο|ἐξακέονται|ἐξακέσαιτο
ἀσπαίρω|ἤσπαιῤ|ἀσπαίροντας|ἀσπαίρουσα|ἤσπαιρε|ἤσπαιρον|ἀσπαίροντα|ἀσπαίροντες
σπάω|ἐσπάσατ̓|σπάσσασθε|ἔσπασεν|σπασθέντος|ἐσπάσατο|σπάσεν|σπασσάμενος|σπάσσατο|σπάσατ̓|σπασάμην
φείδομαι|φείδεο|πεφίδοιτο|πεφιδέσθαι|πεφιδήσεται|φειδομένους|πεφιδοίμην|φείδεσθαι|φείσατ̓|φειδόμενος
ἔρδω|ἔρξε|ἔρξον|ἔρδεσκες|ἔοργας|ἔρξαιμι|ἔρδωμεν|ἕρξον|ἕρδοι|ἐρξέμεν|ἔρξ̓|ἔρδειν|ἕρδειν|ἦρξέ|ἐοργὼς|ἕρξῃς|ἔρξῃς|ἔρξω|ἔρξασ̓|ἔρξανθ̓|ἕρδον|ἕρδεσκεν|ἔρξαι|ἔρξασα|ἔρδ̓|ἔοργε|ἐώργει|ἔρδουσα|ἐοργώς|ἕρξαντα|ἔρδοι|ἕρδ̓|ἕρδομεν
ὑποκλίνομαι|ὑπεκλίνθη
ἐκπλήγνυμι|ἔκπληγεν
μεταπαύομαι|μεταπαυόμενοι
ἀποστέλλω|ἀποστέλλουσιν|ἀποστέλλοντες|ἀποστέλλει|ἀποστέλλειν|ἀπέστειλαν
ἐπιπίλναμαι|ἐπιπίλναται
ἐκβοηθέω|ἐκβοηθήσαντες
κλαίω|κλαίουσα|κλαίοισθα|κλαύσομαι|κλαῦσε|κλαῖον|κλαιόντεσσι|κλαίῃσι|κλαύσας|κλαίοντας|κλαῦσεν|κλαιούσης|κλαῖε|κλαίων|κλαίεσκε|κλαίοντέ|κλαῖ̓|κλαύσονται|κλαίοντα|κλαίοντε|κλαίῃ|κλαῖεν|κλαίουσ̓|κλαίεις|κλαίειν|ἔκλαιον|κλαίωμεν|κλαίετον|κλαίοντες|κλαίομεν|κλαίω
ὁμηγυρίζομαι|ὁμηγυρίσασθαι
ἀνέζω|ἀνέσαντες|ἀνέσαιμι
καταπίπτω|καππεσέτην|κάππεσεν|κάππεσε|κάππεσ̓|κάππεσον
μυθέομαι|μυθέομαι|μυθήσομαι|μυθήσασθαι|μυθεῖτ̓|μυθήσαιο|μυθήσασθε|μυθήσεαι|μυθέαι|μυθεῖται|μυθεῖαι|μυθέσκοντο|μυθείσθην|ἐμυθεόμην|μυθεόμην|μυθησαίμην|μυθήσατο|μυθήσαιτο
θείνω|θείνων|ἔπεφνε|θεῖνε|θεινομένου|πεφάσθαι|πεφνόντα|ἔπεφνον|πέφανται|πέφνεν|πέφνῃς|πέφνον|πέφνε|θεινομένην|θείνῃ|θεινομένων|ἔπεφνες|ἔθεινε|θεινέμεναι|ἔπεφν̓|θείνας|ἔπεφνεν|πέφαται|πέφατ̓|πεφήσεαι|θεινόμεναι|πεφνέμεν|ἐπέφνετε|ἐπέφνομεν|πέφνῃ
περιστέλλω|περιστείλασα
ἀβακέω|ἀβάκησαν
ἐγγυάω|ἐγγυάασθαι
κυνέω|κύσειε|ἔκυσ̓|κύσσαι|κύνεον|κύσσ̓|κύνει|κύσσε|ἔκυσσε|κύσα|κύσε|κύσεν
δουλόω|ἐδουλώθη|δεδουλωμένους|δουλωθέντων|δουλώσειν|ἐδούλωσε|δουλωσάμενος|δουλωσόμενος
ἀντικελεύω|ἀντεκέλευον|ἀντεκελεύσθησαν
συντρέχω|συνέδραμον
παραδύομαι|παραδύμεναι
ἐπεύχομαι|ἐπεύξασθαι|ἐπεύξατο|ἐπεύχεο|ἐπευχόμενος|ἐπευχομένη|ἐπεύχετο|ἐπευξάμενος|ἐπεύξεαι|ἐπεύχεται
ἐπαλλάσσω|ἐπαλλάξαντες
ἐρέικω|ἐρεικόμενος
καταλαμβάνω|κατέλαβον|κατέλαβε|καταλαβεῖν|καταλαμβάνουσι|κατειλημμένους
κεύθω|κεύθω|κεύθωμαι|κεύσω|κεύθετε|κέκευθε|κεῦθε|κεκύθωσι|ἐκεκεύθει|ἔκευθεν|κύθε|κεύθει|κεύθῃ|κεῦθεν
ἄντομαι|ἤντετο|ἄντεσθ̓|ἀντομένη|ἤντετ̓|ἀντόμεναι
τεκμαίρομαι|τεκμαίρομαι|τεκμαιρόμενος|τεκμήραντο|τεκμήρατο|τεκμαίρεται|τεκμαίρομ̓
ὀνειδίζω|ὀνείδισον|ὀνειδιζόντων|ὀνειδίζεται|ὀνείδισας|ὀνειδίζων
ἀδέω|ἀδηκότες|ἁδήσειεν
ἀμελέω|ἀμελούμενοι|ἀμέλησεν|ἀμέλησε
κυδοιμέω|κυδοιμήσων|κυδοίμεον
ἐφανδάνω|ἐπιὴνδανε|ἐπιανδάνει|ἐφήνδανε|ἐπιήνδανε
σκήπτω|σκηπτόμενον|σκηπτόμενος
ἐκπίπτω|ἔκπεσε|ἐκπεσέειν|ἔκπιπτον|ἔκπεσον
ἐπιβάσκω|ἐπιβασκέμεν
ἀρήγω|ἀρῆξαι|ἀρηγέμεν|ἀρήγῃ|ἀρηξέμεν|ἀρήγεθ̓|ἀρήγειν|ἀρήγει|ἀρήγεις|ἀρήγων|ἀρήξειν
ἐμπίπλημι|ἐνέπλησεν|ἐνέπλησθεν|ἐμπλησάμενος|ἐνέπλησάν|ἐνιπλήσῃς|ἔμπλησον|ἐνιπλήσωσιν|ἐμπίπληθι|ἐνιπλησθῆναι|ἐμπλήσαντες|ἐμπλήσας|ἔμπλητο|ἐμπλησέμεν|ἔμπληντο|ἐμπλήσατο
διαπτοέω|διεπτοίησε
ἐπιμιμνήσκομαι|ἐπιμνησθεὶς|ἐπιμνησαίμεθα|ἐπεμνήσθη
προκαθίζω|προκαθιζόντων
ἐξορμάω|ἐξορμήσασα
διασκεδάννυμι|διεσκέδασ̓|διεσκέδασεν|διασκεδάσειεν
ὀρεχθέω|ὀρέχθεον
μετακιάθω|μετεκίαθε|μετεκίαθον
συμβάλλω|συμβλήσεαι|ξυμβαλόντες|ξύμβλητο|ξυμβλήμενος|ξυμβλήτην|σύμβαλον|ξυμβλήμεναι|ξύμβληται|ξύμβληντο|συμβλήμενος|συμβάλετ̓|συμβάλλετον
προσκαλέω|προσκαλέσαντές
μητιάω|μητιόωντι|μητιόωντο|μητιάασθε|μητιόωντες|μητιόωσα|μητιόωσι
ἰάχω|ἰάχων|ἴαχον|ἰάχοντα|ἰάχουσα|ἴαχεν|ἴαχε|ἰάχοντες|ἰάχοντος
ἀπονοστέω|ἀπονοστήσειν
αὐτοσχεδιάζω|αὐτοσχεδιάζειν
διαπλέω|διαπλεύσαντες
προσπλάζω|προσέπλαζε|προσπλάζον
κουρίζω|κουρίζων
ὁπλίζω|ὁπλίσαι|ὁπλίσσατο|ὁπλισόμεσθα|ὁπλιζώμεθα|ὅπλισσόν|ὁπλισάμεσθ̓|ὅπλισθεν|ὥπλισσε|ὡπλίζοντο|ὁπλίζοντο|ὁπλίσαθ̓|ὡπλίζετο|ὁπλίζονται|ὡπλίσσατο
ἴσκω|ἴσκουσ̓|ἴσκοντες
δειπνίζω|δειπνίσσας
παρεῖπον|παρειποῦσ̓|παρείπῃ|παρειπών
παιδεύω|παιδεύεται|παιδευόμενοι
ἀγυρτάζω|ἀγυρτάζειν
ἐγχειρέω|ἐγχειρεῖν
ἐπιπείθομαι|ἐπιπειθόμεναι|ἐπεπείθεθ̓|ἐπιπείθονται|ἐπιπείσομαι|ἐπιπείθηται|ἐπιπείθεθ̓|ἐπεπείθετο|ἐπιπείσεται|ἐπιπείσεαι|ἐπιπείθεο
ἀποτέμνω|ἀπέταμνε|ἀποταμνόμενον
πέρνημι|περνάμεν̓|πεπερημένος|πέρνασχ̓|περνὰς
ἑλκέω|ἑλκηθείσας|ἑλκήσουσ̓|ἕλκησε|εἵλκεον|ἑλκήσουσιν
ταρχύω|ταρχύσουσι|ταρχύσωσι
ἀβροτάζω|ἀβροτάξομεν
ὑλάω|ὑλάει|ὑλάοντο|ὕλαον|ὑλάουσιν
ναίω|ἔναιεν|ναίεσκε|ναῖεν|ναίουσ̓|ναίουσι|ἔναἰ|ναιέμεν|ναιόμενον|ναίεσκον|ναιομένην|ναίω|νάσσα|ναῖ̓|ναῖε|ἔναιον|νάσθη|ναιόμενα|ναιομένῳ|ναῖον|ἔναιε|ναίων|ναίεις|ναίοιτε|ναιέμεναι|ναίοντες|ναίειν|ναιομενάων|ναίοιμεν|ναίει|ναιομένη
ἀποπέμπω|ἀπέπεμψε|ἀπεπέμπομεν|ἀπέπεμπε|ἀποπέμψω|ἀπόπεμψον|ἀποπέμπετε|ἀπέπεμπον|ἀποπέμπω|ἀποπέμπει|ἀποπέμψῃ|ἀποπέμπουσιν|ἀποπέμπειν|ἀππέμψει|ἀπέπεμψα|ἀπέπεμψαν|ἀποπέμψωμεν|ἀποπεμπόμενοι|ἀπέπεμπεν|ἀπόπεμπε|ἀποπεμπέμεν
ἀποτίνω|ἀποτείσομεν|ἀποτινύμενοι|ἀποτίσεαι|ἀπέτισεν|ἀποτίσεται|ἀποτίσας|ἀποτῖσαι|ἀποτίσομαι|ἀποτίνων|ἀποτίνετον|ἀπετίσατο|ἀποτίνειν|ἀπέτισαν|ἀποτίσῃ|ἀπετίνυτο|ἀποτισέμεν|ἀποτίσεις|ἀποτινέμεν
ἀνακρίνω|ἀνακρινοῦντες
ὀρέγνυμι|ὀρεγνύς
κλέπτω|κλέπτε|ἔκλεψεν|κλέψαι|ἔκλεψε
φυτεύω|φυτεῦσαι|φύτευεν|φυτεύουσιν|φυτεύων|φυτεύσω|φυτεύει|φυτεύοντες|ἐφύτευσαν
προοράω|προεώρα|προορώμενοι
δηλέομαι|δηλήσαντο|δηλήσεαι|δηλήσατο|δηλήσαιτο|δηλήσεται|δηλήσασθαι|δηλήσηται|ἐδηλήσαντ̓
νεμέθω|νεμέθοντο
ἀποπνέω|ἀποπνείουσα|ἀποπνείουσαι|ἀποπνείων
ὑφαιρέω|ὑφελεῖν
προσπελάζω|προσπελάσας
ἐπιφρονέω|ἐπιφρονέουσ̓
ἀπέρχομαι|ἀπελθόντων|ἀπῆλθον|ἀπελήλυθε|ἀπελήλυθα|ἀπερχομένη|ἀπῆλθεν
μετονομάζω|μετωνόμασται
μεταμίγνυμι|μετέμισγον|μεταμίξομεν
ὑπεκτίθεμαι|ὑπεξέθεντο
παρατρέχω|παρέδραμον|παραδραμέτην|παρέδραμεν
ἰθύω|ἴθυσε|ἰθύσῃ|ἴθυσαν|ἰθύει|ἰθύσεἰ|ἴθυσεν|ἴθυσέν
ἀνατέλλω|ἀνέτειλε
ἐνοικέω|ἐνοικοῦντας|ἐνοικούντων
ἐξαποδύνω|ἐξαπέδυνε
παππάζω|παππάζουσιν
καθίημι|κάθεμεν|καθέηκα|καθίετε
πράσσω|πράσσειν|πράσσοντας|πρασσόντων|πράσσουσι|πρῆξαι|πεπραγμένον|πρήξαντα|ἐπράχθη|πράσσοντες|ἔπρασσον|πρήσσωμεν|ἔπρασσεν|πράξομεν|ἔπρασσε|πρήσσοντε|πράξοι|πρήξει|πρήσσῃσιν|ἔπραξε|ἔπρηξας|πρήσσεσκον|πράξαντες|πρᾶσσε|πρήσσοντες|πράσσωσι|πρήσσει|πρᾶξαι|πρήσσουσι|ἔπραξαν|πρήξεις|πρασσόμενα|πράσσων|πραχθέντων|πράξειν|πραχθῆναι
δαίνυμι|δαίνυντο|δαίνυσθ̓|δαινύῃ|δαίσειν|δαινύμενον|δαινύντα|δαίνυνται|δαίνυσθαί|δαινύσθω|δαινύμενοι|δαισάμενοι|δαίνυνταί|δαίνυνθ̓|δαινύατ̓|δαινυμένοισι|δαινυμένους|δαινυμένω|δαίνυσθε|δαίνυντ̓|δαίνυται|δαίνὐ|δαίνυ|δαίνυσθαι|δαίνυσαι|δαινῦτό
θαάσσω|θάασσε|θαασσέμεν|θάασσεν
κνάω|κνῆ
καταπύθω|καταπύθεται
ἱδρόω|ἱδρώοντα|ἱδρῶσαι|ἱδρώοντας|ἱδρώσει|ἵδρωσα|ἱδρώουσα
εὐφραίνω|ἐϋφρανέω|ἐϋφραίνοιτε|εὔφρην̓|ἐϋφραίνοιμι|εὐφραίνεσθαι|εὐφρανέειν|ἐϋφρήνῃς|εὐφρῆναι
προβάλλω|προβαλόντες|προβαλλομένοις|προβάλεσκε|προβέβληνται|προβαλοίμην|προβάλοντο
εἴδομαι|ἐείσατο|εἴδονθ̓|εἴδοντο|εἰσαμένη|εἴδεται|ἐεισαμένη|ἐείσαο|ἐεισάμενος|εἰσάμενος|εἰδομένη|εἴσατ̓|εἴσαιτο|εἰδόμενος|εἴσαντο
ἀπανύω|ἀπήνυσαν
ὑπάγω|ὕπαγον|ὕπαγε
συνάντομαι|συνήντετο|συναντέσθην|συναντόμενος
κρύπτω|κρύπτασκε|ἔκρυψαν|κρύψαντες|κρύψω|κρύφθη|κρύψαι|κεκρυμμένον|κρύψεν|κρύπτων|ἔκρυψε|κεκρυμμένα
ὀπιπτεύω|ὀπιπεύσεις|ὀπιπεύσας|ὀπιπεύεις
διεκπλέω|διεκπλέοντες
ἴσκε|ἴσκε|ἴσκεν
ἀποβαίνω|ἀποβάντες|ἀπέβησαν|ἀπέβη|ἀποβαίνειν|ἀπεβήτην|ἀπέβαινεν|ἀποβαινόντων|ἀποβᾶσιν|ἀπεβήσετο|ἀποβῆναι|ἀποβήσομαι|ἀποβαίνοντα
ἑδνόω|ἐεδνώσαιτο
συνναυμαχέω|ξυνναυμαχῆσαι
παραλέγω|παρκατέλεκτο|παραλέξομαι|παρελέξατο
αὐτονομέομαι|αὐτονομεῖσθαι
ἀλετρεύω|ἀλετρεύουσι
καταθέλγω|κατέθελξεν
τήκω|τηκομένης|τέτηκα|τηκόμενος|τῆκε|τήκετο
ἐναλλάσσω|ἐνηλλάγησαν
ὄρνυμι|ὄρσουσα|ὄρνυτε|ὄρσασ̓|ὄρθαι|ὤρετο|ὤρορεν|ὀρνυμένων|ὄρνυθ̓|ὠρώρει|ὀρνυμένου|ὀρνύμεν|ὄρνυσθε|ὤροῤ|ὦρτ̓|ὄρνυον|ὄρμενα|ὄρμενον|ὀρέοντο|ὄρνυσθ̓|ὤρνυτ̓|ὀρνύμενον|ὀρεῖται|ὄρνυτο|ὄρωρεν|ὀρνυμένοιο|ὄρσασκεν|ὄρνυντο|ὀρώρει|ὄρνυται|ὄρνυθι|ὄρσομεν|ὄρσευ|ὤρνυε|ὀρώρῃ|ὀρμένω|ὦρτο|ὄρσο|ὄρηται|ὄρσητε|ὀρνύμεναι|ὀρνυμένη|ὤρνυντο|ὄρνυτ̓|ὄρσε|ὀρώρηται|ὄρσῃ|ὄρσεο|ὄρσας|ὀρώρεται|ὤρνυθ̓|ὄρωρε|ὦρσε|ὄρσωμεν|ὦρσεν|ὄρσ̓|ὤρορε|ὦρσαν
προμαχίζω|προμάχιζε|προμάχιζεν
ἐκλύω|ἐξελύθη|ἐκλύσομαι
βάπτω|βάπτῃ
αἴθω|αἰθομένοις|αἰθομένοισιν|αἰθομένου|αἰθομένοιο|αἰθόμενον|αἰθομένας
ὁμοστιχάω|ὁμοστιχάει
ἀποδίδωμι|ἀποδώσομεν|ἀποδῷσιν|ἀποδοῖτε|ἀπέδωκε|ἀπέδοντο|ἀποδόσθαι|ἀποδοῦναι|ἀποδώσω|ἀποδόντες|ἀπέδοσαν|ἀπέδωχ̓
προδαῆναι|προδαεὶς
ἁνδάνω|ἁδεῖν|ἁνδάνει|εὔαδεν|ἁδηκότας|ἑαδότα|ἅδε|εὔαδε|ἑήνδανε|ἥνδανεν|ἅδοι|ἑήνδανεν|ἥνδανε
ὑποταρβέω|ὑποταρβήσαντες
αἰσχύνω|ᾔσχυνε|ᾔσχυνας|αἰσχυνόμενός|αἰσχυνέμεν|αἰσχυνόμενοι|αἰσχύνεσθε|αἰσχύνει|ᾐσχυμμένος|αἰσχύνωσι|αἰσχύνομαι|αἰσχύνεσθαι|αἰσχύνων
καταμάω|καταμήσατο
σιγάω|σίγα
παραπλέω|παρέπλευσαν|παρέπλω|παρέπλεον
ἐπαλέξω|ἐπαλεξήσων|ἐπαλεξήσουσαν
ψύχω|ψύξασα
εἰσοιχνέω|εἰσοιχνεῦσι|εἰσοιχνεῦσαν
νίζω|νένιπται|νίψατο|νιψάμενοι|νίψει|νίζετο|ἔνιψ̓|νίζ̓|νίζον|νίψω|νίζε|νιψάμενος|νίζοντες|νίψασθαι|νίψον|νίζειν|νίψεν
ἐπαγάλλομαι|ἐπαγαλλόμενος
ἐκκαταπάλλομαι|ἐκκατεπᾶλτο
περιδίδομαι|περιδώσομαι|περιδώμεθον
κακοπαθέω|κακοπαθεῖν|κακοπαθοῦντες
ἐπιπνέω|ἐπιπνεύσωσιν|ἐπιπνείουσα|ἐπιπνείῃσιν
πείθω|πείσεις|πιθοίατο|πείσειαν|πεισθῆτε|ἔπειθεν|πείθεις|πείσονται|πεποίθομεν|πεποίθω|ἐπεποίθει|πείσομ̓|πεπιθήσω|πιθέσθαι|πεποίθασίν|πείσειν|πείσεἰ|πείθονται|πίθεσθε|πείθοντο|ἐπείθοντο|πείθεό|πεῖθ̓|πειθομένοις|ἐπίθοντο|πεπιθοῦσα|πειθέσθην|πίθοντο|πιθήσεις|πείθεο|πείσομαι|πεπίθοιμεν|πείσειε|πειθόμενοι|πεῖθεν|πεισθέντες|πέποιθε|πειθοίατο|πεπίθοιεν|πειθόμενος|πεποιθώς|πιθώμεθα|πειθομένῳ|πείθω|πίθεσθέ|πιθήσας|πείσει|πίθεσθ̓|πείσαντες|πείθῃ|πείθωνται|πεποιθὼς|ἔπεισεν|πείθοντ̓|πίθηαι|πείθοντό|πείσεται|πειθώμεθα|πεισθεὶς|ἐπέπιθμεν|πίθοιο|πίθηται|πεποιθότας|πιθόμην|ἐπείθετο|ἔπεισε|πέποιθα|πείθεθ̓|πεποιθότες|πείθεσθαί|πίθοιό|πείσεσθαι|ἔπειθον|πιθέσθων|πείθηται|ἔπειθε|πεισέμεν|πείθεσθ̓|πεῖθον|πεπίθοιθ̓|πείθομαι|πιθέσθην|πείσεαι|πεισθέντων|πείθευ|πεποίθεα|πείθοντες|πεῖθε|πείθει|πεπιθεῖν|πεποίθῃς|πεπίθωμεν|πείθεσθαι
δακρυπλώω|δακρυπλώειν
ψηλαφάω|ψηλαφόων
προνοέω|προνοουμένων|προνοῶν|προνόησαν|προνοῆσαι
διασκίδνημι|διασκιδνᾶσιν
στυγέω|στυγέει|στύξαιμι|ἔστυγον|στυγέῃσι|στυγέῃσιν|στυγέουσι|στυγέῃ
ἀποδύω|ἀποδύντες
ἐρύκω|ἐρύκει|ἔρυκε|ἔρυξα|ἐρύκεσθον|ἔρυξε|ἐρύκω|ἐρύκεσθαι|ἐρύκοι|ἐρυκάκοι|ἐρύξομεν|ἐρύξω|ἔρυκεν|ἐρύκακε|ἐρύκεται|ἐρύξει|ἐρυκακέειν|ἐρυκάκετε|ἐρύκεις|ἔρυξαν|ἐρύξας|ἐρύκων|ἠρύκακε|ἐρύκομαι|ἐρύκακεν|ἐρυκόντων|ἐρύκεαι|ἐρυκέμεν|ἔρυξον
ἀπαλοάω|ἀπηλοίησεν
ὀχέω|ὀχέεσθαι|ὀχέοντας|ὀχέειν|ὀχέων|ὀχήσατο|ὀχέεσκον|ὀχήσονται
ἐξυβρίζω|ἐξυβρίζομεν
εὐνάζω|εὐνάζοντο|εὐνάσω|εὐνάζεσθαι|εὐνάζετο
φρονέω|φρονέοντε|φρονέοντι|φρονέουσα|φρονέω|φρονέων|φρόνεον|φρονέῃσ̓|φρονέεις|φρονέοντ̓|φρονέειν|φρονέῃσι|φρονέουσ̓|φρονέοντα|φρονεόντων|φρονέουσιν|φρονέουσι|φρονέοντες
συναδικέω|ξυναδικεῖν|ξυναδικῶσιν
κινέω|κινῆσαι|κινεῖν|κίνησεν|κινοῦντες|κινήθη|κίνησε|ἐκίνησαν|κινήσαντες|κινηθέντος|κινήσῃ|ἐκίνηθεν|κινήσαντος|κινήσας
δατέομαι|δάσασθαι|δάσσαντο|δάσσασθαι|δατεώμεθα|δατέοντο|δασάσκετο|δάσωνται|δατεῦντο|δάσσαντό|ἐδάσσατ̓|δασαίμεθα|δάσονται|δέδασται|δασσάμεθ̓|δασσάμενοι|δατέονται
ἔξειμι|ἐξιέναι|ἔξειμι|ἔξεισθα|ἐξίασιν|ἔξιτέ|ἔξεσσι|ἐξιὼν|ἐξῄει|ἐξῇσαν
ἐκπτύω|ἐξέπτυσεν
ἀσχάλλω|ἀσχάλλῃς
φημί|ἔφατ̓|ἔφη|φησιν|ἔφαν|φάτ̓|ἔφαντο|φασ̓|φάμενοι|φησὶν|φὰν|φάο|φατ̓|φάν|φαῖμεν|φάντο|φαμὲν|φὴ|φασι|φῇσιν|φάσθαι|ἔφαμεν|φάντες|φημί|φησ̓|φημὶ|φαμεν|φάθ̓|φημ̓|φάμεν|φάσαν|φῆσθα|φήῃ|φασιν|φάμενος|φαίη|φασὶν|ἐφάμην|φῂς|ἔφην|φαίην|φαμένη|φησι|φησὶ|φῆ|ἔφασαν|φησί|φαίης|ἔφησθα|φασὶ|πεφασμένον|ἔφης|φάσθω|φῇσθα|ἔφατο|φὰς|φημι|φάσ̓|φῇ|φασίν|ἔφαθ̓|φῆς|φατε|φήσει|φάσθ̓|ἔφαντ̓|φάτο|φῆν
ἐγρηγορόων|ἐγρηγορόων
καταικίζω|κατῄκισται
μωμάομαι|μωμήσονται
προσειλέω|προτιειλεῖν
ἐπιτίθημι|ἐπιτίθενται|ἐπέθηχ̓|ἐπιθεῖναι|ἐπιθήσεις|ἐπιθήσει|ἐπιθεῖτε|ἐπιθέντε|ἐπιθήσομεν|ἐπέθηκεν|ἐπέθηκα|ἐπιθεῖσα|ἐπιθήσω|ἐπίθες|ἐπέθηκε|ἐπιθείη
ἐπιτολμάω|ἐπιτολμάτω|ἐπετόλμησε
ἐκρήγνυμι|ἐξέρρηξεν|ἐξέρρηξε
παρανηνέω|παρενήνεον|παρενήνεεν
μοχλέω|ἐμόχλεον
περικήδομαι|περικήδετο
περιπροχέομαι|περιπροχυθεὶς
εὐχετάομαι|εὐχετόῳτ̓|εὐχετόωντο|εὐχετόωνται|εὐχετοῴμην|εὐχετάασθαι
ἔσθω|ἔσθουσ̓|ἦσθ̓|ἔσθων|ἐσθέμεναι|ἦσθε|ἔσθειν|ἔσθουσαι|ἔσθοντες
αἰόλλω|αἰόλλῃ
ἐνερείδω|ἐνέρεισαν
ἀνασκοπέω|ἀνεσκόπουν
θεμιστεύω|θεμιστεύοντα|θεμιστεύει
αὐδάω|αὐδήσασχ̓|αὐδήσαντος|αὐδησάσης|ηὔδα|αὔδα|αὐδήσασκεν
διαμάω|διάμησε
κατέπεφνον|κατέπεφνε|καταπέφνων|κατέπεφνεν|καταπέφνῃ|κατέπεφνον
ἐπαρτύω|ἐπήρτυε
ἱκνέομαι|ἵκηται|ἱκόμεσθα|ἱκοίμεθα|ἵκοιο|ἵξεται|ἵκοισθε|ἷκεν|ἱκνούμενον|ἱκόμεθ̓|ἱκέσθην|ἱκνεύμεσθα|ἱκέσθω|ἱκοίμεθ̓|ἱκώμεθα|ἵκευ|ἱκοίμην|ἵκωμι|ἵξετ̓|ἵκεσθον|ἱκόμεσθ̓|ἱκέσθ̓|ἵκοιτ̓|ἵκεο|ἵκεθ̓|ἵκοι|ἱκοίατο|ἵκηαι|ἵκοντο|ἱκέσθαι|ἵκησθε|ἵξεσθαι|ἵκωνται|ἵκετο|ἵκῃ|ἵκοιτο|ἱκνεύμεναι|ἱκόμην|ἵξομαι|ἵκωμαι|ἵκετ̓
ἀπομάχομαι|ἀπομάχεσθαι
ἐπικερτομέω|ἐπικερτομέων
λάπτω|λάψοντες
γανάω|γανόωσαι
πειραίνω|πειρήναντε
ἐκκαθαίρω|ἐξεκάθαιρον
ἐγκλίνω|ἐγκέκλιται
προβοάω|προβοῶντε
περιτυγχάνω|περιτύχωσιν|περιτυχόντες
ὠδίνω|ὠδίνουσαν|ὠδίνων
πολεμόω|πολεμοῦσιν|πολεμοῦντας|ἐπολεμώθη|ἐπολέμουν|ἐπεπολέμωτο|πολεμοῦται
στάζω|στάξε|στάξον|στάξ̓
διαμαρτάνω|διαμαρτὸν
κυδιάω|κυδιόωντες|κυδιόων
προστυγχάνω|προστυγχάνοντας
ἀπομηνίω|ἀπομηνίσει|ἀπομηνίσας|ἀπομηνίσαντος
δουλεύω|δουλευόντων|δουλεῦσαι
γυμνόω|γυμνωθέντα|γυμνοῦσθαι|γυμνώθη|γυμνωθείη|ἐγυμνώθησάν|ἐγυμνώθη
ἀποκρίνω|ἀποκριναμένων|ἀπεκρίναντο|ἀποκεκρίσθαι|ἀποκρινθέντε|ἀποκρινάμενοι|ἀποκρίνασθαι
γοάω|γοήμεναι|γοάοιεν|γοόωσά|γοόωντας|γοόωντες|γοόωντά|γοόωσα|γοόωσαν|γοάασκεν|γοήσεται|γοῶντες|γοάοιμεν|γόων
εἰκάζω|εἰκάζεσθαι|εἰκάζειν
λυπέω|λυπεῖν
πωλέομαι|πωλεύμενοι|πωλέσκετο|πωλεῖταί|πωλέ̓|πωλεῖτ̓|πωλήσεαι|πωλεύμην
ἀναμάσσω|ἀναμάξεις
ἀναίσσω|ἀναΐσσουσι|ἀναΐξασα|ἀνήϊξαν|ἀναΐξας|ἀναΐξειαν|ἀναΐξαντε|ἀναΐξαντ̓|ἀναΐξαντες|ἀναΐξειεν
λεύσσω|λεύσσουσι|λεύσσουσιν|λεύσσω|λεῦσσε|λεύσσει|λεύσσετε|λεύσσων|λευσσόντων|ἐλεύσσομεν|λεῦσσ̓
ἀείρω|ἄωρτο|ἀερθείς|ἤειραν|ἀείραντες|ἀέρθη|ἀειρόμενοι|ἀείροντο|ἄειρεν|ἄειραν|ἀείρετο|ἀείρας|ἀειράμενος|ἤειρεν|ἄερθεν|ἀροίμεθά|ἀειράσας|ἀειρομένων|ἀεῖραι|ἀειρομένη|ἀερθεὶς|ἀείραι|ἀείρων|ἀειρόμενος|ἀειρόμενον|ἀειραμένη|ἀειρέσθην|ἄειρε
ἐπαίρω|ἐπαείρας|ἐπαιρόμεθα|ἐπαίρεσθαι|ἐπαιρώμεθα|ἐπαιρόμενος|ἐπαρθέντας|ἐπαιρόμενοι
ἀθλέω|ἀθλήσαντε|ἀθλήσαντα
ἐπακούω|ἐπακοῦσαι|ἐπήκουσεν|ἐπακούεις|ἐπακούσω|ἐπακούσαι|ἐπακούσαις|ἐπακούσῃ|ἐπάκουσαν|ἐπακούει
διώκω|διώκεται|διωκέμεναι|διωκόμενος|διώκοι|ἐδίωκεν|διώκεις|διωκόμενον|διώκετο|δίωκε|διώκει|διώκοντες|διώκω|διωκομένη|διώκειν|διωκέμεν|διώκετον|διώκων
ἐξαυδάω|ἐξαύδα
ναρκάω|νάρκησε
ἀναπείρω|ἀμπείραντες
ἐφέπω|ἐπίσπῃ|ἐπισπόμενος|ἐπισπόμενον|ἐπίσποι|ἐπίσπῃς|ἐπισπέσθαι|ἐφέποντες|ἐφέποι|ἔφεπε|ἐπέσπεν|ἔφεπ̓|ἐφέψειν|ἐπισπόμενοι|ἐφέπειν|ἐφέψεις|ἐφέπεσκον|ἐφέπων|ἐπέσπον|ἐπισπεῖν
ἰνδάλλομαι|ἰνδάλλεται|ἰνδάλλετο
πάλλω|πῆλέ|πάλλεν|πάλλειν|πῆλαι|παλλομένη|πάλλ̓|πῆλ̓|πάλλε|πάλλον|παλλόμενος|πάλτο|παλλομένων|πάλλων|πάλλεται|πάλλομεν
καγχαλάω|καγχαλόων|καγχαλόωσα|καγχαλόωσι
θηλέω|θήλεον
μέλδομαι|μελδόμενος
ἀρόω|ἀρηρομένῃ|ἀρόωσιν
κάμπτω|ἔκαμψαν|κάμψειν|ἔκαμψε|κάμψῃ
κατηφέω|κατηφήσας|κατήφησάν
βουλεύω|βουλευόμενοι|βουλεύσαντε|βουλευσαμένους|βουλεύσησθε|βουλεύσωμεν|βουλεύουσιν|βουλεύει|βουλεύουσι|βουλευσάμενοι|ἐβουλεύοντο|βουλεύωσ̓|βούλευε|βούλευσα|βεβουλευμένοι|βουλεύσομεν|βουλεύσῃ|βουλευθῆναι|βουλευέμεν|βουλευομένοις|βουλεύσεσθαι|βουλεύειν|βουλευόντων|βουλεύεσθε|βουλεύεσθαι|βουλευομένους|βουλευόμενος|βουλεύσας|βουλεύῃσι|βουλεύῃσθα|ἐβούλευσας|βουλεύσεσθε|βούλευον|βουλεῦσαί|βούλευσαν|βουλευσέμεν|βουλεύσατο
ἀγκάζομαι|ἀγκάζοντο
εἰσαφικάνω|εἰσαφίκανε|εἰσαφίκανεν
ἰύζω|ἰύζουσιν|ἰΰζοντες
μύω|μύσαν|μέμυκεν
νεοχμόω|ἐνεόχμωσε
ἀφραδέω|ἀφραδέουσιν|ἀφραδέοντι
κοπρίζω|κοπρήσοντες
δειροτομέω|δειροτομήσας|δειροτομῆσαι|δειροτομήσει|δειροτομήσεις
προσαμύνω|προσαμύνομεν|προσαμύνει|προσαμῦναι
προσεπιστέλλω|προσεπεστάλθαι
κελαρύζω|κελαρύζει|κελάρυζε|κελάρυζεν
πενθέω|πενθῆσαι|πενθήμεναι|πενθείετον
καταλήθομαι|καταλήθοντ̓
μετρέω|μετρήσαντες
ἠλάσκω|ἠλάσκουσαι|ἠλάσκουσιν
ἀφραίνω|ἀφραίνει|ἀφραίνοντα|ἀφραίνεις
παρατρέω|παρέτρεσσαν
τιμωρέω|τιμωρήσασθαί|τιμωρούμενοι|τιμωροῦντες|τιμωρήσονται|τιμωρήσετε|τιμωρεῖν|ἐτιμωροῦντο|τιμωρεῖσθαι|τιμωρουμένοις
ἀλεγίζω|ἀλεγίζει|ἀλεγίζεις|ἀλέγιζε|ἀλεγίζω
παρέλκω|παρέλκετο
θήγω|θηξάσθω|θήγων|θήγει
ἀνώγω|ἠνώγειν
κλύω|ἔκλυε|κλῦθί|κλῦθι|κέκλυτέ|ἔκλυεν|κλῦτε|ἔκλυον|κέκλυτε|κλῦτέ|κλύον|κέκλυθι|ἔκλυες
ζέω|ζέε|ζέσσεν|ζεῖ
ἀλυσκάζω|ἀλυσκάζω|ἀλυσκάζοντι|ἀλυσκάζων
νοσφίζομαι|νοσφισσαμένη|νοσφισάμην|νοσφιζοίμεθα|νοσφισθείς|νοσφισσαμένην|νοσφίσατ̓|νοσφίζεαι
μίσγω|ἐμισγέσκοντο
κατασπάω|κατεσπάσθη
κατακλάω|κατέκλων|κατεκλάσθη
ἱππάζομαι|ἱππάζεαι
ἀτιμάω|ἠτίμησεν|ἀτίμα|ἠτίμησ̓|ἀτιμήσουσι|ἀτιμήσεἰ|ἀτίμων|ἀτιμῆσαι|ἀτιμήσαιτε|ἀτιμήσειε|ἠτίμησας|ἀτιμήσασ̓|ἀτιμᾷ
πάρειμι|παρεόντων|πάρεισιν|παρὸν|παρεόντ̓|παρόντες|παρέσται|πάρεστέ|παριών|παρέμμεναι|παρεὼν|πάῤ|παρόντι|πάρεστιν|παρόντα|παριὼν|παρῆεν|παροῦσι|παριόντες|παρεόντε|πάρεσαν|παρόντος|πάρειμι|παρεῖναι|πάρεστι|παρούσῃ|παρεόντος|παρῆν|παρείη|παρόν|παρουσῶν|παρῆσαν|παροῦσα|παρέασι|παρέσσομαι|παρεόντα|παρέσσεται|παρεόντι|παρῆσθα|παρόντων
σμήχω|ἔσμηχεν
ἀποκρεμάννυμι|ἀπεκρέμασεν
ἐξοικίζω|ἐξοικίσαντες
αἰτίζω|αἰτίζῃ|αἰτίζων|αἰτίζεις|αἰτίζειν
προσαίσσω|προσαΐξας
σκηρίπτομαι|σκηριπτόμενος|σκηρίπτεσθ̓
πλήθω|πλήθοντι|πληθούσας|πλήθωσι|πλῆθ̓|πλήθει|πλήθων|πλήθουσαν|πλήθουσι
ἀξιόω|ἠξίωσεν|ἀξιούτω|ἀξιώσαντες|ἠξίουν|ἀξιοῦμεν|ἀξιοῦντες|ἀξιοῦντος|ἠξίωσαν|ἠξίωσα|ἀξιοῖ|ἠξιώσαμεν
ἀποπλήσσω|ἀποπλήξας
ἀπό-ἀχθέω|ἀπηχθημένους
βαμβαίνω|βαμβαίνων
προέχω|προύχοντα|προὐχούσῃ|προύχουσιν|προύχοντο|προύχοντες|προύχουσι|προύχονται|πρόεχ̓|προὐχούσας|προύχοντας|προὔχοντι|προύχειν|προὔχοντα|προύχων
βλεμεαίνω|βλεμεαίνει|βλεμεαίνων
οἰνοποτάζω|οἰνοποτάζει|οἰνοποτάζων
παρακαταβάλλω|παρακάββαλον|παρακάββαλεν
κάρφω|κάρψω|κάρψεν
ἔφημαι|ἐφήμενοι|ἐφήμενος
ἀνέλκω|ἄνελκε|ἀνελκόμενον|ἀνέλκων|ἀνέλκει
ἐπεῖδον|ἐπιδόντα
εἰσέρχομαι|ἐσέλθετε|εἰσῆλθεν|εἰσελθών|εἰσέλθῃσι|ἐσελεύσομαι|εἰσελθὼν|εἰσήλυθον|εἰσῆλθ̓|ἐσελθεῖν|ἐσέρχονται|ἐσέρχεται|ἔσελθε|εἰσελθοῦσα|εἰσῆλθε|εἰσήλυθεν|εἰσῆλθον|εἴσελθε|ἐσελθόντας|ἐσελθών|εἰσέρχεο
δοκέω|δοκέω|ἐδόκουν|δεδογμένον|δοκοῦσιν|δοκεῖτε|δοκοῖεν|δοκέεις|δοκοῦσα|δοκοῖμεν|ἔδοξε|δοκεῖν|δοκῶν|δοκοῦμεν|δόξομεν|δοκοῦσι|ἔδοξεν|δόκησε|ἐδόκει|δόξῃ|δόξασιν|δοκῇ|δοκέει|δοκῶ|δοκοῦντες|δοκεῖ|δοκέουσι|δοκείτω
μεθίημι|μεθέμεν|μεθίῃσι|μεθιέντας|μεθίεμεν|μεθιέμεν|μεθήσει|μεθείω|μεθίει|μεθῆκε|μεθείη|μεθίεις|μεθιεῖς|μεθῶμεν|μεθήσετε|μεθησέμεναί|μεθιέντα|μεθησέμεν|μεθῆκεν|μεθέηκεν|μεθιεῖ|μεθέηκε|μεθίετε|μεθήσω|μεθιέμεναι|μεθήσομεν|μεθέηκα|μέθιεν
δοάσσατο|δοάσσατο|δοάσσεται
δοξάζω|δοξάζομεν
κατίσχω|κατισχέμεναι|καταΐσχεται|κατίσχει|κατίσχεαι
ἀφαρπάζω|ἀφαρπάξαι
ἐπιμάσσομαι|ἐπιμάσσεται
μεταπρέπω|μεταπρέπω|μεταπρέπει|μετέρεπον|μετέπρεπεν|μετέπρεπον|μετέπρεπε
προτίθημι|προυτίθεσαν|προθεὶς|προθέουσιν|προύθηκεν
φλεγέθω|φλεγέθουσιν|φλεγέθει|φλεγέθοντι|φλεγεθοίατο
δαίω|δαῖέ|δαιόμενος|δαῖον|δάηται|δεδαίαται|δαιομένων|δαίετο|δέδηε|δαίεται|δαιόμενον|δέδαε|δαῖεν|δεδήει|δέδηεν|δαῖε
ὑποπίπτω|ὑποπεπτηῶτες
ἐξαπατάω|ἐξαπατῆσαι|ἐξαπάτησεν|ἐξαπατήσειν
ἐνδοιάζω|ἐνδοιάζῃ|ἐνδοιασθῆναι
ἀπό-χράω|ἀπεχρήσαντο
οἴγω|ᾦξε|οἴξασα|ὠΐγνυντο|ὤιξεν|ὤιξε|ὤϊξάν|ὤϊξαν|ὤϊξε|ὤϊξεν
ἀπαλέξω|ἀπαλεξήσαιμι|ἀπαλεξήσειν
ἀντανάγω|ἀνταναγαγόμενοι|ἀνταναγομένας
παιανίζω|ἐπεπαιάνιστο
παραλαμβάνω|παραλαβόντες|παραλαβεῖν|παρέλαβον|παραλαβὼν
ἐπαίσσω|ἐπαΐσσων|ἐπαΐξασθαι|ἐπήϊσσον|ἐπαΐσσοντα|ἐπήϊξαν|ἐπαΐσσει|ἐπήιξα|ἐπαῖξαι|ἐπαΐξανθ̓|ἐπαΐξασκε|ἐπαΐξαντες|ἐπαΐξας|ἐπαΐσσονται|ἐπαΐξαι
βύω|βεβυσμένον
δονέω|δονήσας|ἐδόνησεν|δονέουσι
κατάγνυμι|κατέαξε|κατάξοντες|κατεάξαμεν
τεταγών|τεταγὼν
τρομέω|τρομέουσι|τρομέοντο|τρομεοίατο|τρομέεσθαι|τρομέεις|ἐτρόμεον|τρομέει
μετριάζω|μετριάζομεν
ἀντεπιτάσσω|ἀντεπέταξαν
ἐρχατάομαι|ἐρχατόωντο
καταφέρω|κατοίσεται|καταφέρεται
παραείδω|παραείδειν
ἀντεγγράφω|ἀντενεγέγραπτο
πλίσσομαι|πλίσσοντο
ἀμφιξέω|ἀμφέξεσα
χωλεύω|χωλεύων
ἐνδείκνυμι|ἐνδείξομαι
ἀναπλέω|ἀνεπλέομεν|ἀναπλεύσεσθαι|ἀναπλεύσαντες
ἀποξύω|ἀποξύσας
ἐνίσσω|ἐνισσέμεν|ἐνίσσομεν|ἐνισσόμενος|ἐνίσσων
καταβοάω|κατεβόων
περιτρέω|περίτρεσαν
συνόχωκα|ξυνέχουσι|συνοχωκότε|σύνεχον
ὠφελέω|ὠφελούμενοι|ὠφελεῖ|ὠφελῆσαι|ὠφεληθέντας
ἀφρέω|ἄφρεον
ἀναβάλλω|ἀνάβαλλε|ἀνεβάλλετο|ἀμβαλλώμεθα
ὑποθερμαίνω|ὑπεθερμάνθη
ἐξίημι|ἐξέμεν|ἐξιέναι|ἐξίησι
εἰσκομίζω|ἐσεκομίσαντο
προπέμπω|προύπεμψαν|προὔπεμψε|προὔπεμψεν|προπέμψαντες|προὔπεμψα|προὔπεμψ̓
καταλεύω|κατέλευσαν
ἱλάσκομαι|ἱλάσσεαι|ἱλάσκεσθαι|ἱλάσσομ̓|ἱλασόμεσθα|ἱλάσκονται|ἱλάσκοντο
ἐρητύω|ἐρητύετ̓|ἐρήτυον|ἐρητύοντο|ἐρήτυθεν|ἐρητύειν|ἐρητύεται|ἐρητύσασκε|ἐρητύσειέ|ἐρητύοντό|ἐρήτυε
ἐρέφω|ἔρεψαν|ἔρεψα
ἐφέζομαι|ἐφεζόμενος|ἐφεζομένη|ἐφέζετο|ἐφέζεσθαι|ἐφεζόμενοι
ἐπιφοιτάω|ἐπιφοιτῶντες|ἐπιφοιτῶν
τεκταίνομαι|τεκτήνατο|τεκτήναιτο
ἀνευρίσκω|ἀνηυρέθη
ἀτιτάλλω|ἀτιτάλλω|ἀτίταλλ̓|ἀτίταλλεν|ἀτιταλλέμεναί|ἀτιταλλομένην|ἀτίτηλα|ἀτίταλλε|ἀτίταλλον
καθάλλομαι|καθαλλομένη
αἱρέω|ἕλεσκε|ἕλον|ἕλοντο|ἑλόντες|ἕλῃς|ἑλόντ̓|ἕλεν|ἕλοιτο|ἕλοις|ἕλῃσι|ἑλὼν|ἑλόντων|ἕλῃ|ἑλοίμεθα|ἑλοίατο|εἷλ̓|εἷλεν|ἕλοιμί|ἕλοιεν|ἑλέτην|ἕλωσί|ἕλεσκον|ᾕρεον|ἑλόντε|ἑλομένους|ἑλέειν|ἑλοῦσα|ἕλετο|ἕλητε|αἱρεύμενοι|ἕλοι|ᾕρεε|ἑλοῦσ̓|αἱρησέμεν|εἵλομεν|ἕλεθ̓|ἑλοῦσαι|ἑλών|ἕλοιμεν|ἑλέσθαι|ἕλεσθε|ἕλωμαι|αἱρήσομεν|ἕλωσι|ἕλ̓|αἱρήσεαι|εἱλόμεθ̓|ἕλῃσιν|ᾑρηκότες|εἷλόν|αἱρεῖ|ἕλῃσί|ἑλέσθω|αἱρείτω|ἑλεῖν|εἷλον|ἑλόμεσθα|ᾕρηντο|αἱρήσομαι|εἵλετ̓|ἑλόμην|ἕλες|ᾑρεῖτ̓|εἵλευ|ἕλευ|αἱρήσειν|εἵλοντο|ἕλοιο|ᾑρηκότας|ἕλω|ἑλέτω|ᾕρει|ἑλοίμην|εἷλε|αἱρήσει|ἕλετ̓|ἕλωνται|ἕλωμεν|ἕληται|εἷλες|εἵλετο|ἕλε
διαείδω|διαείσεται|διαείδεται
ἐνάγω|ἐνῆγον
φάω|φάε
αἰνίζω|αἰνίζομ̓
συμπολεμέω|ξυνεπολέμει|ξυμπολεμησάντων|ξυμπολεμήσαντες
περισκοπέω|περισκοπῶν
καταστρέφω|κατεστρέψαντο|κατεστραμμένων|κατεστρέφοντο
συνεπιτίθημι|ξυνεπέθετο
δολοφρονέων|δολοφρονέων|δολοφρονέουσα
παύω|παυώμεσθα|ἐπαύσαντο|παῦσε|παυσαμένους|παύσαιτό|παύσεσθ̓|παύετ̓|παύσαμεν|παυσάμενόν|παυέσκετο|παυσώμεσθα|παῦσεν|πεπαυμένοι|ἔπαυσας|ἐπαύσατο|παύσεσθαι|παυσάμενοι|παύειν|παύσῃ|παυσάμενον|παῦσ̓|παῦσαν|παύσειεν|παύω|ἐπαυσάμεθα|παύσειε|παύσουσα|παύσῃσι|παυσαμένων|παυσθήσεται|παύσασαι|παυέσθων|παύἐ|παύσομεν|παύσασθε|παύεσθαι|παυομένῳ|πέπαυμαι|παύεσκον|παύσατ̓|παύσατο|παυσάσθην|παύσασθαι|παύσωμεν|ἔπαυσε|παῦσαι|παυέσθω|παύομαι|παυέμεναι|πέπαυται|παύεσθον|παύσαντο|παυσάμεθα|ἐπέπαυτ̓|ἐπαύετο|παύσαισθε|παῦε
διαδηλέομαι|διεδηλήσαντο
ὁμόω|ὁμωθῆναι
ἐπί-ἐπικουρέω|ἐπεκούρουν
ἐπανατίθημι|ἐπανθέμεναι
ὑπακούω|ὑπακοῦσαι|ὑπακούσεσθε|ὑπακούσαντες|ὑπακούειν|ὑπάκουσε|ὑπήκουον|ὑπακούει|ὑπήκουσαν
συνίστημι|συνεσταότος|ξυνειστήκεσαν|ξυνέστη
ἐκδέρω|ἐκδείρας
καταγηράσκω|κατεγήρα|καταγηράσκουσιν
ἀποβρίζω|ἀποβρίξαντες
δάκνω|δάκε|δακέειν
ἐθείρω|ἐθείρῃ
ἰσόω|ἰσωσαίμην
ἰθύνω|ἰθυνομένων|ἰθύνεις|ἰθυνθήτην|ἴθυνα|ἴθυνε|ἴθυνεν|ἰθύνοι|ἴθυνον|ἰθύνετε|ἰθύνετο|ἰθύνει|ἰθύνομεν
ἀιστόω|ἀϊστώσειαν|ἀιστώθησαν
σιδηροφορέω|ἐσιδηροφόρει|σιδηροφορεῖσθαι
τέρσομαι|ἐτέρσετο|τέρσοντο|τέρσεται|τερσῆναι|τερσήμεναι
βροτόομαι|βεβροτωμένα
πέπνυμαι|πεπνυμένω|πέπνυσο|πέπνυσαί|πεπνυμένα|πεπνυμένον|πεπνυμένος|πεπνυμένε|πεπνυμένῳ
ὀλιγηπελέων|ὀλιγηπελέουσά|ὀλιγηπελέων
βραχεῖν|βράχε|ἔβραχ̓|ἔβραχε
ἐπαραρίσκω|ἐπῆρσεν|ἐπαρήρει|ἐπῆρσε
προλείπω|προλιπεῖν|προλιπὼν|προλέλοιπεν|προλιπόντες
οἰδάνω|οἰδάνει|οἰδάνεται
ἀποχάζομαι|ἀποχάζεο
ἀλοάω|ἀλοία
θαλέθω|θαλέθων|θαλέθοντες
ἀλητεύω|ἀλητεύοντες|ἀλητεύων|ἀλητεύοντι|ἀλητεύειν|ἀλητεύει
ἐπιθρώσκω|ἐπιθρῴσκουσι
ὑποτρέχω|ὑπέδραμε
ἱλήκω|ἱλήκῃσι
ἀποκλίνω|ἀποκλίναντ̓
θαλπιάω|θαλπιόων
πεμπάζω|πεμπάσσεται
ἐμβρέμομαι|ἐμβρέμεται
ἐγκαταπήγνυμι|ἐγκατέπηξ̓
κείρω|κειρόμενοι|ἔκειρον|κείρει|κέρσαντες|κείρετ̓|κερέειν|ἐκείρετε|κέρσε|κείροντες|κείροντό|κείρασθαί|κείροντας|ἔκερσεν|κεῖρε|κείρων
ὑπολύω|ὑπέλυσε|ὑπέλυντο|ὑπέλυσα|ὑπελύσαο
ἀναψύχω|ἀνέψυχον|ἀναψύχειν|ἀνέψυχθεν|ἀναψύχοντα
μάσσω|μάσασθαι
ἐκκατεῖδον|ἐκκατιδών
εἰσερύω|εἰσερύσαντες
γλαυκιάω|γλαυκιόων
ἀφοπλίζω|ἀφωπλίζοντο
ῥίπτω|ἔρριψεν|ῥίψω|ῥῖψ̓|ῥίψει|ῥίπτασκον|ἔρριψε|ῥῖψε|ῥίπτασκε
προθρώσκω|προθορὼν
ὑπερίημι|ὑπερήσει
ἀμφαφάω|ἀμφαφόωντο|ἀμφαφάασθαι|ἀμφαφόων|ἀμφαφόωσα|ἀμφαφόωντας
κάμνω|καμέτην|κάμῃσι|ἐκάμοντο|κεκμηῶτα|κάμνεις|κάμω|κέκμηκας|ἔκαμον|καμόντα|καμόμεσθα|κάμοιτε|κεκμηῶτι|καμεῖται|καμόντας|κεκμηώς|κάμον|κάμοιεν|κάμετόν|ἔκαμνεν|κάμωσιν|κάμνε|κάμεν|κεκμηότας|κάμ̓|κάμνει|καμόντων|κάμε
ἀπειλέω|ἀπείλεον|ἠπείλησεν|ἠπείλει|ἀπειλεῖτε|ἠπείλησε|ἀπείλησαν|ἀπειλήσει|ἀπειλήτην|ἀπείλησας|ἀπειλήσας|ἀπειλεῖς|ἀπειλήσω|ἀπείλει
ἀφικνέομαι|ἀφίκωνται|ἀφίκηαι|ἀφικοίμεθα|ἀφίκετο|ἀφικόμενοι|ἀφικόμενος|ἀφικνεῖται|ἀφίξεαι|ἀφικνουμένων|ἀφικώμεθα|ἀφίκηται|ἀφίκοιο|ἀφικομένων|ἀφικόμεθ̓|ἀφίκωμαι|ἀφικοίμην|ἀφικέσθαι|ἀφίκεο|ἀφίξεται|ἀφῖχθαι|ἀφικνοῦνται|ἀφίκεσθε|ἀφίκοντο
ἡσσάομαι|ἡσσῶντό|ἡσσημένον|ἡσσημένοι|ἡσσᾶτο|ἥσσηντο
ὀστρακίζω|ὠστρακισμένος
ἐξερέω|ἐξερέουσα|ἐξερέουσιν|ἐξερέω|ἐξερέοις|ἐξερέοντες
ἐπιπωλέομαι|ἐπιπωλεῖται|ἐπεπωλεῖτο
καθέζω|καθεζόμενος
καλύπτω|καλυψάμενος|καλυψάμενοι|κάλυψαν|καλύψαντες|κάλυψε|κεκαλυμμέναι|καλύψατο|καλύψας|ἐκάλυψεν|κεκάλυπτο|ἐκάλυψε|κεκαλυμμένοι|καλύπτοι|κεκάλυφθ̓|καλύπτων|καλύψαι|καλυφθείς|κεκαλυμμένα|ἐκάλυψαν|καλύψω|καλύπτει|κάλυπτε|καλυψαμένη|κάλυψεν|κεκαλυμμένος|ἐκάλυψα|καλύψῃ
ὑπεροπλίζομαι|ὑπεροπλίσσαιτο
ἔργω|ἐέργῃ|ἐέργει|ἐέργων|ἔεργεν|εἴργουσι|εἶργον|εἰργόμενοι|ἔεργον|εἴργωσι|ἐεργμέναι|ἐέργουσίν|ἔεργε|ἐεργόμενοι|ἔρξαν|εἴργεσθαι|εἴρξουσι
διφάω|διφῶν
κεραίζω|κεραϊζέμεν|κεράϊζε|κεραΐζετον|κεραϊζομένην|κεραϊξέμεν|κεραΐζων|κεραϊζομένους
συστρατεύω|ξυνεστράτευον
κοινόω|κοινώσαντας
ἀποπαύω|ἀπέπαυσαν|ἀποπαύσομαι|ἀποπαύεο|ἀποπαύεαι|ἀπέπαυσε|ἀπέπαυσας|ἀποπαύσεται|ἀποπαύσει|ἀπόπαυε|ἀποπαύἐ|ἀποπαύσεσθαι
ἀλεγύνω|ἀλεγύνειν|ἀλέγυνον|ἀλεγύνετε
δοκεύω|δοκεύσας|δοκεύει
ἐκπατάσσω|ἐκπεπαταγμένος
παρατρέπω|παρατρέψας
ἀπανίστημι|ἀπανίστανται|ἀπανίσταντο|ἀπανίστασθαι
ἐνσκίμπτω|ἐνισκίμψαντε|ἐνισκίμφθη
ἱζάνω|ἱζάνει|ἵζανεν|ἵζανον
ὀχλίζω|ὀχλίσσειαν
ἐπιτλῆναι|ἐπιτλήτω
παλιμπλάζομαι|παλιμπλαγχθέντας|παλιμπλαγχθέντα
χαλέπτω|χαλέπτει
ἐξηγέομαι|ἐξηγεῖσθαι|ἐξηγεῖσθε|ἐξηγήσασθαι|ἐξηγείσθω
ἠμύω|ἤμυσε|ἠμύει|ἠμύσειε
ἐπιχράω|ἐπέχραον
ἀναθηλέω|ἀναθηλήσει
ἰσχάνω|ἰσχάνει|ἰσχανέτην|ἴσχανε
ἀλύσσω|ἀλύσσοντες|ἄλυξαν|ἄλυξεν
γέγωνα|γεγωνώς|γέγωνέ|ἐγεγώνει|γεγωνέμεν|ἐγέγωνεν|γέγωνε
ἐρέπτομαι|ἐρεπτόμενοι|ἐρεπτομένους
ἀναχάζω|ἀναχαζομένοιο|ἀνεχάζεθ̓|ἀναχασσάμενος|ἀναχασσαμένη|ἀναχάζομαι|ἀναχαζόμενον|ἀνεχάζετο
μετανίσσομαι|μετενίσσετο|μετενίσετο
χολόω|κεχολωμένος|ἐχόλωσεν|κεχολωμένον|κεχόλωτο|χολώσῃς|κεχολώατο|κεχόλωται|κεχόλωσο|χολωσέμεν|χολώσαιτο|χολώσατο|χολωσάμεναι|χολωσαμένη|ἐχολώσατο|ἐχολώσατε|κεχολωμένη|κεχολώσομαι|χολωθείς|χολωθῇς|χολωθεὶς|κεχολῶσθαι|χολοῦται|κεχολωμένοι|χολωσάμενός|χολωσάμενοι|κεχολώσεαι|ἐχολώθη|κεχολώσεται|χολωσάμενος|χολώσεαι|χολώθη
ἐπιμέμφομαι|ἐπιμέμφομαι|ἐπιμέμφεται|ἐπιμέμφεαι
νεμεσάω|νεμεσήσῃ|νεμέσα|νεμεσσήθητε|νεμεσσήσαιτό|νεμεσσῶμαι|νεμεσήσεται|νεμεσσηθεὶς|νεμεσσᾶται|νεμεσσήθη|νεμεσᾶτον|νεμέσησαν|νεμέσσα|νεμεσσηθεῖσα|νεμεσσῶμαί|ἐνεμέσσα|νεμεσήσεαι|νεμεσῶ|νεμεσσηθέωμέν|νεμεσήσετ̓|νεμέσησε|νεμέσσηθέν
πέμπω|ἔπεμψαν|ἔπεμπε|ἔπεμπον|πέμψουσιν|πέμπει|πέμπουσι|πέμπωσι|πέμψωμεν|πέμψαν|πέμψῃς|πέμπε|πέμψας|πέμψει|πέμπων|πεμπέμεναι|πέμπετε|πέμψαιμι|ἔπεμψε|πέμπον|πέμπω|πέμπουσιν|πέμψαι|ἔπεμψεν|πέμψειεν|πέμψουσι|πέμπειν|πέμψω|πέμψειν|πέμψον|πέμπετέ|πέμψομεν|πέμψαντές|πεμπόμενοι|ἔπεμψα|πέμπῃσιν|πέμποιεν|πέμπ̓|πέμψειας|πέμψεν|πεμπέμεν|πέμψαντες|πέμπωμεν|πέμπεν|πεμψέμεναι
τρέπω|τράπετο|τραπέσθαι|ἔτραπεν|τρέπε|τρέψειε|τράπεθ̓|ἐτράπετ̓|ἐτράπετο|τρέψειαν|τρέπεν|τρέψω|τραπόμενοι|τετραμμένος|τετραμμένον|ἔτρεψαν|ἔτρεψε|τετραμμένοι|τετραμμέναι|τρέπονται|τετράφθω|ἔτραπε|ἔτρεψεν|ἔτραπον|τρεπομένους|τρέπεται|τράπετ̓|ἐτράποντο|τρέψεν|τραφθῆναι|τρέψας|τέτραπτο|τράπε|τράποντο|τετράφαθ̓|τρέψε|τράπωνται|τρέψητε|τρεψάμενοι
εἰσβαίνω|εἴσβαινον|ἐσβάντων|ἐσβάντες|ἐσβῆναι|ἐσβαίη|ἐσβήσεσθαι
περιχέω|περιχεύῃ|περίχευεν|περιχεύεται|περιχεύας|περίχευε
τιτύσκομαι|τιτυσκόμενος|τιτυσκόμενοι|τιτυσκόμεναι|τιτύσκετο|τιτυσκομένη|τιτυσκομένων
ὑπερκαταβαίνω|ὑπερκατέβησαν
προβίβημι|προβιβὰς
ἐκθνήσκω|ἔκθανον
φέβομαι|ἐφέβοντο|φέβεσθαι|φεβώμεθα|φέβωμαι|φέβοντο
προσπίτνω|προσπίπτοντες|προσπιπτούσας
ὑπεκπρορέω|ὑπεκπρόρεεν
ὑποκρίνομαι|ὑπόκριναι|ὑποκρίνασθαι|ὑποκρίνονται|ὑποκρίναιτο
πιέζω|πιεσθεὶς|πιεζομένους|πιέζειν|ἐπίεζε|πίεζεν|ἐπιέζοντο|πίεζον|πιέζοιντο
κραδαίνω|κραδαινομένη|κραδαινόμενον
ἀνακαίω|ἀνέκαιον|ἀνέκαιε
ὁμοφρονέω|ὁμοφρονέοντε|ὁμοφρονέοις
ἐπερείδω|ἐπέρεισε
ἐλελίζω|ἐλέλιξεν|ἐλέλιχθεν|ἐλελιξάμενος|ἐλέλιξε|ἐλελίχθη|ἐλελίχθησαν|ἐλέλικτο|ἐλελιχθέντες
ἐμέω|ἐμέων
ἐνδουπέω|ἐνδούπησα|ἐνδούπησε
σεύω|ἔσσευε|ἐσσύμενον|ἔσσυτο|ἔσσευεν|ἔσσυμαι|ἔσσυο|ἐσσύμενός|ἐσσύμενοί|σεῦαν|σεύωνται|σευάμενος|σεῦα|ἔσσυται|σύτο|ἐσσύμενόν|ἐσσεύαντο|σεύατ̓|σεύῃ|σεῦε|ἐσσεύοντο|σεῦεν|ἔσσευα|σεύαιτο|σεύας|ἔσσυτ̓
ὑποστορέννυμι|ὑποστορέσαι
ἐπικρεμάννυμι|ἐπικρεμασθέντος
ναυτίλλομαι|ναυτίλλεσθαι|ναυτίλλεται
ἐκπρολείπω|ἐκπρολιπόντες
ἀπόλλυμι|ἀπόλοντο|ἀπολλυμένους|ἀπώλεσα|ἀπολέσθω|ἀπόλοιτο|ἀπώλεσεν|ἀπολοίατο|ἀπολοίμην|ἀπώλεο|ἀπόλλυται|ἀπολέσκετ̓|ἀπώλεσαν|ἀπωλόμεθ̓|ἀπώλετο|ἀπόλωλε|ἀπώλεσ̓|ἀπώλοντο|ἀπώλεσε|ἀπολέσθαι|ἀπόλωνται|ἀπόλεσσαν|ἀπόλωλεν|ἀπόληται
συμπροπέμπω|ξυμπροπέμψαι
εἰσγράφω|ἐσεγράψαντο
σκάζω|σκάζοντε|σκάζων
πεινάω|πεινήμεναι|πεινάων|πεινάοντα|πεινάοντε
προσκαθέζομαι|προσκαθεζόμενοι|προσκαθεζόμενοί
ἀλάλημαι|ἀλάλησθε|ἀλάλημαι|ἀλάληται|ἀλαλήμενος|ἀλάλησαι|ἀλάλησο|ἀλάλησθαι
ἀναμιμνήσκω|ἀνέμνησας
μενεαίνω|μενεαίνει|μενεαίνεις|μενέαινον|μενεαίνω|μενέαινε|μενεαινέμεν|μενέαινεν|μενεαίνετε|μενεαίνων|μενεήναμεν|μενεαίνομεν
ἐκπροκαλέομαι|ἐκπροκαλεσσαμένη
φιλοδικέω|φιλοδικεῖν
στηρίζω|στήριξε|στηρίξασθαι|ἐστήριξε|στηρίξαι|ἐστήρικτο
ἀποκρύπτω|ἀπέκρυψεν|ἀποκρύψαι
ἐνδέω|ἐνέδησε|ἐνέδησα|ἐνέδησεν
κωκύω|ἐκώκυε|κωκύσασα|ἐκώκυον|κώκυσέν|κώκυσεν|κώκυσ̓|κωκύει
διασκοπιάομαι|διασκοπιᾶσθαι
ἀθλεύω|ἀεθλεύοιμεν|ἀεθλεύειν|ἀθλεύων|ἀεθλεύωσιν
κρεμάννυμι|κρεμόω|κρέμασεν|κρεμάσαντες|ἐκρέμω
μήδομαι|μήδετο|μήσαο|ἐμήσατ̓|μήδεαι|μήδονθ̓|μήδεο|μήσατο|ἐμήσατο|μήσατ̓|μήδετ̓|μηδοίμην|μήδεται|μήσεαι
ἀποτίθημι|ἀπέθηκ̓|ἀποθέμενοι|ἀποθείομαι|ἀποθέσθαι
πυργόω|πύργωσάν
πλέκω|ἔπλεξε|πλεξάμενος
ἐνστρέφω|ἐνστρέφεται
ἐνστηρίζω|ἐνεστήρικτο
ἀποικοδομέω|ἀπῳκοδόμησαν
ἐξαναδύομαι|ἐξαναδύς|ἐξαναδῦσαι
μεθομιλέω|μεθομίλεον
στεναχίζω|στεναχίζετο|στεναχίζω|στεναχίζων
παρά-βάζω|παραβεβάσθαι
ἀναπνέω|ἄμπνυτο|ἀμπνεῦσαι|ἀναπνεύσωσιν|ἀμπνύνθη|ἀναπνεύσωσι|ἀναπνεύσειε|ἄμπνυε|ἀνέπνευσαν|ἀνέπνεον
τροπέω|τρόπεον
ὑποσχέθω|ὑπέσχεθε
διαιτάω|διαιτώμενον
ὀπίζομαι|ὠπίζετο|ὀπίζεο|ὠπίζετ̓|ὀπίζομαι
μνηστεύω|μνηστεύειν|μνηστεύσαντες
ἐκμολεῖν|ἔκμολεν
δηϊόω|δῃοῦντας
κυδάνω|κύδανον|κυδάνει
συνθέω|συνθεύσεται
ἀπαίρω|ἀποαίρεο
ἐπιόσσομαι|ἐπιοσσομένω
ἐξερείπω|ἐξεριποῦσα|ἐξερίπῃ
θεοπροπέω|θεοπροπέων
ἐξαπαφίσκω|ἐξαπάφοιτο|ἐξαπάφω|ἐξήπαφε|ἐξαπάφοιτ̓
βαθύνω|βάθυνε
ῥέω|ῥέοντες|ῥέε|ἔρρεον|ῥέον|ῥέοι|ἔρρεεν|ῥέουσιν|ἔρρεε|ῥέεν|ῥέουσαι|ῥέοντος|ῥέοντε|ῥύη|ῥέων|ἔρρει|ῥέει|ῥέοντα|ῥεῖ
συνιστάω|ξυνιστάμενον
οἴομαι|οἴομαι|ὀίεαι|ὀΐεται|ὀϊόμεθ̓|ὀϊομένοισι|ὠΐετο|οἴοιτο|ὀΐσατο|ὠίετο|οἴεσθε|ὠΐσθην|ὀϊομένῳ|οἴεσθαι|οἴονται|ὀίσατο|ὀϊόμενός|οἶμαι|ὀΐεαι|ὀϊόμενον|ὀιομένη|ὀϊόμενος|ὀΐομαι|ὠΐσθη|οἰόμενοι|ὀϊσάμενος|οἰόμεθα|ὀϊσθεὶς|ὀίω|ὀισάμενος|ᾤμην|οἴεται|ὀΐω|ὀίομαι
ἀναγνάμπτω|ἀνέγναμψαν|ἀνεγνάμφθη
ἐκφαίνω|ἐκφανεῖ|ἐξεφαάνθη|ἐξεφάανθεν|ἐξεφάνη
ἐνίπτω|ἔνιπτε|ἠνίπαπε|ἐνίπτοι|ἐνένιπεν|ἐνένιπε
ἐχθαίρω|ἐχθήρειε|ἔχθαιρε|ἤχθηρε|ἔχθηρε|ἐχθαίρῃσι|ἐχθαίρουσ̓|ἐχθαίρῃσιν
ἐμμεμαώς|ἐμμεμαώς|ἐμμεμαῶτ̓|ἐμμεμαυῖα|ἐμμεμαῶτες|ἐμμεμαὼς|ἐμμεμαῶτε
ἐκφορέω|ἐκφόρεον|ἐκφορέοντο
ἐξοτρύνω|ἐξοτρυνόντων
ἀναδέω|ἀναδούμενοι
προσκομίζω|προσκομισθεῖσαι|προσκομίσαι|προσκομίσασθαι
κηκίω|κήκιε
καταλέγω|καταλέξεται|κατέλεξας|κατέλεξε|κατέλεξα|καταλέγμενος|καταλέχθαι|καταλέξομεν|κατάλεξαι|κατέλεκτο|κατέλεξεν|κατάλεξον|καταλέξῃ|κατελέξατο|καταλέξαι|καταλέξω|καταλέξῃς|κατέλεκτ̓
ὑπερθρῴσκω|ὑπερθορέονται
συνδιώκω|ξυνδιώκειν
οἰνοχοεύω|οἰνοχοεύει|οἰνοχοεύων|οἰνοχοεύειν
ἱερεύω|ἱερεύσαντες|ἱρεύουσ̓|ἱερευσέμεν|ἱερεύσατε|ἱερεύσω|ἱρεύεσκον|ἱερεύσομεν|ἱέρευσεν|ἱέρευον|ἱέρευσ̓|ἵρευον|ἱρεύσασθαι|ἱέρευσε|ἱερεύοντες|ἱερεύετε|ἱέρευσαν|ἱέρευτο|ἱερεύσειν
πίτνημι|πίτναντο|πιτνὰς|πίτνα
παρανήχομαι|παρανήξομαι
ἀντιάζω|ἀντιάσαντα|ἀντιόω|ἀντιάσειας|ἀντιόωσα|ἀντιάσητον|ἀντιάσειε|ἀντιάσαιμεν|ἀντιάσαντι
ἀνάγω|ἀνάγουσι|ἀνῆγες|ἀνήγαγε|ἀναγαγόμεναι|ἀνάγοντο|ἄναγον|ἀναγομένης|ἀνήγοντο|ἀνήγαγεν|ἀνήγαγον|ἀνάγοντες
ἔνειμι|ἐνέην|ἔνεστι|ἐνείη|ἐνῆεν|ἔνειμεν
ἐπαινέω|ἐπαινεῖσθαί|ἐπαινήσαντες|ἐπῄνεον|ἐπαινέομεν|ἐπαινήσαντος|ἐπαινέσαντες|ἐπῄνησαν
ὑπομιμνήσκω|ὑπομνήσουσα|ὑπέμνησέν
ἐκχέω|ἐξέχυθ̓|ἐκχεύατ̓|ἐκχυμένοιο|ἔκχεον|ἐξεκέχυντο|ἔκχυτο|ἐκχύμενοι|ἐξεχέοντο
ἕπομαι|ἕποιο|ἕψομ̓|σπεῖό|ἕπἐ|ἕποντ̓|ἕπεσθον|εἵπετ̓|εἵπετο|ἕποντο|σπέσθω|ἑψόμεθ̓|ἑσπέσθην|ἕποιτο|ἕπονται|ἕπωμαι|ἕσπεο|ἕπεο|ἕπηται|ἕποιεν|ἕπετον|ἕπει|ἕπεται|ἕποιθ̓|ἑσπομένοιο|ἑπέσθην|ἑσπόμενος|ἕψεαι|ἕσπωνται|ἑπόμεσθα|σπέσθαι|ἑπέσθων|ἑπόμην|ἑποίατο|ἕψεται|ἕψεσθαι|ἕπεθ̓|ἑπέσθω|ἕπονθ̓|ἑσποίμην|ἕπετ̓|ἑπώμεθ̓|ἑσπόμεθ̓|ἕσπετο|ἕψονται|ἕσπετ̓|ἕπουσαν|ἕπευ|ἕψομαι|ἕπετο|εἵποντο|ἕπεσθαι
διασῴζω|διασωθῆναἰ
ἐπισπέρχω|ἐπισπέρχουσι|ἐπισπέρχων
ἀνακηκίω|ἀνεκήκιεν|ἀνακηκίει
ἀντεπιτίθημι|ἀντεπετίθει
ἀπαίνυμαι|ἀπαίνυτο|ἀποαίνυται|ἀπαινύμενον|ἀποαίνυτο|ἀποαίνυμαι
συμμάρπτω|συμμάρψας
ἐκσπάω|ἐξέσπασε|ἐκσπασσαμένω
περιπίπτω|περιπεπτωκότες
θέω|θεύσεαι|θέε|θεούσης|θέει|ἔθεεν|θέῃσι|θείμεν|θείειν|θεύσεσθαι|θέομεν|θέουσι|θέον|θέουσαι|θέοιμεν|θέῃσιν|θέουσ̓|θέοντος|θέων|θέεις|θέεν|ἔθει|θέουσα|θέω|θείω|θέεσκον|θέοντες|θέειν|θείῃ
προθέω|πρότιθεν|προθέῃσι|προθέεσκε
τρέφω|τροφέοντο|ἐτράφημεν|ἔτραφ̓|τρέφε|θρέψ̓|θρέψας|θρέψά|τέτροφεν|τράφη|ἐτραφέτην|θρέψε|ἔτρεφε|τρέφον|ἔτραφεν|τράφεν|ἐτρεφόμην|ἔτρεφεν|τρέφει|θρέψαιό|τρέφουσι|τράφ̓|τραφέμεν|ἔθρεψε|τρέφεται|θρέψεν|ἔτραφέ|ἔτρεφον|τρέφεν|θρέψαν|θρέψασα|ἔτρεφες
ἰχθυάω|ἰχθυάᾳ|ἰχθυάασκον
ἠχέω|ἀχέων
ἐπιμήδομαι|ἐπεμήδετο
ὀτρύνω|ὤτρυν̓|ὀτρύνοντες|ὀτρύνεις|ὀτρυνέεις|ὀτρύνεσθε|ὤτρυνον|ὀτρύνεσθαι|ὀτρύνουσ̓|ὀτρύνουσα|ὀτρυνέουσα|ὀτρύνομεν|ὀτρύνει|ὀτρύνοντι|ὀτρύνοντο|ὀτρύνοντος|ὀτρύνοιτε|ὀτρυνέει|ὄτρυνε|ὀτρύνεσκον|ὤτρυνε|ὀτρύνετε|ὀτρύνειαν|ὄτρυν̓|ὀτρύνουσιν|ὀτρύνῃσιν|ὄτρυνέ|ὤτρυνεν|ὀτρύνοντα|ὠτρύνοντ̓|ὄτρυνον|ὀτρύνειε|ὀτρύνω|ὄτρυνεν|ὀτρυνώμεθ̓|ὀτρυνέων|ὀτρῦναι|ὀτρύνων|ὀτρύνωμεν|ὀτρύναντος|ὀτρύνετον|ὀτρυνέμεν|ὤτρυνα|ὀτρύνουσι|ὀτρύνῃσι|ὀτρυνέω
ὑπερθρώσκω|ὑπερθορέειν|ὑπέρθορον
ἐάω|ἔασκε|ἐῶμεν|ἐῷμι|εἴων|εἴασχ̓|ἔασεν|ἐῶσιν|ἐῶσι|ἐάσειε|ἔασκεν|εἴασκεν|ἔα|ἐῶντος|εἰῶ|εἴασε|εἴασεν|εἴασαν|ἐάᾳ|ἐάας|εἴας|ἔασας|εἰῶμεν|ἐάαν|ἐᾷ|ἐᾶν|ἐάσαντες|εἰῶσι|εἰῶσ̓|εἴασκον|ἔασκες|ἐῷ|ἐάσουσιν|ἐᾶσαι|ἐάᾳς|ἐασόμενοι|ἐάσατε|ἔασον|ἔασ̓|ἐάσετε|εἴασκε|ἐᾶτε|εἴα|ἐᾷς|ἐῶμέν|εἴη|ἐάσῃς|ἐάσαιμεν|ἐῶ|ἔασε|ἐάσομεν|εἴασ̓|ἐάσει|ἐάσω
συνεργάζομαι|ξυνειργασμένων
μέμαα|μέματον|μεμαὼς|μεμαῶτι|μέμασαν|μεμαῶτ̓|μεμαώς|μεμαῶτα|μεμάασι|μεμάασιν|μεμαυῖαν|μεμαῶτε|μεμαότες|μεμαῶτες|μεμαότε|μέμαθ̓|μεμαῶσιν|μεμαῶτος|μεμάασί|μεμαυῖα|μέμαμεν|μεμαυῖ̓|μεμαῶτας|μεμαυῖαι|μεμάτω
ταλαιπωρέω|ταλαιπωροίη|ταλαιπωρεῖν
παρίστημι|παρέστηκεν|παραστήσεσθαι|παρσταίη|παριστάμεναι|παραστάς|πάρστητε|παρασταῖεν|παρστήετον|παρστὰς|παρστᾶσα|παρέστης|παραστησώμεθα|παριστάμενος|παρισταμένη|παριστάμενοι|παρίσταμαι|παραστὰς|παρεστήσαντο|παρίσταο|παρεστάμεναι|παρέσταν|παρίστασαι|παρίστατο|παρίσταται|παραστήσασθαι|παρέστη|παρασταίης
ὀλοφύρομαι|ὀλοφυρομένην|ὀλοφυρόμεναι|ὀλοφυρόμενος|ὀλοφύρεαι|ὀλοφύραο|ὀλοφυρόμεθ̓|ὀλοφυρομένη|ὀλοφυρομένους|ὀλοφυρόμενοι|ὀλοφύρομαι|ὀλοφύρατο|ὀλοφύρεται
στερέω|ἐστερήθησαν|στερέσαι
ἵλημι|ἵληθ̓|ἵληθι
παροικέω|παροικοῦντες
ἐκδύω|ἔκδυνε|ἐκδὺς|ἐξεδύοντο|ἐκδῦμεν
πιστόω|πιστωθῆναι|πιστωθῆτόν|πιστώσαντο|ἐπιστώσαντ̓
ἐμπάζομαι|ἐμπάζεαι|ἐμπάζεο|ἐμπάζομαι|ἐμπαζόμεθ̓|ἐμπάξομαι|ἐμπάζετο
κατέχω|κατέσχεν|καθέξει|κάτεχ̓|κατασχεῖν|κατέχειν|κατεῖχον|κάτεχεν|κατασχομένη|κατέχει|κατέχων|κατάσχῃ|κατεσχηκότος|κατέχονται|κατέσχετο|κατέσχετ̓|κατείχετο|κατέχουσι|κατέχοντο
ἀνέρομαι|ἀνείρηται|ἀνείρεαι|ἀνειρόμενος|ἀνείρετο
ἐποτρύνω|ἐποτρῦναι|ἐποτρύνων|ἐποτρύνῃσιν|ἐποτρύνω|ἐποτρύνῃσι|ἐποτρύνῃ|ἐπότρυνον|ἐποτρύνας|ἐποτρύνητον|ἐπώτρυνας|ἐποτρυνώμεθα|ἐποτρύνουσα|ἐποτρύνειε|ἐποτρύνῃς|ἐποτρύνειεν|ἐποτρύνωσι|ἐποτρύνοντα|ἐπότρυνε|ἐποτρύνει
ἐπιπλήσσω|ἐπιπλήσσων|ἐπιπλήξειν|ἐπιπλήσσεις
προστίθημι|προσέθηκεν|πρόσθησθε|προστίθεσθαι|προσεθέμεθα
ἐξεμέω|ἐξεμέσειεν|ἐξεμέσειε
ἐφάπτω|ἐφῆπτο|ἐφῆπται|ἐφάψεαι
μετέρχομαι|μετελεύσομαι|μετέλθοι|μέτελθε|μετέρχομαι|μετέρχεο|μετελθών|μετελθὼν|μετέρχεται|μετερχόμενος|μετελθεῖν
οἰκτείρω|ᾤκτιρε|οἰκτίρων|ᾤκτειρε|οἰκτίρεις
περιστρέφω|περιστρέψας
μακρηγορέω|μακρηγορεῖν
ἐνθρώσκω|ἔνθοῤ|ἔνθορε
καταπέτομαι|καταπτήτην
σώω|σώεσκον|σώοντες
ἐπιληκέω|ἐπελήκεον
αἰσθάνομαι|αἰσθανόμενοι|αἰσθάνεσθαι|ᾐσθημένοι|ᾔσθοντο|αἰσθόμενοι|αἰσθανομένων|αἰσθάνεται|ᾐσθάνοντο
ἐπιστρατεύω|ἐπεστράτευσε|ἐπεστράτευσαν|ἐπιστρατεύομεν
ζῶ|ζώοντι|ζώοντα|ζώοντος
ἐξερεείνω|ἐξερέεινε|ἐξερέεινον|ἐξερεείνετο|ἐξερεείνοι|ἐξερεείνων|ἐξερέεινεν
ἐναίρω|ἐναίρειν|ἐναίρω|ἐναιρέμεν|ἐναίροντα|ἐναίρων|ἐναιρόμενος|ἐναίρεο|ἔναιρε|ἐνήρατο
διερέσσω|διήρεσα|διήρεσσ̓
καταφθίω|κατέφθιτο|καταφθιμένοισιν|καταφθίσει|καταφθιμένοιο|καταφθίσθαι
συνελαύνω|ξυνελάσσαι|συνελάσσαμεν|ξυνελαύνεις|ξυνελάσσομεν|ξυνελαυνέμεν
ἐπινεύω|ἐπένευσα|ἐπένευε
ἐρέσσω|ἔρεξας|ἐρεσσέμεναι|ἔρεσσον
ἀναγιγνώσκω|ἀναγνοίη|ἀναγνούσῃ|ἀναγνόντος|ἀνέγνων|ἀνέγνω
ἀγλαίζω|ἀγλαϊεῖσθαι
δέρω|δείραντας|δέρον|ἔδειραν|ἔδερόν
ει´κω|εἴκετε
