Θουκυδίδης|Θουκυδίδης|n-s---mn-
Ἀθηναῖος|Ἀθηναῖος|n-s---mn-
ξυνέγραψε|συγγράφω|v3saia---
τὸν|ὁ|l-s---ma-
πόλεμον|πόλεμος|n-s---ma-
τῶν|ὁ|l-p---mg-
Πελοποννησίων|Πελοποννήσιοι|n-p---mg-
καὶ|καί|c--------
Ἀθηναίων|Ἀθήναιος|n-p---mg-
,|,|u--------
ὡς|ὡς|c--------
ἐπολέμησαν|πολεμέω|v3paia---
πρὸς|πρός|r--------
ἀλλήλους|ἀλλήλων|p-p---ma-
ἀρξάμενος|ἄρχω|v-sapmmn-
εὐθὺς|εὐθύς|d--------
καθισταμένου|καθιστάω|v-sppeng-
ἐλπίσας|ἐλπίζω|v-sapamn-
μέγαν|μέγας|a-s---ma-
τε|τε|d--------
ἔσεσθαι|εἰμί|v--fnm---
ἀξιολογώτατον|ἀξιόλογος|a-s---mas
προγεγενημένων|προγίγνομαι|v-prpemg-
τεκμαιρόμενος|τεκμαίρομαι|v-sppemn-
ὅτι|ὅτι|c--------
ἀκμάζοντές|ἀκμάζω|v-pppamn-
ᾖσαν|εἶμι|v3piia---
ἐς|εἰς|r--------
αὐτὸν|αὐτός|a-s---ma-
ἀμφότεροι|ἀμφότερος|a-p---mn-
παρασκευῇ|παρασκευή|n-s---fd-
τῇ|ὁ|l-s---fd-
πάσῃ|πᾶς|a-s---fd-
τὸ|ὁ|l-s---na-
ἄλλο|ἄλλος|a-s---na-
Ἑλληνικὸν|Ἑλληνικός|a-s---na-
ὁρῶν|ὁράω|v-sppamn-
ξυνιστάμενον|συνιστάω|v-sppena-
ἑκατέρους|ἑκάτερος|a-p---ma-
μὲν|μέν|d--------
εὐθύς|εὐθύς|d--------
δὲ|δέ|c--------
διανοούμενον|διανοέομαι|v-sppena-
.|.|u--------
κίνησις|κίνησις|n-s---fn-
γὰρ|γάρ|d--------
αὕτη|οὗτος|a-s---fn-
μεγίστη|μέγας|a-s---fn-
δὴ|δή|d--------
τοῖς|ὁ|l-p---md-
Ἕλλησιν|Ἕλλην|n-p---md-
ἐγένετο|γίγνομαι|v3saim---
μέρει|μέρος|n-s---nd-
τινὶ|τις|a-s---nd-
βαρβάρων|βάρβαρος|n-p---mg-
εἰπεῖν|εἶπον|v--ana---
ἐπὶ|ἐπί|r--------
πλεῖστον|πλεῖστος|a-s---na-
ἀνθρώπων|ἄνθρωπος|n-p---mg-
τὰ|ὁ|l-p---na-
πρὸ|πρό|r--------
αὐτῶν|αὐτός|p-p---ng-
ἔτι|ἔτι|d--------
παλαίτερα|παλαιός|a-p---nac
σαφῶς|σαφής|d--------
εὑρεῖν|εὑρίσκω|v--ana---
διὰ|διά|r--------
χρόνου|χρόνος|n-s---mg-
πλῆθος|πλῆθος|n-s---na-
ἀδύνατα|ἀδύνατος|a-p---nn-
ἦν|εἰμί|v3siia---
ἐκ|ἐκ|r--------
τεκμηρίων|τεκμήριον|n-p---ng-
ὧν|ὅς|p-p---ng-
μακρότατον|μακρός|a-s---nas
σκοποῦντί|σκοπέω|v-sppamd-
μοι|ἐγώ|p1s---md-
πιστεῦσαι|πιστεύω|v--ana---
ξυμβαίνει|συμβαίνω|v3spia---
οὐ|οὐ|d--------
μεγάλα|μέγας|a-p---na-
νομίζω|νομίζω|v1spia---
γενέσθαι|γίγνομαι|v--anm---
οὔτε|οὐτε|d--------
κατὰ|κατά|r--------
τοὺς|ὁ|l-p---ma-
πολέμους|πόλεμος|n-p---ma-
ἄλλα|ἄλλος|p-p---na-
φαίνεται|φαίνω|v3spie---
ἡ|ὁ|l-s---fn-
νῦν|νῦν|d--------
Ἑλλὰς|Ἑλλάς|n-s---fn-
καλουμένη|καλέω|v-sppefn-
πάλαι|πάλαι|d--------
βεβαίως|βέβαιος|d--------
οἰκουμένη|οἰκουμένη|n-s---fn-
ἀλλὰ|ἀλλὰ|c--------
μεταναστάσεις|μετανάστασις|n-p---fn-
οὖσαι|εἰμί|v-pppafn-
πρότερα|πρότερος|a-p---na-
ῥᾳδίως|ῥᾴδιος|d--------
ἕκαστοι|ἕκαστος|a-p---mn-
τὴν|ὁ|l-s---fa-
ἑαυτῶν|ἑαυτοῦ|p-p---mg-
ἀπολείποντες|ἀπολιμπάνω|v-pppamn-
βιαζόμενοι|βιάζω|v-pppemn-
ὑπό|ὑπό|r--------
τινων|τις|p-p---mg-
αἰεὶ|ἀεί|d--------
πλειόνων|πλείων|a-p---mgc
τῆς|ὁ|l-s---fg-
ἐμπορίας|ἐμπορία|n-s---fg-
οὐκ|οὐ|d--------
οὔσης|εἰμί|v-sppafg-
οὐδ̓|οὐδέ|c--------
ἐπιμειγνύντες|ἐπιμίγνυμι|v-pppamn-
ἀδεῶς|ἀδεής|d--------
ἀλλήλοις|ἀλλήλων|p-p---md-
γῆν|Γαῖα|n-s---fa-
θαλάσσης|θάλασσα|n-s---fg-
νεμόμενοί|νέμω|v-pppemn-
αὑτῶν|ἑαυτοῦ|p-p---mg-
ὅσον|ὅσος|a-s---na-
ἀποζῆν|ἀποζάω|v--pna---
περιουσίαν|περιουσία|n-s---fa-
χρημάτων|χρῆμα|n-p---ng-
ἔχοντες|ἔχω|v-pppamn-
οὐδὲ|οὐδέ|c--------
φυτεύοντες|φυτεύω|v-pppamn-
ἄδηλον|ἄδηλος|a-s---na-
ὂν|εἰμί|v-sppana-
ὁπότε|ὁπότε|d--------
τις|τις|p-s---mn-
ἐπελθὼν|ἐπέρχομαι|v-sapamn-
ἀτειχίστων|ἀτείχιστος|a-p---mg-
ἅμα|ἅμα|d--------
ὄντων|εἰμί|v-pppamg-
ἄλλος|ἄλλος|a-s---mn-
ἀφαιρήσεται|ἀφαιρέω|v3sasm---
καθ̓|κατά|r--------
ἡμέραν|ἡμέρα|n-s---fa-
ἀναγκαίου|ἀναγκαῖος|a-s---fg-
τροφῆς|τροφή|n-s---fg-
πανταχοῦ|πανταχοῦ|d--------
ἂν|ἄν|d--------
ἡγούμενοι|ἡγέομαι|v-pppemn-
ἐπικρατεῖν|ἐπικρατέω|v--pna---
χαλεπῶς|χαλεπός|d--------
ἀπανίσταντο|ἀπανίστημι|v3piie---
δἰ|διά|r--------
αὐτὸ|αὐτός|p-s---na-
μεγέθει|μέγεθος|n-s---nd-
πόλεων|πόλις|n-p---fg-
ἴσχυον|ἰσχύω|v3piia---
ἄλλῃ|ἄλλος|a-s---fd-
μάλιστα|μάλιστα|d--------
γῆς|γῆ|n-s---fg-
ἀρίστη|ἄριστος|a-s---fn-
τὰς|ὁ|l-p---fa-
μεταβολὰς|μεταβολή|n-p---fa-
οἰκητόρων|οἰκήτωρ|n-p---mg-
εἶχεν|ἔχω|v3siia---
ἥ|ὁ|l-s---fn-
Θεσσαλία|Θεσσαλίη|n-s---fn-
Βοιωτία|Βοιωτία|n-s---fn-
Πελοποννήσου|Πελοπόννησος|n-s---fg-
πολλὰ|πολύς|a-p---nn-
πλὴν|πλήν|r--------
Ἀρκαδίας|Ἀρκαδία|n-s---fg-
ἄλλης|ἄλλος|p-s---fg-
ὅσα|ὅσος|a-p---nn-
κράτιστα|κράτιστος|a-p---nn-
ἀρετὴν|ἀρετή|n-s---fa-
αἵ|ὁ|l-p---fn-
δυνάμεις|δύναμις|n-p---fn-
τισὶ|τις|p-p---md-
μείζους|μέγας|a-p---fnc
ἐγγιγνόμεναι|ἐγγίγνομαι|v-pppefn-
στάσεις|στάσις|n-p---fa-
ἐνεποίουν|ἐμποιέω|v3piia---
ἐξ|ἐκ|r--------
ἐφθείροντο|φθείρω|v3piie---
ὑπὸ|ὑπό|r--------
ἀλλοφύλων|ἀλλόφυλος|a-p---mg-
μᾶλλον|μᾶλλον|d--------
ἐπεβουλεύοντο|ἐπιβουλεύω|v3piie---
γοῦν|γοῦν|d--------
Ἀττικὴν|Ἀττική|n-s---fa-
τοῦ|ὁ|l-s---ng-
λεπτόγεων|λεπτόγειος|a-s---na-
ἀστασίαστον|ἀστασίαστος|a-s---fa-
οὖσαν|εἰμί|v-sppafa-
ἄνθρωποι|ἄνθρωπος|n-p---mn-
ᾤκουν|οἰκέω|v3piia---
οἱ|ὁ|l-p---mn-
αὐτοὶ|αὐτός|a-p---mn-
αἰεί|ἀεί|d--------
παράδειγμα|παράδειγμα|n-s---nn-
τόδε|ὅδε|a-s---nn-
λόγου|λόγος|n-s---mg-
ἐλάχιστόν|ἐλάχιστος|a-s---nn-
ἐστι|εἰμί|v3spia---
μετοικίας|μετοικία|n-p---fa-
μὴ|μή|d--------
ὁμοίως|ὁμοῖος|d--------
αὐξηθῆναι|αὐξάνω|v--anp---
·|·|u--------
Ἑλλάδος|Ἑλλάς|n-s---fg-
πολέμῳ|πόλεμος|n-s---md-
ἢ|ἤ|c--------
στάσει|στάσις|n-s---fd-
ἐκπίπτοντες|ἐκπίτνω|v-pppamn-
παῤ|παρά|r--------
Ἀθηναίους|Ἀθήναιος|n-p---ma-
δυνατώτατοι|δυνατός|a-p---mns
βέβαιον|βέβαιος|a-s---na-
ἀνεχώρουν|ἀναχωρέω|v3piia---
πολῖται|πολίτης|n-p---mn-
γιγνόμενοι|γίγνομαι|v-pppemn-
ἀπὸ|ἀπό|r--------
παλαιοῦ|παλαιός|a-s---ng-
μείζω|μέγας|a-s---fac
ἐποίησαν|ποιέω|v3paia---
πλήθει|πλῆθος|n-s---nd-
πόλιν|πόλις|n-s---fa-
ὥστε|ὥστε|c--------
Ἰωνίαν|Ἰωνία|n-s---fa-
ὕστερον|ὕστερος|a-s---na-
οὐχ|οὐ|d--------
ἱκανῆς|ἱκανός|a-s---fg-
Ἀττικῆς|Ἀττική|n-s---fg-
ἀποικίας|ἀποικία|n-p---fa-
ἐξέπεμψαν|ἐκπέμπω|v3paia---
δηλοῖ|δηλόω|v3spia---
δέ|δέ|d--------
παλαιῶν|παλαιός|a-p---mg-
ἀσθένειαν|ἀσθένεια|n-s---fa-
ἥκιστα|ἥκιστος|a-p---na-
Τρωικῶν|Τρωικός|a-p---ng-
οὐδὲν|οὐδείς|p-s---na-
πρότερον|πρότερος|a-s---na-
κοινῇ|κοινῇ|d--------
ἐργασαμένη|ἐργάζομαι|v-sapefn-
Ἑλλάς|Ἑλλάς|n-s---fn-
δοκεῖ|δοκέω|v3spia---
τ-|ὁ|l-s---na-
οὔνομα|ὄνομα|n-s---na-
τοῦτο|οὗτος|a-s---na-
ξύμπασά|σύμπας|a-s---fn-
πω|πω|d--------
Ἕλληνος|Ἕλλην|n-s---mg-
Δευκαλίωνος|Δευκαλίων|n-s---mg-
πάνυ|πάνυ|d--------
εἶναι|εἰμί|v--pna---
ἐπίκλησις|ἐπίκλησις|n-s---fn-
ἔθνη|ἔθνος|n-p---na-
Πελασγικὸν|Πελασγικός|a-s---na-
ἀφ̓|ἀπό|r--------
ἐπωνυμίαν|ἐπωνυμία|n-s---fa-
παρέχεσθαι|παρέχω|v--pne---
παίδων|παῖς|n-p---mg-
αὐτοῦ|αὐτός|p-s---mg-
ἐν|ἐν|r--------
Φθιώτιδι|Φθιῶτις|n-s---fd-
ἰσχυσάντων|ἰσχύω|v-papamg-
ἐπαγομένων|ἐπάγω|v-pppemg-
αὐτοὺς|αὐτός|p-p---ma-
ἐπ̓|ἐπί|r--------
ὠφελίᾳ|ὠφέλεια|n-s---fd-
ἄλλας|ἄλλος|a-p---fa-
πόλεις|πόλις|n-p---fa-
ἑκάστους|ἕκαστος|a-p---ma-
ἤδη|ἤδη|d--------
ὁμιλίᾳ|ὁμιλία|n-s---fd-
καλεῖσθαι|καλέω|v--pne---
Ἕλληνας|Ἕλλην|n-p---ma-
μέντοι|μέντοι|d--------
πολλοῦ|πολύς|a-s---mg-
γε|γε|d--------
[|[|u--------
ἐδύνατο|δύναμαι|v3siie---
]|]|u--------
ἅπασιν|ἅπας|a-p---md-
ἐκνικῆσαι|ἐκνικάω|v--ana---
τεκμηριοῖ|τεκμηριόω|v3spia---
Ὅμηρος|Ὅμηρος|n-s---mn-
πολλῷ|πολύς|a-s---nd-
γενόμενος|γίγνομαι|v-sapmmn-
οὐδαμοῦ|οὐδαμοῦ|d--------
ξύμπαντας|σύμπας|a-p---ma-
ὠνόμασεν|ὀνομάζω|v3saia---
ἄλλους|ἄλλος|p-p---ma-
μετ̓|μετά|r--------
Ἀχιλλέως|Ἀχιλλεύς|n-s---mg-
Φθιώτιδος|Φθιῶτις|n-s---fg-
οἵπερ|ὅς|p-p---mn-
πρῶτοι|πρῶτος|a-p---mn-
Ἕλληνες|Ἕλλην|n-p---mn-
ἦσαν|εἰμί|v3piia---
Δαναοὺς|Δαναός|n-p---ma-
ἔπεσι|ἔπος|n-p---nd-
Ἀργείους|Ἀργεῖος|n-p---ma-
Ἀχαιοὺς|Ἀχαιός|n-p---ma-
ἀνακαλεῖ|ἀνακαλέω|v3spia---
μὴν|μήν|d--------
βαρβάρους|βάρβαρος|n-p---ma-
εἴρηκε|ἐρῶ|v3sria---
μηδὲ|μηδέ|d--------
Ἕλληνάς|Ἕλλην|n-p---ma-
ἐμοὶ|ἐγώ|p1s---md-
ἀντίπαλον|ἀντίπαλος|a-s---na-
ἓν|εἷς|n-s---na-
ὄνομα|ὄνομα|n-s---na-
ἀποκεκρίσθαι|ἀποκρίνω|v--rne---
δ̓|δέ|d--------
οὖν|οὖν|d--------
ὅσοι|ὅσος|a-p---mn-
ἀλλήλων|ἀλλήλων|p-p---mg-
ξυνίεσαν|συνίημι|v3piia---
ξύμπαντες|σύμπας|a-p---mn-
κληθέντες|καλέω|v-pappmn-
ἀμειξίαν|ἀμιξία|n-s---fa-
ἁθρόοι|ἀθρόος|a-p---mn-
ἔπραξαν|πράσσω|v3paia---
ταύτην|οὗτος|a-s---fa-
στρατείαν|στρατεία|n-s---fa-
θαλάσσῃ|θάλασσα|n-s---fd-
πλείω|πλείων|a-p---nac
χρώμενοι|χράω|v-pppemn-
ξυνεξῆλθον|συνεξέρχομαι|v3paia---
Μίνως|Μίνως|n-s---mn-
παλαίτατος|παλαιός|a-s---mn-
ἀκοῇ|ἀκοή|n-s---fd-
ἴσμεν|οἶδα|v1pria---
ναυτικὸν|ναυτικός|a-s---na-
ἐκτήσατο|κτάομαι|v3saim---
Ἑλληνικῆς|Ἑλληνικός|a-s---fg-
ἐκράτησε|κρατέω|v3saia---
Κυκλάδων|Κυκλάδες|n-p---fg-
νήσων|νῆσος|n-p---fg-
ἦρξέ|ἔρδω|v3saia---
οἰκιστὴς|οἰκιστής|n-s---mn-
πρῶτος|πρῶτος|a-s---mn-
πλείστων|πλεῖστος|a-p---fg-
Κᾶρας|Κάρ|n-p---ma-
ἐξελάσας|ἐξελαύνω|v-sapamn-
ἑαυτοῦ|ἑαυτοῦ|p-s---mg-
παῖδας|παῖς|n-p---ma-
ἡγεμόνας|ἡγεμών|n-p---ma-
ἐγκαταστήσας|ἐγκαθίστημι|v-sapamn-
τό|ὁ|l-s---na-
λῃστικόν|λῃστικός|a-s---na-
εἰκός|εἰκός|v-srpann-
καθῄρει|καθαιρέω|v3siia---
ἐφ̓|ἐπί|r--------
προσόδους|πρόσοδος|n-p---fa-
ἰέναι|εἶμι|v--pna---
αὐτῷ|αὐτός|p-s---md-
οἵ|ὁ|l-p---mn-
ἠπείρῳ|ἤπειρος|n-s---fd-
παραθαλάσσιοι|παραθαλάσσιος|a-p---mn-
νήσους|νῆσος|n-p---fa-
εἶχον|ἔχω|v3piia---
ἐπειδὴ|ἐπεί|c--------
ἤρξαντο|ἄρχω|v3paim---
περαιοῦσθαι|περαιόω|v--pne---
ναυσὶν|ναῦς|n-p---fd-
ἐτράποντο|τρέπω|v3paim---
λῃστείαν|λῃστεία|n-s---fa-
ἡγουμένων|ἡγέομαι|v-pppemg-
ἀνδρῶν|ἀνήρ|n-p---mg-
ἀδυνατωτάτων|ἀδύνατος|a-p---mgs
κέρδους|κέρδος|n-s---ng-
σφετέρου|σφέτερος|a-s---mg-
ἕνεκα|ἕνεκα|r--------
ἀσθενέσι|ἀσθενής|a-p---md-
προσπίπτοντες|προσπίτνω|v-pppamn-
πόλεσιν|πόλις|n-p---fd-
ἀτειχίστοις|ἀτείχιστος|a-p---fd-
κώμας|κώμη|n-p---fa-
οἰκουμέναις|οἰκέω|v-pppefd-
ἥρπαζον|ἁρπάζω|v3piia---
βίου|βίος|n-s---mg-
ἐντεῦθεν|ἐντεῦθεν|d--------
ἐποιοῦντο|ποιέω|v3piie---
ἔχοντός|ἔχω|v-sppang-
αἰσχύνην|αἰσχύνη|n-s---fa-
τούτου|οὗτος|a-s---ng-
ἔργου|ἔργον|n-s---ng-
φέροντος|φέρω|v-sppang-
τι|τις|p-s---na-
δόξης|δόξα|n-s---fg-
δηλοῦσι|δηλόω|v3ppia---
ἠπειρωτῶν|ἠπειρώτης|n-p---mg-
τινὲς|τις|p-p---mn-
οἷς|ὅς|p-p---md-
κόσμος|κόσμος|n-s---mn-
καλῶς|καλός|d--------
δρᾶν|δράω|v--pna---
παλαιοὶ|παλαιός|a-p---mn-
ποιητῶν|ποιητής|n-p---mg-
πύστεις|πύστις|n-p---fa-
καταπλεόντων|καταπλέω|v-pppamg-
ἐρωτῶντες|ἐρωτάω|v-pppamn-
εἰ|εἰ|c--------
λῃσταί|ληιστής|n-p---mn-
εἰσιν|εἰμί|v3ppia---
πυνθάνονται|πυνθάνομαι|v3ppie---
ἀπαξιούντων|ἀπαξιόω|v-pppamg-
ἔργον|ἔργον|n-s---na-
ἐπιμελὲς|ἐπιμελής|a-s---nn-
εἴη|ἐάω|v3siia---
εἰδέναι|οἶδα|v--rna---
ὀνειδιζόντων|ὀνειδίζω|v-pppamg-
ἐστιν|εἰμί|v3spia---
ἐλῄζοντο|ληίζομαι|v3piie---
κατ̓|κατά|r--------
ἤπειρον|ἤπειρος|n-s---fa-
μέχρι|μέχρι|r--------
τοῦδε|ὅδε|p-s---ng-
τῷ|ὁ|l-s---md-
παλαιῷ|παλαιός|a-s---md-
τρόπῳ|τρόπος|n-s---md-
νέμεται|νέμω|v3spie---
περί|περί|r--------
Λοκροὺς|Λοκροί|n-p---ma-
Ὀζόλας|Ὀζόλαι|n-p---ma-
Αἰτωλοὺς|Αἰτωλοί|n-p---ma-
Ἀκαρνᾶνας|Ἀκαρνάν|n-p---ma-
ταύτῃ|ταύτῃ|d--------
σιδηροφορεῖσθαι|σιδηροφορέω|v--pne---
τούτοις|οὗτος|a-p---md-
ἠπειρώταις|ἠπειρώτης|n-p---md-
παλαιᾶς|παλαιός|a-s---fg-
λῃστείας|λῃστεία|n-s---fg-
ἐμμεμένηκεν|ἐμμένω|v3sria---
πᾶσα|πᾶς|a-s---fn-
ἐσιδηροφόρει|σιδηροφορέω|v3siia---
ἀφάρκτους|ἄφρακτος|a-p---fa-
οἰκήσεις|οἴκησις|n-p---fa-
ἀσφαλεῖς|ἀσφαλής|a-p---fa-
ἐφόδους|ἔφοδος|n-p---fa-
ξυνήθη|ξυνήθης|a-s---fa-
δίαιταν|δίαιτα|n-s---fa-
μεθ̓|μετά|r--------
ὅπλων|ὅπλον|n-p---ng-
ἐποιήσαντο|ποιέω|v3paim---
ὥσπερ|ὥσπερ|c--------
βάρβαροι|βάρβαρος|n-p---mn-
σημεῖον|σημεῖον|n-s---nn-
ἐστὶ|εἰμί|v3spia---
ταῦτα|οὗτος|p-p---nn-
οὕτω|οὕτως|d--------
νεμόμενα|νέμω|v-pppenn-
ποτὲ|ποτέ|d--------
πάντας|πᾶς|a-p---ma-
ὁμοίων|ὁμοῖος|a-p---ng-
διαιτημάτων|διαίτημα|n-p---ng-
Ἀθηναῖοι|Ἀθηναῖος|n-p---mn-
τόν|ὁ|l-s---ma-
σίδηρον|σίδηρος|n-s---ma-
κατέθεντο|κατατίθημι|v3paim---
ἀνειμένῃ|ἀνίημι|v-srpefd-
διαίτῃ|δίαιτα|n-s---fd-
τρυφερώτερον|τρυφερός|a-s---nac
μετέστησαν|μεθίστημι|v3paia---
πρεσβύτεροι|πρέσβυς|a-p---mnc
αὐτοῖς|αὐτός|p-p---md-
εὐδαιμόνων|εὐδαίμων|a-p---mg-
ἁβροδίαιτον|ἁβροδίαιτος|a-s---na-
πολὺς|πολύς|a-s---mn-
χρόνος|χρόνος|n-s---mn-
χιτῶνάς|χιτών|n-p---ma-
λινοῦς|λίνεος|a-p---ma-
ἐπαύσαντο|παύω|v3paim---
φοροῦντες|φορέω|v-pppamn-
χρυσῶν|χρύσεος|a-p---mg-
τεττίγων|τέττιξ|n-p---mg-
ἐνέρσει|ἔνερσις|n-s---fd-
κρωβύλον|κρωβύλος|n-s---ma-
ἀναδούμενοι|ἀναδέω|v-pppemn-
κεφαλῇ|κεφαλή|n-s---fd-
τριχῶν|θρίξ|n-p---fg-
οὗ|ὅς|p-s---ng-
Ἰώνων|Ἴωνες|n-p---mg-
πρεσβυτέρους|πρέσβυς|a-p---ma-
ξυγγενὲς|συγγενής|a-s---na-
πολὺ|πολύς|a-s---na-
σκευὴ|σκευή|n-s---fn-
κατέσχεν|κατέχω|v3saia---
μετρίᾳ|μέτριος|a-s---fd-
αὖ|αὖ|d--------
ἐσθῆτι|ἐσθής|n-s---fd-
τρόπον|τρόπος|n-s---ma-
Λακεδαιμόνιοι|Λακεδαιμόνιος|n-p---mn-
ἐχρήσαντο|χράω|v3paim---
πολλοὺς|πολύς|a-p---ma-
κεκτημένοι|κτάομαι|v-prpemn-
ἰσοδίαιτοι|ἰσοδίαιτος|a-p---mn-
κατέστησαν|καθίστημι|v3paia---
ἐγυμνώθησάν|γυμνόω|v3paip---
φανερὸν|φανερός|a-s---na-
ἀποδύντες|ἀποδύω|v-papamn-
λίπα|λίπος|n-p---na-
μετὰ|μετά|r--------
γυμνάζεσθαι|γυμνάζω|v--pne---
ἠλείψαντο|ἀλείφω|v3paim---
Ὀλυμπικῷ|Ὀλυμπικός|a-s---md-
ἀγῶνι|ἀγών|n-s---md-
διαζώματα|διάζωμα|n-p---na-
περὶ|περί|r--------
αἰδοῖα|αἰδοῖον|n-p---na-
ἀθληταὶ|ἀθλητής|n-p---mn-
ἠγωνίζοντο|ἀγωνίζομαι|v3piie---
ἔτη|ἔτος|n-p---nn-
πέπαυται|παύω|v3srie---
βαρβάροις|βάρβαρος|n-p---md-
ἔστιν|εἰμί|v3spia---
Ἀσιανοῖς|Ἀσιανός|a-p---md-
πυγμῆς|πυγμή|n-s---fg-
πάλης|πάλα|n-s---fg-
ἆθλα|ἆθλον|n-p---nn-
τίθεται|τίθημι|v3spie---
διεζωμένοι|διαζώννυμι|v-prpemn-
δρῶσιν|δράω|v3ppia---
ἀποδείξειε|ἀποδείκνυμι|v3saoa---
παλαιὸν|παλαιός|a-s---na-
ὁμοιότροπα|ὁμοιότροπος|a-p---na-
βαρβαρικῷ|βαρβαρικός|a-s---nd-
διαιτώμενον|διαιτάω|v-sppena-
ὅσαι|ὅσος|a-p---fn-
νεώτατα|νεώτατος|a-p---na-
ᾠκίσθησαν|οἰκίζω|v3paip---
πλωιμωτέρων|πλώιμος|a-p---mgc
περιουσίας|περιουσία|n-p---fa-
ἔχουσαι|ἔχω|v-pppafn-
αἰγιαλοῖς|αἰγιαλός|n-p---md-
τείχεσιν|τεῖχος|n-p---nd-
ἐκτίζοντο|κτίζω|v3piie---
ἰσθμοὺς|ἰσθμός|n-p---ma-
ἀπελάμβανον|ἀπολαμβάνω|v3piia---
προσοίκους|πρόσοικος|a-p---ma-
ἰσχύος|ἰσχύς|n-s---fg-
αἱ|ὁ|l-p---fn-
παλαιαὶ|παλαιός|a-p---fn-
ἀντίσχουσαν|ἀντί-ἴσχω|v-sppafa-
ταῖς|ὁ|l-p---fd-
νήσοις|νῆσος|n-p---fd-
ἠπείροις|ἤπειρος|n-p---fd-
(|(|u--------
ἔφερον|φέρω|v3piia---
ἄλλων|ἄλλος|p-p---mg-
ὄντες|εἰμί|v-pppamn-
θαλάσσιοι|θαλάσσιος|a-p---mn-
κάτω|κάτω|d--------
)|)|u--------
ἀνῳκισμένοι|ἀνοικίζω|v-prpemn-
εἰσίν|εἰμί|v3ppia---
ἧσσον|ἥσσων|a-s---nac
λῃσταὶ|λῃστής|n-p---mn-
νησιῶται|νησιώτης|n-p---mn-
Κᾶρές|Κάρ|n-p---mn-
Φοίνικες|Φοῖνιξ|n-p---mn-
οὗτοι|οὗτος|p-p---mn-
πλείστας|πλεῖστος|a-p---fa-
ᾤκησαν|οἰκέω|v3paia---
μαρτύριον|μαρτύριον|n-s---nn-
Δήλου|Δῆλος|n-s---fg-
καθαιρομένης|καθαίρω|v-sppefg-
τῷδε|ὅδε|a-s---md-
θηκῶν|θήκη|n-p---fg-
ἀναιρεθεισῶν|ἀναιρέω|v-pappfg-
τεθνεώτων|θνήσκω|v-prpamg-
νήσῳ|νῆσος|n-s---fd-
ὑπὲρ|ὑπέρ|r--------
ἥμισυ|ἥμισυς|a-s---na-
Κᾶρες|Κάρ|n-p---mn-
ἐφάνησαν|φανάω|v3piia---
γνωσθέντες|γιγνώσκω|v-pappmn-
σκευῇ|σκευή|n-s---fd-
ξυντεθαμμένῃ|συνθάπτω|v-srpefd-
ᾧ|ὅς|p-s---md-
θάπτουσιν|θάπτω|v3ppia---
καταστάντος|καθίστημι|v-sapamg-
Μίνω|Μίνως|n-s---mg-
ναυτικοῦ|ναυτικός|a-s---mg-
πλωιμώτερα|πλώιμος|a-p---nnc
κακοῦργοι|κακοῦργος|a-p---mn-
ἀνέστησαν|ἀνίστημι|v3paia---
ὑπ̓|ὑπό|r--------
ὅτεπερ|ὅτε|c--------
πολλὰς|πολύς|a-p---fa-
κατῴκιζε|κατοικίζω|v3siia---
παρὰ|παρά|r--------
θάλασσαν|θάλασσα|n-s---fa-
κτῆσιν|κτῆσις|n-s---fa-
ποιούμενοι|ποιόω|v-pppemn-
βεβαιότερον|βέβαιος|a-s---nac
καί|καί|c--------
τινες|τις|p-p---mn-
τείχη|τεῖχος|n-p---na-
περιεβάλλοντο|περιβάλλω|v3piie---
πλουσιώτεροι|πλούσιος|a-p---mnc
ἐφιέμενοι|ἐφίημι|v-pppemn-
κερδῶν|κέρδος|n-p---ng-
ἥσσους|ἥσσων|a-p---mnc
ὑπέμενον|ὑπομένω|v3piia---
κρεισσόνων|κρείσσων|a-p---mgc
δουλείαν|δουλεία|n-s---fa-
δυνατώτεροι|δυνατός|a-p---mnc
προσεποιοῦντο|προσποιέω|v3piie---
ὑπηκόους|ὑπήκους|a-p---fa-
ἐλάσσους|ἐλάσσων|a-p---fac
τούτῳ|οὗτος|a-s---md-
χρόνῳ|χρόνος|n-s---md-
Τροίαν|Τροία|n-s---fa-
ἐστράτευσαν|στρατεύω|v3paia---
Ἀγαμέμνων|Ἀγαμέμνων|n-s---mn-
τέ|τε|d--------
τότε|τότε|d--------
δυνάμει|δύναμις|n-s---fd-
προύχων|προέχω|v-sppamn-
τοσοῦτον|τοσοῦτος|p-s---na-
Τυνδάρεω|Τυνδάρεως|n-s---mg-
ὅρκοις|ὅρκος|n-p---md-
κατειλημμένους|καταλαμβάνω|v-prpema-
Ἑλένης|Ἑλένη|n-s---fg-
μνηστῆρας|μνηστήρ|n-p---ma-
ἄγων|ἄγω|v-sppamn-
στόλον|στόλος|n-s---ma-
ἀγεῖραι|ἀγείρω|v--ana---
λέγουσι|λέγω|v3ppia---
σαφέστατα|σαφής|a-p---nas
μνήμῃ|μνήμη|n-s---fd-
δεδεγμένοι|δέχομαι|v-prpemn-
Πέλοπά|Πέλοψ|n-s---ma-
πρῶτον|πρῶτος|a-s---ma-
ἃ|ὅς|p-p---na-
ἦλθεν|ἔρχομαι|v3saia---
Ἀσίας|Ἀσία|n-s---fg-
ἔχων|ἔχω|v-sppamn-
ἀνθρώπους|ἄνθρωπος|n-p---ma-
ἀπόρους|ἄπορος|a-p---ma-
δύναμιν|δύναμις|n-s---fa-
περιποιησάμενον|περιποιέω|v-sapmma-
χώρας|χώρα|n-s---fg-
ἔπηλυν|ἔπηλυς|n-s---ma-
ὄντα|εἰμί|v-sppama-
ὅμως|ὅμως|d--------
σχεῖν|ἔχω|v--ana---
ἐκγόνοις|ἔκγονος|a-p---md-
ξυνενεχθῆναι|συμφέρω|v--anp---
Εὐρυσθέως|Εὐρυσθεύς|n-s---mg-
Ἀττικῇ|Ἀττική|n-s---fd-
Ἡρακλειδῶν|Ἡρακλείδαι|n-p---mg-
ἀποθανόντος|ἀποθνήσκω|v-sapamg-
Ἀτρέως|Ἀτρεύς|n-s---mg-
μητρὸς|μήτηρ|n-s---fg-
ἀδελφοῦ|ἀδελφός|n-s---mg-
ὄντος|εἰμί|v-sppamg-
ἐπιτρέψαντος|ἐπιτρέπω|v-sapamg-
ὅτ̓|ὅτε|c--------
ἐστράτευε|στρατεύω|v3siia---
Μυκήνας|Μυκήνη|n-p---fa-
ἀρχὴν|ἀρχή|n-s---fa-
οἰκεῖον|οἰκέω|v-sppana-
Ἀτρεῖ|Ἀτρεύς|n-s---md-
τυγχάνειν|τυγχάνω|v--pna---
φεύγοντα|φεύγω|v-sppama-
πατέρα|πατήρ|n-s---ma-
Χρυσίππου|Χρύσιππος|n-s---mg-
θάνατον|θάνατος|n-s---ma-
οὐκέτι|οὐκέτι|d--------
ἀνεχώρησεν|ἀναχωρέω|v3saia---
Εὐρυσθεύς|Εὐρυσθεύς|n-s---mn-
βουλομένων|βούλομαι|v-pppemg-
Μυκηναίων|Μυκηναῖος|n-p---mg-
φόβῳ|φόβος|n-s---md-
δυνατὸν|δυνατός|a-s---ma-
δοκοῦντα|δοκόω|v-sppama-
τεθεραπευκότα|θεραπεύω|v-prpana-
ὅσων|ὅσος|a-p---mg-
Εὐρυσθεὺς|Εὐρυσθεύς|n-s---mn-
ἦρχε|ἄρχω|v3sria---
βασιλείαν|βασιλεία|n-s---fa-
Ἀτρέα|Ἀτρεύς|n-s---ma-
παραλαβεῖν|παραλαμβάνω|v--ana---
Περσειδῶν|Περσείδης|n-p---mg-
Πελοπίδας|Πελοπίδης|n-p---ma-
καταστῆναι|καθίστημι|v--ana---
ἅ|ὅς|p-p---na-
παραλαβὼν|παραλαμβάνω|v-sapamn-
ναυτικῷ|ναυτικός|a-s---nd-
πλέον|πλείων|a-s---nac
ἰσχύσας|ἰσχύω|v-sapamn-
χάριτι|χάρις|n-s---fd-
ξυναγαγὼν|συνάγω|v-sapamn-
ποιήσασθαι|ποιέω|v--anm---
ναυσί|ναῦς|n-p---fd-
πλείσταις|πλεῖστος|a-p---fd-
αὐτὸς|αὐτός|p-s---mn-
ἀφικόμενος|ἀφικνέομαι|v-sapmmn-
Ἀρκάσι|Ἀρκάς|n-p---md-
προσπαρασχών|προσπαρέχω|v-sapamn-
δεδήλωκεν|δηλόω|v3sria---
εἴ|εἰ|c--------
τῳ|τις|p-s---nd-
ἱκανὸς|ἱκανός|a-s---mn-
τεκμηριῶσαι|τεκμηριόω|v--ana---
σκήπτρου|σκῆπτρον|n-s---ng-
παραδόσει|παράδοσις|n-s---fd-
εἴρηκεν|ἐρῶ|v3sria---
πολλῇσι|πολύς|a-p---fd-
νήσοισι|νῆσος|n-p---fd-
Ἄργεϊ|Ἄργος|n-s---nd-
παντὶ|πᾶς|a-s---nd-
ἀνάσσειν|ἀνάσσω|v--pna---
ἔξω|ἔξω|r--------
περιοικίδων|περιοικίς|n-p---fg-
αὗται|οὗτος|p-p---fn-
πολλαὶ|πολύς|a-p---fn-
εἶεν|εἰμί|v3ppoa---
ἠπειρώτης|ἠπειρώτης|n-s---mn-
ὢν|εἰμί|v-sppamn-
ἐκράτει|κρατέω|v3siia---
μή|μή|d--------
εἰκάζειν|εἰκάζω|v--pna---
χρὴ|χρή|v3spia---
στρατείᾳ|στρατεία|n-s---fd-
οἷα|οἷος|a-p---nn-
αὐτῆς|αὐτός|p-s---fg-
Μυκῆναι|Μυκήνη|n-p---fn-
μικρὸν|μικρός|a-s---nn-
πόλισμα|πόλισμα|n-s---nn-
ἀξιόχρεων|ἀξιόχρεως|a-p---ng-
ἀκριβεῖ|ἀκριβής|a-s---nd-
ἄν|ἄν|d--------
σημείῳ|σημεῖον|n-s---nd-
χρώμενος|χράομαι|v-sppemn-
ἀπιστοίη|ἀπιστέω|v3spoa---
ποιηταὶ|ποιητής|n-p---mn-
εἰρήκασι|ἐρῶ|v3pria---
ὁ|ὁ|l-s---mn-
λόγος|λόγος|n-s---mn-
κατέχει|κατέχω|v3spia---
Λακεδαιμονίων|Λακεδαιμόνιος|n-p---mg-
πόλις|πόλις|n-s---fn-
ἐρημωθείη|ἐρημόω|v3saop---
λειφθείη|λείπω|v3saop---
τά|ὁ|l-p---nn-
ἱερὰ|ἱερόv|n-p---nn-
κατασκευῆς|κατασκευή|n-s---fg-
ἐδάφη|ἔδαφος|n-p---nn-
πολλὴν|πολύς|a-s---fa-
οἶμαι|οἴομαι|v1spie---
ἀπιστίαν|ἀπιστία|n-s---fa-
δυνάμεως|δύναμις|n-s---fg-
προελθόντος|προέρχομαι|v-sapamg-
ἔπειτα|ἔπειτα|d--------
κλέος|κλέος|n-s---na-
καίτοι|καίτοι|d--------
πέντε|πέντε|a--------
δύο|δύο|a--------
μοίρας|μοῖρα|n-p---fa-
νέμονται|νέμω|v3ppie---
ξυμπάσης|σύμπας|a-s---fg-
ἡγοῦνται|ἡγέομαι|v3ppie---
ξυμμάχων|σύμμαχος|a-p---mg-
πολλῶν|πολύς|a-p---mg-
ξυνοικισθείσης|συνοικίζω|v-sappfg-
πόλεως|πόλις|n-s---fg-
ἱεροῖς|ἱερόν|n-p---nd-
κατασκευαῖς|κατασκευή|n-p---fd-
πολυτελέσι|πολυτελής|a-p---fd-
χρησαμένης|χράω|v-sapmfg-
οἰκισθείσης|οἰκίζω|v-sappfg-
φαίνοιτ̓|φαίνω|v3spoe---
ὑποδεεστέρα|ὑποδεής|a-s---fnc
παθόντων|πάσχω|v-papamg-
διπλασίαν|διπλάσιος|a-s---fa-
εἰκάζεσθαι|εἰκάζω|v--pne---
φανερᾶς|φανερός|a-s---fg-
ὄψεως|ὄψις|n-s---fg-
οὔκουν|οὔκουν|d--------
ἀπιστεῖν|ἀπιστέω|v--pna---
ὄψεις|ὄψις|n-p---fa-
σκοπεῖν|σκοπάω|v--pna---
νομίζειν|νομίζω|v--pna---
ἐκείνην|ἐκεῖνος|a-s---fa-
μεγίστην|μέγας|a-s---fa-
αὑτῆς|ἑαυτοῦ|p-s---fg-
λειπομένην|λείπω|v-sppefa-
Ὁμήρου|Ὅμηρος|n-s---mg-
ποιήσει|ποίησις|n-s---fd-
κ-|καί|d--------
ἀνταῦθα|ἐνταῦθα|d--------
πιστεύειν|πιστεύω|v--pna---
ἣν|ὅς|p-s---fa-
εἰκὸς|εἰκός|v-srpann-
μεῖζον|μέγας|a-s---nac
ποιητὴν|ποιητής|n-s---ma-
κοσμῆσαι|κοσμέω|v--ana---
οὕτως|οὕτως|d--------
ἐνδεεστέρα|ἐνδεής|a-s---fnc
πεποίηκε|ποιέω|v3sria---
χιλίων|χίλιοι|a-p---fg-
διακοσίων|διακόσιοι|a-p---fg-
νεῶν|ναῦς|n-p---fg-
Βοιωτῶν|Βοιωτός|n-p---mg-
εἴκοσι|εἴκοσι|a--------
ἑκατὸν|ἑκατόν|a--------
Φιλοκτήτου|Φιλοκτήτης|n-s---mg-
πεντήκοντα|πεντήκοντα|a--------
δηλῶν|δηλόω|v-sppamn-
μεγίστας|μέγας|a-p---fa-
ἐλαχίστας|ἐλάχιστος|a-p---fa-
μεγέθους|μέγεθος|n-s---ng-
πέρι|περί|r--------
καταλόγῳ|κατάλογος|n-s---md-
ἐμνήσθη|μιμνήσκω|v3saip---
αὐτερέται|αὐτερέτης|n-p---mn-
μάχιμοι|μάχιμος|a-p---mn-
πάντες|πᾶς|a-p---mn-
ναυσὶ|ναῦς|n-p---fd-
τοξότας|τοξότης|n-p---ma-
προσκώπους|πρόσκωπος|a-p---ma-
περίνεως|περίνεως|n-p---ma-
ξυμπλεῖν|συμπλέω|v--pna---
βασιλέων|βασιλεύς|n-p---mg-
τέλει|τέλος|n-s---nd-
ἄλλως|ἄλλως|d--------
μέλλοντας|μέλλω|v-pppama-
πέλαγος|πέλαγος|n-s---na-
περαιώσεσθαι|περαιόω|v--fnm---
σκευῶν|σκεῦος|n-p---ng-
πολεμικῶν|πολεμικός|a-p---ng-
πλοῖα|πλοῖον|n-p---na-
κατάφαρκτα|κατάφρακτος|a-p---na-
ἔχοντας|ἔχω|v-pppama-
λῃστικώτερον|λῃστικός|a-s---nac
παρεσκευασμένα|παρασκευάζω|v-prpenn-
ναῦς|ναῦς|n-p---fa-
μέσον|μέσος|a-s---na-
σκοποῦντι|σκοπέω|v-sppamd-
πολλοὶ|πολύς|a-p---mn-
φαίνονται|φαίνω|v3ppie---
ἐλθόντες|ἔρχομαι|v-papamn-
πάσης|πᾶς|a-s---fg-
πεμπόμενοι|πέμπω|v-pppemn-
αἴτιον|αἴτιος|a-s---nn-
ὀλιγανθρωπία|ὀλιγανθρωπία|n-s---fn-
ἀχρηματία|ἀχρηματία|n-s---fn-
ἀπορίᾳ|ἀπορία|n-s---fd-
στρατὸν|στρατός|n-s---ma-
ἐλάσσω|ἐλάσσων|a-s---mac
ἤγαγον|ἄγω|v3paia---
ἤλπιζον|ἐλπίζω|v3piia---
αὐτόθεν|αὐτόθεν|d--------
πολεμοῦντα|πολεμέω|v-sppama-
βιοτεύσειν|βιοτεύω|v--fna---
ἀφικόμενοι|ἀφικνέομαι|v-papmmn-
μάχῃ|μάχη|n-s---fd-
ἐκράτησαν|κρατέω|v3paia---
δῆλον|δῆλος|a-s---nn-
ἔρυμα|ἔρυμα|n-s---na-
στρατοπέδῳ|στρατόπεδον|n-s---nd-
ἐτειχίσαντο|τειχίζω|v3paim---
ἐνταῦθα|ἐνταῦθα|d--------
χρησάμενοι|χράω|v-papmmn-
γεωργίαν|γεωργία|n-s---fa-
Χερσονήσου|Χερσόνησος|n-s---fg-
τραπόμενοι|τρέπω|v-papmmn-
ᾗ|ὅς|p-s---fd-
Τρῶες|Τρώς|n-p---mn-
διεσπαρμένων|διασπείρω|v-prpemg-
δέκα|δέκα|a--------
ἀντεῖχον|ἀντέχω|v3piia---
βίᾳ|βία|n-s---fd-
ὑπολειπομένοις|ὑπολείπω|v-pppemd-
ἀντίπαλοι|ἀντίπαλος|a-p---mn-
ἦλθον|ἔρχομαι|v3paia---
ἄνευ|ἄνευ|r--------
γεωργίας|γεωργία|n-s---fg-
ξυνεχῶς|συνεχής|d--------
διέφερον|διαφέρω|v3piia---
κρατοῦντες|κρατέω|v-pppamn-
εἷλον|αἱρέω|v3paia---
παρόντι|πάρειμι|v-sppand-
πολιορκίᾳ|πολιορκία|n-s---fd-
προσκαθεζόμενοι|προσκαθέζομαι|v-pppemn-
ἐλάσσονί|ἐλάσσων|a-s---mdc
ἀπονώτερον|ἄπονος|a-s---nac
ἀχρηματίαν|ἀχρηματία|n-s---fa-
τούτων|οὗτος|p-p---ng-
ἀσθενῆ|ἀσθενής|a-p---nn-
αὐτά|αὐτός|a-p---nn-
ὀνομαστότατα|ὀνομαστός|a-p---nns
πρὶν|πρίν|d--------
γενόμενα|γίγνομαι|v-papmnn-
δηλοῦται|δηλόω|v3spie---
ἔργοις|ἔργον|n-p---nd-
ὑποδεέστερα|ὑποδεής|a-p---nnc
φήμης|φήμη|n-s---fg-
ποιητὰς|ποιητής|n-p---ma-
κατεσχηκότος|κατέχω|v-srpamg-
ἐπεὶ|ἐπεί|d--------
Τρωικὰ|Τρωικός|a-p---na-
μετανίστατό|μετανίστημι|v3siie---
κατῳκίζετο|κατοικίζω|v3siie---
ἡσυχάσασαν|ἡσυχάζω|v-sapafa-
ἀναχώρησις|ἀναχώρησις|n-s---fn-
Ἑλλήνων|Ἕλλην|n-p---mg-
Ἰλίου|Ἴλιον|n-s---ng-
χρονία|χρόνιος|a-s---fn-
γενομένη|γίγνομαι|v-sapmfn-
ἐνεόχμωσε|νεοχμόω|v3saia---
ἐγίγνοντο|γίγνομαι|v3piie---
ἔκτιζον|κτίζω|v3piia---
Βοιωτοί|Βοιωτός|n-p---mn-
ἑξηκοστῷ|ἑξηκοστός|a-s---nd-
ἔτει|ἔτος|n-s---nd-
ἅλωσιν|ἅλωσις|n-s---fa-
Ἄρνης|Ἄρνη|n-s---fg-
ἀναστάντες|ἀνίστημι|v-papamn-
Θεσσαλῶν|Θεσσαλός|n-p---mg-
Βοιωτίαν|Βοιωτία|n-s---fa-
Καδμηίδα|Καδμηίς|n-s---fa-
καλουμένην|καλέω|v-sppefa-
ᾤκισαν|οἰκίζω|v3paia---
ἀποδασμὸς|ἀποδασμός|n-s---mn-
γῇ|γῆ|n-s---fd-
Ἴλιον|Ἴλιον|n-s---na-
Δωριῆς|Δωριεύς|n-p---mn-
ὀγδοηκοστῷ|ὀγδοηκοστός|a-s---nd-
ξὺν|σύν|r--------
Ἡρακλείδαις|Ἡρακλείδαι|n-p---md-
Πελοπόννησον|Πελοπόννησος|n-s---fa-
ἔσχον|ἔχω|v3paia---
μόλις|μόλις|d--------
ἡσυχάσασα|ἡσυχάζω|v-sapafn-
ἀνισταμένη|ἀνίστημι|v-sppefn-
ἐξέπεμψε|ἐκπέμπω|v3saia---
Ἴωνας|Ἴωνες|n-p---ma-
νησιωτῶν|νησιώτης|n-p---mg-
Ἰταλίας|Ἰταλία|n-s---fg-
Σικελίας|Σικελία|n-s---fg-
Πελοποννήσιοι|Πελοποννήσιοι|n-p---mn-
χωρία|χωρίον|n-p---nn-
πάντα|πᾶς|a-p---nn-
ἐκτίσθη|κτίζω|v3saip---
δυνατωτέρας|δυνατός|a-s---fgc
γιγνομένης|γίγνομαι|v-sppefg-
ποιουμένης|ποιέω|v-sppefg-
τυραννίδες|τυραννίς|n-p---fn-
πόλεσι|πόλις|n-p---fd-
καθίσταντο|καθίστημι|v3piie---
προσόδων|πρόσοδος|n-p---fg-
μειζόνων|μέγας|a-p---fgc
γιγνομένων|γίγνομαι|v-pppefg-
ῥητοῖς|ῥητός|a-p---nd-
γέρασι|γέρας|n-p---nd-
πατρικαὶ|πατρικός|a-p---fn-
βασιλεῖα|βασιλεία|n-p---fn-
ναυτικά|ναυτικός|a-p---na-
ἐξηρτύετο|ἐξαρτύω|v3siie---
ἀντείχοντο|ἀντέχω|v3piie---
Κορίνθιοι|Κορίνθιος|n-p---mn-
λέγονται|λέγω|v3ppie---
ἐγγύτατα|ἐγγύτατος|a-p---na-
τρόπου|τρόπος|n-s---mg-
μεταχειρίσαι|μεταχειρίζω|v--ana---
τριήρεις|τριήρης|n-p---fn-
Κορίνθῳ|Κόρινθος|n-s---fd-
ναυπηγηθῆναι|ναυπηγέω|v--anp---
Σαμίοις|Σάμιος|n-p---md-
Ἀμεινοκλῆς|Ἀμεινοκλῆς|n-s---mn-
Κορίνθιος|Κορίνθιος|a-s---mn-
ναυπηγὸς|ναυπηγός|n-s---mn-
ποιήσας|ποιέω|v-sapamn-
τέσσαρας|τέσσαρες|n-p---fa-
τριακόσια|τριακόσιοι|a-p---nn-
τελευτὴν|τελευτή|n-s---fa-
πολέμου|πόλεμος|n-s---mg-
ὅτε|ὅτε|c--------
ναυμαχία|ναυμαχία|n-s---fn-
παλαιτάτη|παλαιός|a-s---fn-
γίγνεται|γίγνομαι|v3spie---
Κορινθίων|Κορίνθιος|n-p---mg-
Κερκυραίους|Κερυκυραῖος|n-p---ma-
ἑξήκοντα|ἑξήκοντα|a--------
διακόσιά|διακόσιοι|a-p---nn-
οἰκοῦντες|οἰκέω|v-pppamn-
Ἰσθμοῦ|Ἰσθμός|n-s---mg-
δή|δή|d--------
ποτε|ποτέ|d--------
ἐμπόριον|ἐμπόριος|n-s---ma-
ἐντὸς|ἐντός|r--------
ἐκείνων|ἐκεῖνος|p-p---mg-
ἐπιμισγόντων|ἐπιμίγνυμι|v-pppamg-
χρήμασί|χρῆμα|n-p---nd-
δυνατοὶ|δυνατός|a-p---mn-
παλαιοῖς|παλαιός|a-p---md-
ποιηταῖς|ποιητής|n-p---md-
δεδήλωται|δηλόω|v3srie---
ἀφνειὸν|ἀφνειός|a-s---na-
ἐπωνόμασαν|ἐπονομάζω|v3paia---
χωρίον|χωρίον|n-s---na-
ἐπειδή|ἐπεί|c--------
ἔπλῳζον|πλωίζω|v3piia---
κτησάμενοι|κτάομαι|v-papmmn-
λῃστικὸν|λῃστικός|a-s---na-
καθῄρουν|καθαιρέω|v3piia---
παρέχοντες|παρέχω|v-pppamn-
ἀμφότερα|ἀμφότερος|a-p---na-
δυνατὴν|δυνατός|a-s---fa-
προσόδῳ|πρόσοδος|n-s---fd-
Ἴωσιν|Ἴωνες|n-p---md-
Κύρου|Κῦρος|n-s---mg-
Περσῶν|Πέρσης|n-p---mg-
πρώτου|πρῶτος|a-s---mg-
βασιλεύοντος|βασιλεύω|v-sppamg-
Καμβύσου|Καμβύσης|n-s---mg-
υἱέος|υἱός|n-s---mg-
ἑαυτοὺς|ἑαυτοῦ|p-p---ma-
Κύρῳ|Κῦρος|n-s---md-
πολεμοῦντες|πολεμέω|v-pppamn-
ἐκράτησάν|κρατέω|v3paia---
τινα|τις|a-s---ma-
χρόνον|χρόνος|n-s---ma-
Πολυκράτης|Πολυκράτης|n-s---mn-
Σάμου|Σάμος|n-s---fg-
τυραννῶν|τυραννεύω|v-sppamn-
ἰσχύων|ἰσχύω|v-sppamn-
ἐποιήσατο|ποιέω|v3saim---
Ῥήνειαν|Ῥηνεία|n-s---fa-
ἑλὼν|αἱρέω|v-sapamn-
ἀνέθηκε|ἀνατίθημι|v3saia---
Ἀπόλλωνι|Ἀπόλλων|n-s---md-
Δηλίῳ|Δήλιος|a-s---md-
Φωκαῆς|Φωκαιεύς|n-p---mn-
Μασσαλίαν|Μασσαλία|n-s---fa-
οἰκίζοντες|οἰκίζω|v-pppamn-
Καρχηδονίους|Καρχηδόνιος|n-p---ma-
ἐνίκων|νικάω|v3piia---
ναυμαχοῦντες|ναυμαχέω|v-pppamn-
δυνατώτατα|δυνατός|a-p---nns
ναυτικῶν|ναυτικός|a-p---ng-
πολλαῖς|πολύς|a-p---fd-
γενεαῖς|γενεά|n-p---fd-
ὕστερα|ὕστερον|n-p---na-
τριήρεσι|τριήρης|n-p---fd-
ὀλίγαις|ὀλίγος|a-p---fd-
χρώμενα|χράω|v-pppenn-
πεντηκοντόροις|πεντηκόντορος|n-p---md-
πλοίοις|πλοῖον|n-p---nd-
μακροῖς|μακρός|a-p---nd-
ἐξηρτυμένα|ἐξαρτύω|v-prpenn-
ἐκεῖνα|ἐκεῖνος|p-p---nn-
ὀλίγον|ὀλίγος|a-s---na-
Μηδικῶν|Μηδικός|a-p---ng-
Δαρείου|Δαρεῖος|n-s---mg-
θανάτου|θάνατος|n-s---mg-
ὃς|ὅς|p-s---mn-
Καμβύσην|Καμβύσης|n-s---ma-
ἐβασίλευσε|βασιλεύω|v3saia---
Σικελίαν|Σικελία|n-s---fa-
τυράννοις|τύραννος|n-p---md-
ἐγένοντο|γίγνομαι|v3paim---
Κερκυραίοις|Κερυκυραῖος|n-p---md-
τελευταῖα|τελευταῖος|a-p---nn-
Ξέρξου|Ξέρξης|n-s---mg-
στρατείας|στρατεία|n-s---fg-
ναυτικὰ|ναυτικός|a-p---nn-
ἀξιόλογα|ἀξιόλογος|a-p---nn-
Ἑλλάδι|Ἑλλάς|n-s---fd-
κατέστη|καθίστημι|v3saia---
Αἰγινῆται|Αἰγινήτης|n-p---mn-
ἄλλοι|ἄλλος|p-p---mn-
βραχέα|βραχύς|a-p---na-
ἐκέκτηντο|κτάομαι|v3plie---
πεντηκοντόρους|πεντηκόντορος|n-p---ma-
ὀψέ|ὀψέ|d--------
Θεμιστοκλῆς|Θεμιστοκλῆς|n-s---mn-
ἔπεισεν|πείθω|v3saia---
Αἰγινήταις|Αἰγινήτης|n-p---md-
πολεμοῦντας|πολεμόω|v-pppama-
βαρβάρου|βάρβαρος|a-s---mg-
προσδοκίμου|προσδόκιμος|a-s---mg-
αἷσπερ|ὅς|p-p---fd-
ἐναυμάχησαν|ναυμαχέω|v3paia---
οὔπω|οὔπω|d--------
καταστρώματα|κατάστρωμα|n-p---na-
τοιαῦτα|τοιοῦτος|p-p---nn-
παλαιὰ|παλαιός|a-p---nn-
ἰσχὺν|ἰσχύς|n-s---fa-
περιεποιήσαντο|περιποιέω|v3paim---
ἐλαχίστην|ἐλάχιστος|a-s---fa-
προσσχόντες|προσέχω|v-papamn-
ἀρχῇ|ἀρχή|n-s---fd-
ἐπιπλέοντες|ἐπιπλέω|v-pppamn-
κατεστρέφοντο|καταστρέφω|v3piie---
διαρκῆ|διαρκής|a-s---fa-
χώραν|χώρα|n-s---fa-
πόλεμος|πόλεμος|n-s---mn-
ὅθεν|ὅθεν|d--------
δύναμις|δύναμις|n-s---fn-
παρεγένετο|παραγίγνομαι|v3saim---
οὐδεὶς|οὐδείς|a-s---mn-
ξυνέστη|συνίστημι|v3saia---
ὁμόρους|ὅμορος|a-p---ma-
σφετέρους|σφέτερος|a-p---ma-
ἑκάστοις|ἕκαστος|a-p---md-
ἐκδήμους|ἔκδημος|a-p---fa-
καταστροφῇ|καταστροφή|n-s---fd-
ἐξῇσαν|ἔξειμι|v3piia---
ξυνειστήκεσαν|συνίστημι|v3plia---
ὑπήκοοι|ὑπήκους|a-p---mn-
ἴσης|ἴσος|a-s---fg-
κοινὰς|κοινός|a-p---fa-
ἀστυγείτονες|ἀστυγείτων|a-p---mn-
ἐπολέμουν|πολεμόω|v3piia---
γενόμενον|γίγνομαι|v-sapmma-
Χαλκιδέων|Χαλκιδεύς|n-p---mg-
Ἐρετριῶν|Ἐρετριός|a-p---fg-
ξυμμαχίαν|συμμαχία|n-s---fa-
ἑκατέρων|ἑκάτερος|a-p---mg-
διέστη|διίστημι|v3saia---
ἐπεγένετο|ἐπιγίγνομαι|v3saim---
ἄλλοις|ἄλλος|p-p---md-
ἄλλοθι|ἄλλοθι|d--------
κωλύματα|κώλυμα|n-p---nn-
Ἴωσι|Ἴωνες|n-p---md-
προχωρησάντων|προχωρέω|v-papang-
μέγα|μέγας|a-s---na-
πραγμάτων|πρᾶγμα|n-p---ng-
Κῦρος|Κῦρος|n-s---mn-
Περσικὴ|Περσικός|a-s---fn-
βασιλεία|βασιλεία|n-s---fn-
Κροῖσον|Κροῖσος|n-s---ma-
καθελοῦσα|καθαιρέω|v-sapafn-
Ἅλυος|Ἅλυς|n-s---fg-
ποταμοῦ|ποταμός|n-s---mg-
ἐπεστράτευσε|ἐπιστρατεύω|v3saia---
ἐδούλωσε|δουλόω|v3saia---
Δαρεῖός|Δαρεῖος|n-s---mn-
Φοινίκων|Φοῖνιξ|n-p---mg-
κρατῶν|κρατέω|v-sppamn-
τύραννοί|τύραννος|n-p---mn-
Ἑλληνικαῖς|Ἑλληνικός|a-p---fd-
μόνον|μόνος|a-s---na-
προορώμενοι|προοράω|v-pppemn-
ἔς|εἰς|r--------
σῶμα|σῶμα|n-s---na-
ἴδιον|ἴδιος|a-s---ma-
οἶκον|οἶκος|n-s---ma-
αὔξειν|αὐξάνω|v--pna---
ἀσφαλείας|ἀσφάλεια|n-s---fg-
ἐδύναντο|δύναμαι|v3piie---
ἐπράχθη|πράσσω|v3saip---
ἀπ̓|ἀπό|r--------
ἀξιόλογον|ἀξιόλογος|a-s---nn-
περιοίκους|περίοικος|a-p---ma-
Σικελίᾳ|Σικελία|n-s---fd-
ἐχώρησαν|χωρέω|v3paia---
πανταχόθεν|πανταχόθεν|d--------
πολὺν|πολύς|a-s---ma-
κατείχετο|κατέχω|v3siie---
μήτε|μήτε|d--------
μηδὲν|μηδείς|p-s---na-
κατεργάζεσθαι|κατεργάζομαι|v--pne---
ἀτολμοτέρα|ἄτολμος|a-d---fnc
τύραννοι|τύραννος|n-p---mn-
τυραννευθείσης|τυραννεύω|v-sappfg-
πλεῖστοι|πλεῖστος|a-p---mn-
τελευταῖοι|τελευταῖος|a-p---mn-
κατελύθησαν|καταλύω|v3paip---
Λακεδαίμων|Λακεδαίμων|n-s---fn-
κτίσιν|κτίσις|n-s---fa-
ἐνοικούντων|ἐνοικέω|v-pppamg-
αὐτὴν|αὐτός|p-s---fa-
Δωριῶν|Δώριος|n-p---mg-
στασιάσασα|στασιάζω|v-sapafn-
παλαιτάτου|παλαιός|a-s---ng-
ηὐνομήθη|εὐνομέομαι|v3saip---
ἀτυράννευτος|ἀτυράννευτος|a-s---mn-
γάρ|γάρ|d--------
τετρακόσια|τετρακόσιοι|a-p---nn-
ὀλίγῳ|ὀλίγος|a-s---nd-
αὐτῇ|αὐτός|a-s---fd-
πολιτείᾳ|πολιτεία|n-s---fd-
χρῶνται|χράομαι|v3ppie---
δυνάμενοι|δύναμαι|v-pppemn-
ἄλλαις|ἄλλος|a-p---fd-
καθίστασαν|καθιστάω|v3paia---
τυράννων|τύραννος|n-p---mg-
κατάλυσιν|κατάλυσις|n-s---fa-
πολλοῖς|πολύς|a-p---nd-
ἔτεσιν|ἔτος|n-p---nd-
Μαραθῶνι|Μαραθών|n-s---md-
μάχη|μάχη|n-s---fn-
Μήδων|Μήδων|n-s---mn-
δεκάτῳ|δέκατος|a-s---nd-
αὖθις|αὖθις|d--------
βάρβαρος|βάρβαρος|a-s---mn-
μεγάλῳ|μέγας|a-s---md-
στόλῳ|στόλος|n-s---md-
Ἑλλάδα|Ἑλλάς|n-s---fa-
δουλωσόμενος|δουλόω|v-sfpmmn-
μεγάλου|μέγας|a-s---mg-
κινδύνου|κίνδυνος|n-s---mg-
ἐπικρεμασθέντος|ἐπικρεμάννυμι|v-sappmg-
ξυμπολεμησάντων|συμπολεμέω|v-papamg-
ἡγήσαντο|ἡγέομαι|v3paim---
προύχοντες|προέχω|v-pppamn-
ἐπιόντων|ἔπειμι|v-pppamg-
διανοηθέντες|διανοέομαι|v-papemn-
ἐκλιπεῖν|ἐκλείπω|v--ana---
ἀνασκευασάμενοι|ἀνασκευάζω|v-papmmn-
ἐσβάντες|εἰσβαίνω|v-papamn-
ναυτικοὶ|ναυτικός|a-p---mn-
ἀπωσάμενοι|ἀπωθέω|v-papmmn-
βάρβαρον|βάρβαρος|a-s---ma-
διεκρίθησαν|διακρίνω|v3paip---
πρός|πρός|r--------
Λακεδαιμονίους|Λακεδαιμόνιος|n-p---ma-
ἀποστάντες|ἀφεστήξω|v-papamn-
βασιλέως|βασιλεύς|n-s---mg-
ξυμπολεμήσαντες|συμπολεμέω|v-papamn-
μέγιστα|μέγας|a-p---nn-
διεφάνη|διαφαίνω|v3saip---
ναυσίν|ναῦς|n-p---fd-
ξυνέμεινεν|συμμένω|v3saia---
ὁμαιχμία|ὁμαιχμία|n-s---fn-
διενεχθέντες|διαφέρω|v-pappmn-
τινές|τις|p-p---mn-
που|πού|d--------
διασταῖεν|διίστημι|v3paoa---
τούτους|οὗτος|p-p---ma-
ἐχώρουν|χωρέω|v3piia---
τόνδε|ὅδε|a-s---ma-
σπενδόμενοι|σπένδω|v-pppemn-
ξυμμάχοις|σύμμαχος|a-p---md-
ἀφισταμένοις|ἀφεστήξω|v-pppemd-
εὖ|εὖ|d--------
παρεσκευάσαντο|παρασκευάζω|v3paim---
πολέμια|πολέμιος|a-p---na-
ἐμπειρότεροι|ἔμπειρος|a-p---mnc
κινδύνων|κίνδυνος|n-p---mg-
μελέτας|μελέτη|n-p---fa-
ὑποτελεῖς|ὑποτελής|a-p---ma-
φόρου|φόρος|n-s---mg-
ξυμμάχους|σύμμαχος|a-p---ma-
ἡγοῦντο|ἡγέομαι|v3piie---
ὀλιγαρχίαν|ὀλιγαρχία|n-s---fa-
σφίσιν|σφεῖς|p-p---md-
ἐπιτηδείως|ἐπιτήδειος|d--------
ὅπως|ὅπως|c--------
πολιτεύσουσι|πολιτεύω|v3pfia---
θεραπεύοντες|θεραπεύω|v-pppamn-
παραλαβόντες|παραλαμβάνω|v-papamn-
Χίων|Χίος|n-p---mg-
Λεσβίων|Λέσβιος|n-p---mg-
χρήματα|χρῆμα|n-p---na-
πᾶσι|πᾶς|a-p---md-
τάξαντες|τάσσω|v-papamn-
φέρειν|φέρω|v--pna---
ἰδία|ἴδιος|a-s---fn-
παρασκευὴ|παρασκευή|n-s---fn-
μείζων|μέγας|a-s---fnc
κράτιστά|κράτιστος|a-p---nn-
ἀκραιφνοῦς|ἀκραιφνής|a-s---fg-
ξυμμαχίας|συμμαχία|n-s---fg-
ἤνθησαν|ἀνθέω|v3paia---
ηὗρον|εὑρίσκω|v1saia---
χαλεπὰ|χαλεπός|a-p---na-
ἑξῆς|ἑξῆς|d--------
τεκμηρίῳ|τεκμήριον|n-s---nd-
ἀκοὰς|ἀκοή|n-p---fa-
ἢν|ἐάν|c--------
ἐπιχώρια|ἐπιχώριος|a-p---nn-
ᾖ|εἰμί|v3spsa---
ἀβασανίστως|ἀβασάνιστος|d--------
δέχονται|δέχομαι|v3ppie---
Ἵππαρχον|ἵππαρχος|n-s---ma-
οἴονται|οἴομαι|v3ppie---
ὑφ̓|ὑπό|r--------
Ἁρμοδίου|Ἁρμόδιος|n-s---mg-
Ἀριστογείτονος|Ἀριστογείτων|n-s---mg-
τύραννον|τύραννος|n-s---ma-
ἀποθανεῖν|ἀποθνήσκω|v--ana---
ἴσασιν|οἶδα|v3ppia---
Ἱππίας|Ἱππίας|n-s---mn-
πρεσβύτατος|πρέσβυς|a-s---mn-
Πεισιστράτου|Πεισίστρατος|n-s---mg-
υἱέων|υἱός|n-p---mg-
Ἵππαρχος|Ἵππαρχος|n-s---mn-
Θεσσαλὸς|Θεσσαλός|n-s---mn-
ἀδελφοὶ|ἀδελφός|n-p---mn-
ὑποτοπήσαντες|ὑποτοπέω|v-papamn-
ἐκείνῃ|ἐκεῖνος|a-s---fd-
ἡμέρᾳ|ἡμέρα|n-s---fd-
παραχρῆμα|παραχρῆμα|d--------
Ἁρμόδιος|Ἁρμόδιος|n-s---mn-
Ἀριστογείτων|Ἀριστογείτων|n-s---mn-
ξυνειδότων|σύνοιδα|v-prpamg-
Ἱππίᾳ|Ἱππίας|n-s---md-
μεμηνῦσθαι|μηνύω|v--rne---
ἀπέσχοντο|ἀπέχω|v3paim---
προειδότος|πρόοιδα|v-srpamg-
βουλόμενοι|βούλομαι|v-pppemn-
ξυλληφθῆναι|συλλαμβάνω|v--anp---
δράσαντές|δράω|v-papamn-
κινδυνεῦσαι|κινδυνεύω|v--ana---
Ἱππάρχῳ|Ἵππαρχος|n-s---md-
περιτυχόντες|περιτυγχάνω|v-papamn-
Λεωκόρειον|Λεωκόρειον|n-s---na-
καλούμενον|καλέω|v-sppena-
Παναθηναϊκὴν|Παναθηναικός|a-s---fa-
πομπὴν|πομπή|n-s---fa-
διακοσμοῦντι|διακοσμέω|v-sppamd-
ἀπέκτειναν|ἀποκτείνω|v3paia---
ἀμνηστούμενα|ἀμνηστέω|v-pppena-
ὀρθῶς|ὀρθός|d--------
τούς|ὁ|l-p---ma-
βασιλέας|βασιλεύς|n-p---ma-
μιᾷ|εἷς|a-s---fd-
ψήφῳ|ψῆφος|n-s---fd-
προστίθεσθαι|προστίθημι|v--pne---
ἑκάτερον|ἑκάτερος|a-s---ma-
δυοῖν|δύο|a-d---fd-
Πιτανάτην|Πιτανάτης|n-s---ma-
λόχον|λόχος|n-s---ma-
πώποτε|πώποτε|d--------
ἀταλαίπωρος|ἀταλαίπωρος|a-s---fn-
ζήτησις|ζήτησις|n-s---fn-
ἀληθείας|ἀλήθεια|n-s---fg-
ἑτοῖμα|ἑτοῖμος|a-p---na-
τρέπονται|τρέπω|v3ppie---
εἰρημένων|ἐρῶ|v-prpeng-
νομίζων|νομίζω|v-sppamn-
διῆλθον|διέρχομαι|v1saia---
ἁμαρτάνοι|ἁμαρτάνω|v3spoa---
ὑμνήκασι|ὑμνέω|v3pria---
κοσμοῦντες|κοσμέω|v-pppamn-
πιστεύων|πιστεύω|v-sppamn-
λογογράφοι|λογογράφος|n-p---mn-
ξυνέθεσαν|συντίθημι|v3paia---
προσαγωγότερον|προσαγωγός|a-s---nac
ἀκροάσει|ἀκρόασις|n-s---fd-
ἀληθέστερον|ἀληθής|a-s---nac
ἀνεξέλεγκτα|ἀνεξέλεγκτος|a-p---na-
ἀπίστως|ἄπιστος|d--------
μυθῶδες|μυθώδης|a-s---na-
ἐκνενικηκότα|ἐκνικάω|v-prpana-
ηὑρῆσθαι|εὑρίσκω|v--rne---
ἡγησάμενος|ἡγέομαι|v-sapmmn-
ἐπιφανεστάτων|ἐπιφανής|a-p---ngs
σημείων|σημεῖον|n-p---ng-
ἀποχρώντως|ἀποχρώντως|d--------
οὗτος|οὗτος|a-s---mn-
καίπερ|καίπερ|d--------
πολεμῶσι|πολεμέω|v3ppsa---
παρόντα|πάρειμι|v-sppama-
μέγιστον|μέγας|a-s---ma-
κρινόντων|κρίνω|v-pppamg-
παυσαμένων|παύω|v-papmmg-
ἀρχαῖα|ἀρχαῖος|a-p---na-
θαυμαζόντων|θαυμάζω|v-pppamg-
ἔργων|ἔργον|n-p---ng-
σκοποῦσι|σκοπέω|v-pppamd-
δηλώσει|δηλόω|v3sasa---
γεγενημένος|γίγνομαι|v-srpemn-
λόγῳ|λόγος|n-s---md-
εἶπον|εἶπον|v3paia---
μέλλοντες|μέλλω|v-pppamn-
πολεμήσειν|πολεμέω|v--fna---
χαλεπὸν|χαλεπός|a-s---nn-
ἀκρίβειαν|ἀκρίβεια|n-s---fa-
λεχθέντων|λέγω|v-pappmg-
διαμνημονεῦσαι|διαμνημονεύω|v--ana---
ἐμοί|ἐγώ|p1s---md-
ἤκουσα|ἀκούω|v1saia---
ἄλλοθέν|ἄλλοθεν|d--------
ποθεν|ποθεν|d--------
ἀπαγγέλλουσιν|ἀπαγγέλλω|v-pppamd-
χαλεπόν|χαλεπός|a-s---nn-
ἐδόκουν|δοκέω|v3piia---
παρόντων|πάρειμι|v-pppang-
δέοντα|δεῖ|v-pppana-
μάλιστ̓|μάλιστα|d--------
ἐχομένῳ|ἔχω|v-sppemd-
γνώμης|γνώμη|n-s---fg-
ἀληθῶς|ἀληθής|d--------
εἴρηται|ἐρῶ|v3srie---
ἔργα|ἔργον|n-p---na-
πραχθέντων|πράσσω|v-pappng-
παρατυχόντος|παρατυγχάνω|v-sapang-
πυνθανόμενος|πυνθάνομαι|v-sppemn-
ἠξίωσα|ἀξιόω|v1saia---
γράφειν|γράφω|v--pna---
ἐδόκει|δοκέω|v3siia---
ἀλλ̓|ἀλλά|c--------
παρῆν|πάρειμι|v1siia---
ἀκριβείᾳ|ἀκρίβεια|n-s---fd-
ἑκάστου|ἕκαστος|a-s---ng-
ἐπεξελθών|ἐπεξέρχομαι|v-sapamn-
ἐπιπόνως|ἐπίπονος|d--------
ηὑρίσκετο|εὑρίσκω|v3siie---
διότι|διότι|c--------
παρόντες|πάρειμι|v-pppamn-
αὐτὰ|αὐτός|p-p---na-
ἔλεγον|λέγω|v3piia---
εὐνοίας|εὔνοια|n-s---fg-
μνήμης|μνήμη|n-s---fg-
ἔχοι|ἔχω|v3spoa---
ἀκρόασιν|ἀκρόασις|n-s---fa-
ἴσως|ἴσως|d--------
ἀτερπέστερον|ἀτερπής|a-s---nnc
φανεῖται|φαίνω|v3sfim---
βουλήσονται|βούλομαι|v3pfim---
γενομένων|γίγνομαι|v-papmng-
σαφὲς|σαφής|a-s---na-
μελλόντων|μέλλω|v-pppang-
ἀνθρώπινον|ἀνθρώπινος|a-s---na-
τοιούτων|τοιοῦτος|p-p---ng-
παραπλησίων|παραπλήσιος|a-p---ng-
ὠφέλιμα|ὠφέλιμος|a-p---na-
κρίνειν|κρίνω|v--pna---
ἀρκούντως|ἀρκεόντως|d--------
ἕξει|ἔχω|v3sfia---
κτῆμά|κτῆμα|n-s---nn-
ἀγώνισμα|ἀγώνισμα|n-s---nn-
ἀκούειν|ἀκούω|v--pna---
ξύγκειται|σύγκειμαι|v3spie---
Μηδικόν|Μηδικός|a-s---nn-
ναυμαχίαιν|ναυμαχία|n-d---fd-
πεζομαχίαιν|πεζομαχία|n-d---fg-
ταχεῖαν|ταχύς|a-s---fa-
κρίσιν|κρίσις|n-s---fa-
ἔσχεν|ἔχω|v3saia---
μῆκός|μῆκος|n-s---nn-
προύβη|προβαίνω|v3saia---
παθήματά|πάθημα|n-p---na-
ξυνηνέχθη|συμφέρω|v3saip---
ἕτερα|ἕτερος|a-p---nn-
ἴσῳ|ἴσος|a-s---md-
τοσαίδε|τοσόσδε|a-p---fn-
ληφθεῖσαι|λαμβάνω|v-pappfn-
ἠρημώθησαν|ἐρημόω|v3paip---
σφῶν|σφεῖς|p-p---mg-
ἀντιπολεμούντων|ἀντιπολεμέω|v-pppamg-
εἰσὶ|εἰμί|v3ppia---
αἳ|ὅς|p-p---fn-
οἰκήτορας|οἰκήτωρ|n-p---ma-
μετέβαλον|μεταβάλλω|v3paia---
ἁλισκόμεναι|ἁλίσκομαι|v-pppefn-
φυγαὶ|φυγή|n-p---fn-
φόνος|φόνος|n-s---mn-
στασιάζειν|στασιάζω|v--pna---
λεγόμενα|λέγω|v-pppenn-
ἔργῳ|ἔργον|n-s---nd-
σπανιώτερον|σπάνιος|a-s---nac
βεβαιούμενα|βεβαιόω|v-pppenn-
ἄπιστα|ἄπιστος|a-p---nn-
σεισμῶν|σεισμός|n-p---mg-
οἳ|ὅς|p-p---mn-
μέρος|μέρος|n-s---na-
ἰσχυρότατοι|ἰσχυρός|a-p---mns
ἐπέσχον|ἐπέχω|v3paia---
ἡλίου|ἥλιος|n-s---mg-
ἐκλείψεις|ἔκλειψις|n-p---fn-
πυκνότεραι|πυκνος|a-p---fnc
μνημονευόμενα|μνημονεύω|v-pppena-
ξυνέβησαν|συμβαίνω|v3paia---
αὐχμοί|αὐχμός|n-p---mn-
ἔστι|εἰμί|v3spia---
μεγάλοι|μέγας|a-p---mn-
λιμοὶ|λιμός|n-p---mn-
βλάψασα|βλάπτω|v-sapafn-
φθείρασα|φθείρω|v-sapafn-
λοιμώδης|λοιμώδης|a-p---fn-
νόσος|νόσος|n-s---fn-
ξυνεπέθετο|συνεπιτίθημι|v3saim---
λύσαντες|λύω|v-papamn-
τριακοντούτεις|τριακονταετής|a-p---fa-
σπονδὰς|σπονδή|n-p---fa-
Εὐβοίας|Εὔβοια|n-s---fg-
ἔλυσαν|λύω|v3paia---
αἰτίας|αἰτία|n-p---fa-
προύγραψα|προγράφω|v1saia---
διαφοράς|διαφορά|n-p---fa-
ζητῆσαί|ζητέω|v--ana---
ὅτου|ὅστις|p-s---ng-
τοσοῦτος|τοσοῦτος|a-s---mn-
Ἕλλησι|Ἕλλην|n-p---md-
ἀληθεστάτην|ἀληθής|a-s---fas
πρόφασιν|πρόφασις|n-s---fa-
ἀφανεστάτην|ἀφανής|a-s---fas
ἡγοῦμαι|ἡγέομαι|v1spie---
μεγάλους|μέγας|a-p---ma-
γιγνομένους|γίγνομαι|v-pppema-
φόβον|φόβος|n-s---ma-
παρέχοντας|παρέχω|v-pppama-
Λακεδαιμονίοις|Λακεδαιμόνιος|n-p---md-
ἀναγκάσαι|ἀναγκάζω|v--ana---
πολεμεῖν|πολεμέω|v--pna---
λεγόμεναι|λέγω|v-pppefn-
αἰτίαι|αἰτία|n-p---fn-
αἵδ̓|ὅδε|p-p---fn-
Ἐπίδαμνός|Ἐπίδαμνος|n-s---mn-
δεξιᾷ|δεξιά|n-s---fd-
ἐσπλέοντι|εἰσπλέω|v-sppamd-
Ἰόνιον|Ἰόνιος|a-s---ma-
κόλπον|κόλπος|n-s---ma-
προσοικοῦσι|προσοικέω|v3ppia---
Ταυλάντιοι|Ταυλάντιος|n-p---mn-
Ἰλλυρικὸν|Ἰλλυρικός|a-s---nn-
ἔθνος|ἔθνος|n-s---nn-
ἀπῴκισαν|ἀποικίζω|v3paia---
Κερκυραῖοι|Κερυκυραῖος|n-p---mn-
Φαλίος|Φαλίος|n-s---mn-
Ἐρατοκλείδου|Ἐρατοκλείδης|n-s---mg-
γένος|γένος|n-s---na-
Ἡρακλέους|Ἡρακλῆς|n-s---mg-
νόμον|νόμος|n-s---ma-
μητροπόλεως|μητρόπολις|n-s---fg-
κατακληθείς|κατακαλέω|v-sappmn-
ξυνῴκισαν|συνοικίζω|v3paia---
ἄλλου|ἄλλος|a-s---ng-
Δωρικοῦ|Δωρικός|a-s---ng-
γένους|γένος|n-s---ng-
Ἐπιδαμνίων|Ἐπιδάμνιος|n-p---mg-
μεγάλη|μέγας|a-s---fn-
πολυάνθρωπος|πολυάνθρωπος|a-s---fn-
στασιάσαντες|στασιάζω|v-papamn-
πολλά|πολύς|a-p---na-
λέγεται|λέγω|v3spie---
τινὸς|τις|a-s---mg-
προσοίκων|πρόσοικος|a-p---mg-
ἐφθάρησαν|φθείρω|v3paip---
πολλῆς|πολύς|a-s---fg-
ἐστερήθησαν|στερέω|v3paip---
δῆμος|δῆμος|n-s---mn-
ἐξεδίωξε|ἐκδιώκω|v3saia---
δυνατούς|δυνατός|a-p---ma-
ἐπελθόντες|ἐπέρχομαι|v-papamn-
πόλει|πόλις|n-s---fd-
κατά|κατά|r--------
Ἐπιδάμνιοι|Ἐπιδάμνιος|n-p---mn-
ἐπιέζοντο|πιέζω|v3piie---
πέμπουσιν|πέμπω|v3ppia---
Κέρκυραν|Κέρκυρα|n-s---fa-
πρέσβεις|πρέσβις|n-p---fa-
μητρόπολιν|μητρόπολις|n-s---fa-
δεόμενοι|δέω|v-pppemn-
σφᾶς|σφεῖς|p-p---ma-
περιορᾶν|περιοράω|v--pna---
φθειρομένους|φθείρω|v-pppema-
φεύγοντας|φεύγω|v-pppama-
ξυναλλάξαι|συναλλάσσω|v--ana---
σφίσι|σφεῖς|p-p---md-
καταλῦσαι|καταλύω|v--ana---
ἱκέται|ἱκέτης|n-p---mn-
καθεζόμενοι|κατά-καθέζομαι|v-pppemn-
Ἥραιον|Ἥραιον|n-s---na-
ἐδέοντο|δέομαι|v3piie---
ἱκετείαν|ἱκετεία|n-s---fa-
ἐδέξαντο|δέχομαι|v3paim---
ἀπράκτους|ἄπρακτος|a-p---ma-
ἀπέπεμψαν|ἀποπέμπω|v3paia---
γνόντες|γιγνώσκω|v-papamn-
οὐδεμίαν|οὐδείς|a-s---fa-
Κερκύρας|Κέρκυρα|n-s---fg-
τιμωρίαν|τιμωρία|n-s---fa-
ἀπόρῳ|ἄπορος|a-s---nd-
εἴχοντο|ἔχω|v3piie---
θέσθαι|τίθημι|v--ane---
παρόν|πάρειμι|v-sppana-
πέμψαντες|πέμπω|v-papamn-
Δελφοὺς|Δελφοί|n-p---ma-
θεὸν|θεός|n-s---ma-
ἐπήροντο|ἐπέρομαι|v3paim---
παραδοῖεν|παραδίδωμι|v3paoa---
Κορινθίοις|Κορίνθιος|n-p---md-
οἰκισταῖς|οἰκιστής|n-p---md-
τινὰ|τις|a-s---fa-
πειρῷντ̓|πειράω|v3ppoe---
ποιεῖσθαι|ποιέω|v--pne---
ἀνεῖλε|ἀναιρέω|v3saia---
παραδοῦναι|παραδίδωμι|v--ana---
Κόρινθον|Κόρινθος|n-s---fa-
μαντεῖον|μαντεῖον|n-s---na-
παρέδοσαν|παραδίδωμι|v3paia---
ἀποικίαν|ἀποικία|n-s---fa-
οἰκιστὴν|οἰκιστής|n-s---ma-
ἀποδεικνύντες|ἀποδείκνυμι|v-pppamn-
Κορίνθου|Κόρινθος|n-s---fg-
χρηστήριον|χρηστήριον|n-s---na-
δηλοῦντες|δηλόω|v-pppamn-
ἐδέοντό|δέω|v3piie---
ἐπαμῦναι|ἐπαμύνω|v--ana---
δίκαιον|δίκαιος|a-s---na-
ὑπεδέξαντο|ὑποδέχομαι|v3paim---
νομίζοντες|νομίζω|v-pppamn-
Κερκυραίων|Κερυκυραῖος|n-p---mg-
μίσει|μῖσος|n-s---nd-
παρημέλουν|παραμελέω|v3piia---
ἄποικοι|ἄποικος|a-p---mn-
πανηγύρεσι|πανήγυρις|n-p---fd-
κοιναῖς|κοινός|a-p---fd-
διδόντες|δίδωμι|v-pppamn-
γέρα|γέρας|n-p---na-
νομιζόμενα|νομίζω|v-pppena-
Κορινθίῳ|Κορίνθιος|a-s---md-
ἀνδρὶ|ἀνήρ|n-s---md-
προκαταρχόμενοι|προκατάρχομαι|v-pppemn-
ἱερῶν|ἱερόν|n-p---ng-
ἄλλαι|ἄλλος|a-p---fn-
ἀποικίαι|ἀποικία|n-p---fn-
περιφρονοῦντες|περιφρονέω|v-pppamn-
ἐκεῖνον|ἐκεῖνος|a-s---ma-
ὁμοῖα|ὅμοιος|a-p---na-
πλουσιωτάτοις|πλούσιος|a-p---mds
προύχειν|προέχω|v--pna---
ἐπαιρόμενοι|ἐπαίρω|v-pppemn-
Φαιάκων|Φαίαξ|n-p---mg-
προενοίκησιν|προενοίκησις|n-s---fa-
ἐχόντων|ἔχω|v-pppamg-
ἐξηρτύοντο|ἐξαρτύω|v3piie---
ἀδύνατοι|ἀδύνατος|a-p---mn-
ὑπῆρχον|ὑπάρχω|v3piia---
ἤρχοντο|ἄρχω|v3piie---
πάντων|πᾶς|a-p---ng-
ἐγκλήματα|ἔγκλημα|n-p---na-
ἔπεμπον|πέμπω|v3piia---
Ἐπίδαμνον|Ἐπίδαμνος|n-s---fa-
ἄσμενοι|ἄσμενος|a-p---mn-
ὠφελίαν|ὠφέλεια|n-s---fa-
οἰκήτορά|οἰκήτωρ|n-s---ma-
βουλόμενον|βούλομαι|v-sppema-
κελεύοντες|κελεύω|v-pppamn-
Ἀμπρακιωτῶν|Ἀμπρακιώτης|n-p---mg-
Λευκαδίων|Λευκάδιος|n-p---mg-
φρουρούς|φρουρός|n-p---ma-
ἐπορεύθησαν|πορεύω|v3paip---
πεζῇ|πεζός|a-s---fd-
Ἀπολλωνίαν|Ἀπολλώνια|n-s---fa-
δέει|δέος|n-s---nd-
κωλύωνται|κωλύω|v3ppse---
περαιούμενοι|περαιόω|v-pppemn-
ᾔσθοντο|αἰσθάνομαι|v3paim---
φρουροὺς|φρουρός|n-p---ma-
ἥκοντας|ἥκω|v-pppama-
τήν|ὁ|l-s---fa-
δεδομένην|δίδωμι|v-srpefa-
ἐχαλέπαινον|χαλεπαίνω|v3piia---
πλεύσαντες|πλέω|v-papamn-
ἑτέρῳ|ἕτερος|a-s---md-
ἐκέλευον|κελεύω|v3piia---
ἐπήρειαν|ἐπήρεια|n-s---fa-
δέχεσθαι|δέχομαι|v--pne---
αὐτούς|αὐτός|p-p---ma-
φυγάδες|φυγάς|n-p---mn-
τάφους|τάφος|n-p---ma-
ξυγγένειαν|συγγένεια|n-s---fa-
προϊσχόμενοι|προίσχω|v-pppemn-
κατάγειν|κατάγω|v--pna---
οὓς|ὅς|p-p---ma-
ἔπεμψαν|πέμπω|v3paia---
ἀποπέμπειν|ἀποπέμπω|v--pna---
ὑπήκουσαν|ὑπακούω|v3paia---
στρατεύουσιν|στρατεύω|v3ppia---
τεσσαράκοντα|τεσσαράκοντα|a--------
φυγάδων|φυγάς|n-p---mg-
κατάξοντες|κατάγνυμι|v-pfpamn-
Ἰλλυριοὺς|Ἰλλυριοί|n-p---ma-
προσλαβόντες|προσλαμβάνω|v-papamn-
προεῖπον|προεῖπον|v3paia---
ξένους|ξένος|n-p---ma-
ἀπαθεῖς|ἀπαθής|a-p---ma-
ἀπιέναι|ἄπειμι|v--pna---
πολεμίοις|πολέμιος|a-p---md-
χρήσεσθαι|χράω|v--fnm---
ἐπείθοντο|πείθω|v3piie---
ἰσθμὸς|ἰσθμός|n-s---mn-
ἐπολιόρκουν|πολιορκέω|v3piia---
Ἐπιδάμνου|Ἐπίδαμνος|n-s---mg-
ἄγγελοι|ἄγγελος|n-p---mn-
πολιορκοῦνται|πολιορκέω|v3ppie---
παρεσκευάζοντο|παρασκευάζω|v3piie---
ἐκήρυσσον|κηρύσσω|v3piia---
ἴσῃ|ἴσος|a-s---fd-
ὁμοίᾳ|ὅμοιος|a-s---fd-
παραυτίκα|παραυτίκα|d--------
ἐθέλει|ἐθέλω|v3spia---
μετέχειν|μετέχω|v--pna---
βούλεται|βούλομαι|v3spie---
δραχμὰς|δραχμή|n-p---fa-
καταθέντα|κατατίθημι|v-sapama-
Κορινθίας|Κορίνθιος|a-p---fa-
μένειν|μένω|v--pna---
πλέοντες|πλέω|v-pppamn-
ἀργύριον|ἀργύριον|n-s---na-
καταβάλλοντες|καταβάλλω|v-pppamn-
ἐδεήθησαν|δέω|v3paip---
Μεγαρέων|Μεγαρεύς|n-p---mg-
ξυμπροπέμψαι|συμπροπέμπω|v--ana---
ἄρα|ἄρα|d--------
κωλύοιντο|κωλύω|v3ppoe---
πλεῖν|πλέω|v--pna---
ὀκτὼ|ὀκτώ|a--------
Παλῆς|Παλή|n-s---fg-
Κεφαλλήνων|Κεφαλλήν|n-p---mg-
τέσσαρσιν|τέσσαρες|n-p---fd-
Ἐπιδαυρίων|Ἐπιδαύριος|n-p---mg-
παρέσχον|παρέχω|v3paia---
Ἑρμιονῆς|Ἑρμιονή|n-s---fg-
μίαν|εἷς|a-s---fa-
Τροιζήνιοι|Τροιζήνιος|n-p---mn-
Λευκάδιοι|Λευκάδιος|n-p---mn-
Ἀμπρακιῶται|Ἀμπρακιώτης|n-p---mn-
ὀκτώ|ὀκτώ|a--------
παρέσχε|παρέχω|v3saia---
Θηβαίους|Θηβαῖος|n-p---ma-
ᾔτησαν|αἰτέω|v3paia---
Φλειασίους|Φλιάσιος|n-p---ma-
Ἠλείους|Ἠλεῖος|n-p---ma-
κενὰς|κενός|a-p---fa-
νῆες|ναῦς|n-p---fn-
τριάκοντα|τριάκοντα|a--------
τρισχίλιοι|τρισχίλιοι|a-p---mn-
ὁπλῖται|ὁπλίτης|n-p---mn-
ἐπύθοντο|πυνθάνομαι|v3paim---
παρασκευήν|παρασκευή|n-s---fa-
Σικυωνίων|Σικυών|a-p---mg-
πρέσβεων|πρέσβυς|n-p---mg-
παρέλαβον|παραλαμβάνω|v3paia---
Κορινθίους|Κορίνθιος|n-p---ma-
Ἐπιδάμνῳ|Ἐπίδαμνος|n-s---fd-
ἀπάγειν|ἀπάγω|v--pna---
μετὸν|μέτειμι|v-sppann-
ἀντιποιοῦνται|ἀντιποιέω|v3ppie---
δίκας|δίκη|n-p---fa-
ἤθελον|ἐθέλω|v3piia---
δοῦναι|δίδωμι|v--ana---
Πελοποννήσῳ|Πελοπόννησος|n-s---fd-
αἷς|ὅς|p-p---fd-
ξυμβῶσιν|συμβαίνω|v3pasa---
ὁποτέρων|ὁπότερος|a-p---mg-
δικασθῇ|δικάζω|v3sasp---
κρατεῖν|κρατέω|v--pna---
Δελφοῖς|Δελφοί|n-p---md-
μαντείῳ|μαντεῖον|n-s---nd-
ἐπιτρέψαι|ἐπιτρέπω|v--ana---
εἴων|ἐάω|v3piia---
ποιεῖν|ποιέω|v--pna---
ἀναγκασθήσεσθαι|ἀναγκάζω|v--fnp---
ἔφασαν|φημί|v3paia---
βιαζομένων|βιάζω|v-pppemg-
φίλους|φίλος|n-p---ma-
βούλονται|βούλομαι|v3ppie---
ἑτέρους|ἕτερος|a-p---ma-
ὠφελίας|ὠφέλεια|n-s---fg-
ἀπεκρίναντο|ἀποκρίνω|v3paim---
τάς|ὁ|l-p---fa-
ἀπαγάγωσι|ἀπάγω|v3pasa---
βουλεύσεσθαι|βουλεύω|v--fnm---
ἔχειν|ἔχω|v--pna---
πολιορκεῖσθαι|πολιορκέω|v--pne---
δικάζεσθαι|δικάζω|v--pne---
ἀντέλεγον|ἀντιλέγω|v3piia---
ἐκεῖνοι|ἐκεῖνος|p-p---mn-
ποιήσειν|ποιέω|v--fna---
ἑτοῖμοι|ἑτοῖμος|a-p---mn-
ἀμφοτέρους|ἀμφότερος|a-p---ma-
ἕως|ἕως|c--------
δίκη|δίκη|n-s---fn-
γένηται|γίγνομαι|v3sasm---
ὑπήκουον|ὑπακούω|v3piia---
πλήρεις|πλήρης|a-p---fa-
ξύμμαχοι|σύμμαχος|a-p---mn-
παρῆσαν|πάρειμι|v3piia---
προπέμψαντες|προπέμπω|v-papamn-
κήρυκα|κῆρυξ|n-s---ma-
προεροῦντα|προερέω|v-sppama-
ἄραντες|αἴρω|v-papamn-
ἑβδομήκοντα|ἑβδομήκοντα|a--------
δισχιλίοις|δισχίλιοι|a-p---md-
ὁπλίταις|ὁπλίτης|n-p---md-
ἔπλεον|πλέω|v3piia---
ἐναντία|ἐναντίος|a-p---na-
πολεμήσοντες|πολεμέω|v-pfpamn-
ἐστρατήγει|στρατηγέω|v3siia---
Ἀριστεὺς|Ἀριστεύς|n-s---mn-
Πελλίχου|Πελλίχης|n-s---mg-
Καλλικράτης|Καλλικράτης|n-s---mn-
Καλλίου|Καλλίας|n-s---mg-
Τιμάνωρ|Τιμάνωρ|n-s---mn-
Τιμάνθους|Τιμάνθης|n-s---mg-
πεζοῦ|πεζός|a-s---mg-
Ἀρχέτιμός|Ἀρχέτιμος|n-s---mn-
Εὐρυτίμου|Εὐρύτιμος|n-s---mg-
Ἰσαρχίδας|Ἰσαρχίδης|n-s---mn-
Ἰσάρχου|Ἴσαρχος|n-s---mg-
Ἀκτίῳ|Ἄκτιον|n-s---nd-
Ἀνακτορίας|ἀνακτόριος|a-s---fg-
ἱερὸν|ἱερόν|n-s---nn-
Ἀπόλλωνός|Ἀπόλλων|n-s---mg-
στόματι|στόμα|n-s---nd-
Ἀμπρακικοῦ|Ἀμπρακικός|a-s---mg-
κόλπου|κόλπος|n-s---mg-
κήρυκά|κῆρυξ|n-s---ma-
προύπεμψαν|προπέμπω|v3paia---
ἀκατίῳ|ἀκάτιον|n-s---nd-
ἀπεροῦντα|ἀπεράω|v-sppama-
ἐπλήρουν|πληρόω|v3piia---
ζεύξαντές|ζεύγνυμι|v-papamn-
παλαιὰς|παλαιός|a-p---fa-
πλωίμους|πλώιμος|a-p---fa-
ἐπισκευάσαντες|ἐπισκευάζω|v-papamn-
κῆρύξ|κῆρυξ|n-s---mn-
ἀπήγγειλεν|ἀπαγγέλλω|v3saia---
εἰρηναῖον|εἰρηναῖος|a-s---na-
ἐπεπλήρωντο|ἐπιπληρόω|v3plie---
ὀγδοήκοντα|ὀγδοήκοντα|a--------
ἀνταναγαγόμενοι|ἀντανάγω|v-papmmn-
παραταξάμενοι|παρατάσσω|v-papmmn-
ἐνίκησαν|νικάω|v3paia---
διέφθειραν|διαφθείρω|v3paia---
ξυνέβη|συμβαίνω|v3saia---
πολιορκοῦντας|πολιορκέω|v-pppama-
παραστήσασθαι|παρίστημι|v--anm---
ὁμολογίᾳ|ὁμολογία|n-s---fd-
ἐπήλυδας|ἔπηλυς|n-p---ma-
ἀποδόσθαι|ἀποδίδωμι|v--anm---
δήσαντας|δέω|v-papama-
δόξῃ|δοκέω|v3sasa---
ναυμαχίαν|ναυμαχία|n-s---fa-
τροπαῖον|τροπαῖος|a-s---na-
στήσαντες|ἵστημι|v-papamn-
Λευκίμμῃ|Λευκίμμη|n-s---fd-
Κερκυραίας|Κερυκυραία|n-s---fg-
ἀκρωτηρίῳ|ἀκρωτήριον|n-s---nd-
ἔλαβον|λαμβάνω|v3paia---
αἰχμαλώτους|αἰχμάλωτος|a-p---ma-
δήσαντες|δέω|v-papamn-
ἡσσημένοι|ἡσσάομαι|v-prpemn-
ἀνεχώρησαν|ἀναχωρέω|v3paia---
οἴκου|οἶκος|n-s---mg-
ἁπάσης|ἅπας|a-s---fg-
ἐκράτουν|κρατέω|v3piia---
Λευκάδα|Λευκάς|n-s---fa-
ἔτεμον|τέμνω|v3paia---
Κυλλήνην|Κυλλήνη|n-s---fa-
Ἠλείων|Ἠλεῖος|n-p---mg-
ἐπίνειον|ἐπίνειον|n-s---na-
ἐνέπρησαν|ἐμπίμπρημι|v3paia---
ἐπεκράτουν|ἐπικρατέω|v3piia---
ἔφθειρον|φθείρω|v3piia---
περιιόντι|περίειμι|v-sppand-
θέρει|θέρος|n-s---nd-
στρατιάν|στρατιά|n-s---fa-
ἐπόνουν|πονέω|v3piia---
ἐστρατοπεδεύοντο|στρατοπεδεύω|v3piie---
Χειμέριον|Χειμέριον|n-s---na-
Θεσπρωτίδος|Θεσπρωτίς|n-s---fg-
φυλακῆς|φυλακή|n-s---fg-
Λευκάδος|Λευκάς|n-s---fg-
φίλιαι|φίλιος|a-p---fn-
ἀντεστρατοπεδεύοντο|ἀντιστρατοπεδεύω|v3piie---
πεζῷ|πεζός|a-s---md-
ἐπέπλεον|ἐπιπλέω|v3piia---
οὐδέτεροι|οὐδέτερος|a-p---mn-
θέρος|θέρος|n-s---na-
ἀντικαθεζόμενοι|ἀντί,κατά-ἕζομαι|v-pppemn-
χειμῶνος|χειμών|n-s---mg-
ἑκάτεροι|ἑκάτερος|a-p---mn-
ἐνιαυτὸν|ἐνιαυτός|n-s---ma-
ὀργῇ|ὀργή|n-s---fd-
φέροντες|φέρω|v-pppamn-
ἐναυπηγοῦντο|ναυπηγέω|v3piie---
ἔκ|ἐκ|r--------
ἀγείροντες|ἀγείρω|v-pppamn-
ἐρέτας|ἐρέτης|n-p---ma-
μισθῷ|μισθός|n-s---md-
πείθοντες|πείθω|v-pppamn-
πυνθανόμενοι|πυνθάνομαι|v-pppemn-
παρασκευὴν|παρασκευή|n-s---fa-
ἐφοβοῦντο|φοβέω|v3piie---
οὐδενὸς|οὐδείς|p-s---mg-
ἔνσπονδοι|ἔνσπονδος|a-p---mn-
ἐσεγράψαντο|εἰσγράφω|v3paim---
ἔδοξεν|δοκέω|v3saia---
ἐλθοῦσιν|ἔρχομαι|v-papamd-
πειρᾶσθαι|πειράζω|v--fnm---
εὑρίσκεσθαι|εὑρίσκω|v--pne---
πυθόμενοι|πυνθάνομαι|v-papmmn-
Ἀθήνας|Ἀθῆναι|n-p---fa-
πρεσβευσόμενοι|πρεσβεύω|v-pfpmmn-
προσγενόμενον|προσγίγνομαι|v-sapmnn-
ἐμπόδιον|ἐμπόδιος|a-s---nn-
καταστάσης|καθίστημι|v-sapafg-
ἐκκλησίας|ἐκκλησία|n-s---fg-
ἀντιλογίαν|ἀντιλογία|n-s---fa-
ἔλεξαν|λέγω|v3paia---
τοιάδε|τοιόσδε|p-p---na-
Δίκαιον|δίκαιος|a-s---nn-
ὦ|ὦ|i--------
εὐεργεσίας|εὐεργεσία|n-s---fg-
μεγάλης|μέγας|a-s---fg-
προυφειλομένης|προοφείλω|v-sppefg-
πέλας|πέλας|d--------
ἐπικουρίας|ἐπικουρία|n-s---fg-
ἡμεῖς|ἐγώ|p1p---mn-
δεησομένους|δέω|v-pfpmma-
ἀναδιδάξαι|ἀναδιδάσκω|v--ana---
ξύμφορα|σύμφορος|a-p---na-
δέονται|δέω|v3ppie---
ἐπιζήμια|ἐπιζήμιος|a-p---nn-
χάριν|χάρις|n-s---fa-
ἕξουσιν|ἔχω|v3pfia---
καταστήσουσι|καθίστημι|v3pfia---
ὀργίζεσθαι|ὀργίζω|v--pne---
ἀτυχῶσιν|ἀτυχέω|v3ppsa---
αἰτήσεως|αἴτησις|n-s---fg-
πιστεύοντες|πιστεύω|v-pppamn-
ἐχυρὰ|ἐχυρός|a-p---na-
ὑμῖν|σύ|p2p---md-
παρέξεσθαι|παρέχω|v--fnm---
ἀπέστειλαν|ἀποστέλλω|v3paia---
ἡμᾶς|ἐγώ|p1p---ma-
τετύχηκε|τυγχάνω|v3sria---
ἐπιτήδευμα|ἐπιτήδευμα|n-s---nn-
ὑμᾶς|σύ|p2p---ma-
χρείαν|χρεία|n-s---fa-
ἡμῖν|ἐγώ|p1p---md-
ἄλογον|ἄλογος|a-s---nn-
ἡμέτερα|ἡμέτερος|a-p---na-
ἀξύμφορον|ἀσύμφορος|a-s---nn-
ξύμμαχοί|σύμμαχος|a-p---mn-
οὐδενός|οὐδείς|p-s---ng-
ἑκούσιοι|ἑκούσιος|a-p---mn-
γενόμενοι|γίγνομαι|v-papmmn-
δεησόμενοι|δέω|v-pfpmmn-
ἥκομεν|ἥκω|v1ppia---
ἐρῆμοι|ἐρῆμος|a-p---mn-
καθέσταμεν|καθίστημι|v1pria---
περιέστηκεν|περιίστημι|v3sria---
δοκοῦσα|δοκέω|v-sppafn-
ἡμῶν|ἐγώ|p1p---mg-
σωφροσύνη|σωφροσύνη|n-s---fn-
ἀλλοτρίᾳ|ἀλλότριος|a-s---fd-
ξυμμαχίᾳ|συμμαχία|n-s---fd-
γνώμῃ|γνώμη|n-s---fd-
ξυγκινδυνεύειν|συγκινδυνεύω|v--pna---
ἀβουλία|ἀβουλία|n-s---fn-
ἀσθένεια|ἀσθένεια|n-s---fn-
φαινομένη|φαίνω|v-sppefn-
γενομένην|γίγνομαι|v-sapmfa-
μόνας|μόνος|a-p---fa-
ἀπεωσάμεθα|ἀπωθέω|v1paim---
μείζονι|μέγας|a-s---fdc
ὥρμηνται|ὁρμάω|v3prie---
ὁρῶμεν|ὁράω|v1ppia---
οἰκείᾳ|οἰκεῖος|a-s---fd-
περιγενέσθαι|περιγίγνομαι|v--anm---
μέγας|μέγας|a-s---mn-
κίνδυνος|κίνδυνος|n-s---mn-
ἐσόμεθα|εἰμί|v1pfim---
ἀνάγκη|ἀνάγκη|n-s---fn-
ὑμῶν|σύ|p2p---mg-
παντὸς|πᾶς|a-s---mg-
δεῖσθαι|δέω|v--pne---
ξυγγνώμη|συγγνώμη|n-s---fn-
κακίας|κακία|n-s---fg-
ἁμαρτίᾳ|ἁμαρτία|n-s---fd-
ἀπραγμοσύνῃ|ἀπραγμοσύνη|n-s---fd-
τολμῶμεν|τολμάω|v1ppia---
ἔσται|εἰμί|v3sfim---
γενήσεται|γίγνομαι|v3sfim---
πειθομένοις|πείθω|v-pppemd-
καλὴ|κάλως|a-s---fn-
ξυντυχία|συντυχία|n-s---fn-
ἡμετέρας|ἡμέτερος|a-s---fg-
χρείας|χρεία|n-s---fg-
ἀδικουμένοις|ἀδικέω|v-pppemd-
βλάπτουσι|βλάπτω|v-pppamd-
ἐπικουρίαν|ἐπικουρία|n-s---fa-
ποιήσεσθε|ποιέω|v2pfim---
μεγίστων|μέγας|a-p---ngs
κινδυνεύοντας|κινδυνεύω|v-pppama-
δεξάμενοι|δέχομαι|v-papmmn-
αἰειμνήστου|ἀείμνηστος|a-s---ng-
μαρτυρίου|μαρτύριον|n-s---ng-
καταθήσεσθε|κατατίθημι|v2pfim---
γένοιτο|γίγνομαι|v3saom---
ναυτικόν|ναυτικός|a-s---na-
κεκτήμεθα|κτάομαι|v1prie---
σκέψασθε|σκέπτομαι|v2pame---
τίς|τις|a-s---fn-
εὐπραξία|εὐπραξία|n-s---fn-
σπανιωτέρα|σπάνιος|a-s---fnc
λυπηροτέρα|λυπηρός|a-s---fnc
ὑμεῖς|σύ|p2p---mn-
χάριτος|χάρις|n-s---fg-
ἐτιμήσασθε|τιμάω|v2paim---
προσγενέσθαι|προσγίγνομαι|v--anm---
πάρεστιν|πάρειμι|v3spia---
αὐτεπάγγελτος|αὐτεπάγγελτος|a-s---fn-
δαπάνης|δαπάνη|n-s---fg-
διδοῦσα|δίδωμι|v-sppafn-
ἑαυτήν|ἑαυτοῦ|p-s---fa-
προσέτι|προσέτι|d--------
φέρουσα|φέρω|v-sppafn-
ἀρετήν|ἀρετή|n-s---fa-
ἐπαμυνεῖτε|ἐπαμύνω|v2pfia---
ἰσχύν|ἰσχύς|n-s---fa-
ὀλίγοις|ὀλίγος|a-p---md-
ὀλίγοι|ὀλίγος|a-p---mn-
ἐπικαλοῦνται|ἐπικαλέω|v3ppie---
ἀσφάλειαν|ἀσφάλεια|n-s---fa-
κόσμον|κόσμος|n-s---ma-
ληψόμενοι|λαμβάνω|v-pfpmmn-
παραγίγνονται|παραγίγνομαι|v3ppie---
ὅνπερ|ὅς|p-s---ma-
χρήσιμοι|χρήσιμος|a-p---mn-
εἶμεν|εἰμί|v1ppoa---
οἴεται|οἴομαι|v3spie---
ἁμαρτάνει|ἁμαρτάνω|v3spia---
αἰσθάνεται|αἰσθάνομαι|v3spie---
ὑμετέρῳ|ὑμέτερος|a-s---md-
πολεμησείοντας|πολεμησείω|v-pppama-
δυναμένους|δύναμαι|v-pppema-
ἐχθροὺς|ἐχθρός|a-p---ma-
ὄντας|εἰμί|v-pppama-
προκαταλαμβάνοντας|προκαταλαμβάνω|v-pppama-
ὑμετέραν|ὑμέτερος|a-s---fa-
ἐπιχείρησιν|ἐπιχείρησις|n-s---fa-
ἵνα|ἵνα|c--------
κοινῷ|κοινός|a-s---nd-
ἔχθει|ἔχθος|n-s---nd-
στῶμεν|ἵστημι|v1pasa---
φθάσαι|φθάνω|v--ana---
ἁμάρτωσιν|ἁμαρτάνω|v3pasa---
κακῶσαι|κακόω|v--ana---
βεβαιώσασθαι|βεβαιόω|v--anm---
ἡμέτερον|ἡμέτερος|a-s---nn-
γ̓|γε|d--------
προτερῆσαι|προτερέω|v--ana---
διδόντων|δίδωμι|v-pppamg-
δεξαμένων|δέχομαι|v-papmmg-
προεπιβουλεύειν|προεπιβουλεύω|v--pna---
ἀντεπιβουλεύειν|ἀντεπιβουλεύω|v--pna---
λέγωσιν|λέγω|v3ppsa---
ἀποίκους|ἄποικος|a-p---ma-
μαθόντων|μανθάνω|v3pama---
ἀποικία|ἀποικία|n-s---fn-
πάσχουσα|πάσχω|v-sppafn-
τιμᾷ|τιμάω|v3spia---
ἀδικουμένη|ἀδικέω|v-sppefn-
ἀλλοτριοῦται|ἀλλοτριόω|v3spie---
δοῦλοι|δοῦλος|a-p---mn-
ὁμοῖοι|ὅμοιος|a-p---mn-
λειπομένοις|λείπω|v-pppemd-
ἐκπέμπονται|ἐκπέμπω|v3ppie---
ἠδίκουν|ἀδικέω|v3piia---
σαφές|σαφής|a-s---nn-
προκληθέντες|προκαλέω|v-pappmn-
ἐβουλήθησαν|βούλομαι|v3paip---
μετελθεῖν|μετέρχομαι|v--ana---
ἔστω|εἰμί|v3spma---
τεκμήριον|τεκμήριον|n-s---nn-
ξυγγενεῖς|συγγενεύς|n-p---ma-
ἀπάτῃ|ἀπάτη|n-s---fd-
παράγεσθαι|παράγω|v--pne---
δεομένοις|δέω|v-pppemd-
εὐθέος|εὐθής|a-s---ng-
ὑπουργεῖν|ὑπουργέω|v--pna---
μεταμελείας|μεταμέλεια|n-p---fa-
χαρίζεσθαι|χαρίζομαι|v--pne---
ἐναντίοις|ἐναντίος|a-p---md-
λαμβάνων|λαμβάνω|v-sppamn-
ἀσφαλέστατος|ἀσφαλής|a-s---mns
διατελοίη|διατελέω|v3spoa---
λύσετε|λύω|v2pfia---
δεχόμενοι|δέχομαι|v-pppemn-
μηδετέρων|μηδέτερος|a-p---mg-
αὐταῖς|αὐτός|p-p---fd-
Ἑλληνίδων|Ἑλληνίς|n-p---fg-
ἥτις|ὅστις|p-s---fn-
μηδαμοῦ|μηδαμός|a-s---mg-
ξυμμαχεῖ|συμμαχέω|v3spia---
ἐξεῖναι|ἔξεστι|v--pna---
ὁποτέρους|ὁπότερος|a-p---ma-
ἀρέσκηται|ἀρέσκω|v3spse---
ἐλθεῖν|ἔρχομαι|v--ana---
δεινὸν|δεινός|a-s---nn-
τοῖσδε|ὅδε|p-p---md-
ἀπό|ἀπό|r--------
ἐνσπόνδων|ἔνσπονδος|a-p---mg-
πληροῦν|πληρόω|v--pna---
ὑμετέρων|ὑμέτερος|a-p---mg-
ὑπηκόων|ὑπήκους|a-p---mg-
προκειμένης|πρόκειμαι|v-sppefg-
εἴρξουσι|ἔργω|v3pfia---
εἶτα|εἶτα|c--------
ἀδικήματι|ἀδίκημα|n-s---nd-
θήσονται|τίθημι|v3pfim---
πεισθέντων|πείθω|v-pappmg-
δεόμεθα|δέομαι|v1ppie---
πλέονι|πλείων|a-s---fdc
αἰτίᾳ|αἰτία|n-s---fd-
πείσαντες|πείθω|v-papamn-
ἕξομεν|ἔχω|v1pfia---
ἀπώσεσθε|ἀπωθέω|v2pfim---
τῶνδε|ὅδε|p-p---mg-
κωλυταὶ|κωλυτής|n-p---mn-
ἐχθρῶν|ἐχθρός|a-p---mg-
γενήσεσθε|γίγνομαι|v2pfim---
ὑμετέρας|ὑμέτερος|a-s---fg-
ἀρχῆς|ἀρχή|n-s---fg-
προσλαβεῖν|προσλαμβάνω|v--ana---
περιόψεσθε|περιοράω|v2pfim---
ἀκείνων|ἐκεῖνος|p-p---mg-
κωλύειν|κωλύω|v--pna---
μισθοφόρους|μισθόφορος|a-p---ma-
πέμπειν|πέμπω|v--pna---
πεισθῆτε|πείθω|v2pasp---
προφανοῦς|προφανής|a-s---ng-
δεξαμένους|δείκνυμι|v-papmma-
βοηθεῖν|βοηθέω|v--pna---
ὑπείπομεν|ὑπεῖπον|v1paia---
ξυμφέροντα|συμφέρω|v-pppana-
ἀποδείκνυμεν|ἀποδείκνυμι|v1ppia---
πολέμιοι|πολέμιος|a-p---mn-
ὅπερ|ὅσπερ|p-s---nn-
σαφεστάτη|σαφής|a-s---fns
πίστις|πίστις|n-s---fn-
ἀσθενεῖς|ἀσθενής|a-p---mn-
ἱκανοὶ|ἱκανός|a-p---mn-
μεταστάντας|μεθίστημι|v-papama-
βλάψαι|βλάπτω|v--ana---
ναυτικῆς|ναυτικός|a-s---fg-
ἠπειρώτιδος|ἠπειρώτης|n-s---fg-
διδομένης|δίδωμι|v-sppefg-
ὁμοία|ὁμοῖος|a-s---fn-
ἀλλοτρίωσις|ἀλλοτρίωσις|n-s---fn-
μέν|μέν|d--------
δύνασθε|δύναμαι|v2ppie---
μηδένα|μηδείς|p-s---ma-
ἄλλον|ἄλλος|a-s---ma-
ἐᾶν|ἐάω|v--pna---
κεκτῆσθαι|κτάομαι|v--rne---
ὅστις|ὅστις|p-s---mn-
ἐχυρώτατος|ἐχυρός|a-s---mns
τοῦτον|οὗτος|p-s---ma-
φίλον|φίλος|a-s---ma-
ὅτῳ|ὅστις|p-s---md-
τάδε|ὅδε|p-p---na-
λέγεσθαι|λέγω|v--pne---
φοβεῖται|φοβέω|v3spie---
πειθόμενος|πείθω|v-sppemn-
λύσῃ|λύω|v3sasa---
γνώτω|γιγνώσκω|v3sama---
δεδιὸς|δείδω|v-srpann-
ἔχον|ἔχω|v-sppann-
ἐναντίους|ἐναντίος|a-p---ma-
φοβῆσον|φοβέω|v-sfpann-
θαρσοῦν|θαρσέω|v-sppann-
δεξαμένου|δέχομαι|v-sapmmg-
ἀσθενὲς|ἀσθενής|a-s---nn-
ἰσχύοντας|ἰσχύω|v-pppama-
ἀδεέστερον|ἀδεής|a-s---nnc
ἐσόμενον|εἰμί|v-sfpmnn-
Ἀθηνῶν|Ἀθῆναι|n-p---fg-
βουλευόμενος|βουλεύω|v-sppemn-
προνοῶν|προνοέω|v-sppamn-
ὅταν|ὅταν|c--------
μέλλοντα|μέλλω|v-sppama-
αὐτίκα|αὐτίκα|d--------
περισκοπῶν|περισκοπέω|v-sppamn-
ἐνδοιάζῃ|ἐνδοιάζω|v3spsa---
ὃ|ὅς|p-s---nn-
καιρῶν|καιρός|n-p---mg-
οἰκειοῦταί|οἰκειόω|v3spie---
πολεμοῦται|πολεμόω|v3spie---
παράπλου|παράπλοος|n-s---mg-
κεῖται|κεῖμαι|v3spie---
ἐκεῖθεν|ἐκεῖθεν|d--------
ἐᾶσαι|ἐάω|v2spie---
Πελοποννησίοις|Πελοποννήσιοι|n-p---md-
ἐπελθεῖν|ἐπέρχομαι|v--ana---
ἐνθένδε|ἐνθένδε|d--------
ἀκεῖ|ἐκεῖ|d--------
παραπέμψαι|παραπέμπω|v--ana---
ἆλλα|ἄλλος|p-p---na-
ξυμφορώτατόν|σύμφορος|a-s---nns
βραχυτάτῳ|βραχύς|a-s---nds
κεφαλαίῳ|κεφάλαιος|a-s---nd-
ξύμπασι|σύμπας|a-p---nd-
ἕκαστον|ἕκαστος|a-s---na-
τῷδ̓|ὅδε|p-s---nd-
προέσθαι|προίημι|v--anm---
μάθοιτε|μανθάνω|v2paoa---
τρία|τρία|n-p---nn-
ἄξια|ἄξιος|a-p---nn-
ταὐτὸν|ταὐτός|a-s---na-
προκαταλήψονται|προκαταλαμβάνω|v3pfim---
ναυμαχήσετε|ναυμαχέω|v2pfia---
ἕξετε|ἔχω|v2pfia---
πλείοσι|πλείων|a-p---fdc
ἡμετέραις|ἡμέτερος|a-p---fd-
ἀγωνίζεσθαι|ἀγωνίζομαι|v--pne---
ἀναγκαῖον|ἀναγκαῖος|a-s---nn-
δέξασθαι|δέχομαι|v--anm---
λόγον|λόγος|n-s---ma-
ποιησαμένων|ποιέω|v-papmmg-
ἀδικοῦμεν|ἀδικέω|v1ppia---
εἰκότως|εἰκότως|d--------
πολεμοῦνται|πολεμέω|v3ppie---
μνησθέντας|μιμνήσκω|v-pappma-
ἀμφοτέρων|ἀμφότερος|a-p---ng-
ἀξίωσιν|ἀξίωσις|n-s---fa-
ἀσφαλέστερον|ἀσφαλής|a-s---nac
προειδῆτε|πρόοιδα|v2prsa---
ἀλογίστως|ἀλόγιστος|d--------
ἀπώσησθε|ἀπωθέω|v2pasm---
φασὶ|φημί|v3ppia---
σῶφρον|σώφρων|a-s---na-
κακουργίᾳ|κακουργία|n-s---fd-
ἀρετῇ|ἀρετή|n-s---fd-
ἐπετήδευσαν|ἐπιτηδεύω|v3paia---
ξύμμαχόν|σύμμαχος|a-s---ma-
οὐδένα|οὐδείς|a-s---ma-
ἀδικήματα|ἀδίκημα|n-p---na-
μάρτυρα|μάρτυς|n-s---ma-
παρακαλοῦντες|παρακαλέω|v-pfpamn-
αἰσχύνεσθαι|αἰσχύνω|v--pne---
αὐτάρκη|αὐτάρκης|a-s---fa-
θέσιν|θέσις|n-s---fa-
κειμένη|κεῖμαι|v-srpefn-
παρέχει|παραχέω|v3siia---
δικαστὰς|δικαστής|n-p---ma-
βλάπτουσί|βλάπτω|v3ppia---
ξυνθήκας|συνθήκη|n-p---fa-
γίγνεσθαι|γίγνομαι|v--pne---
ἐκπλέοντας|ἐκπλέω|v-pppama-
ἀνάγκῃ|ἀνάγκη|n-s---fd-
καταίροντας|καταίρω|v-pppama-
εὐπρεπὲς|εὐπρεπής|a-s---na-
ἄσπονδον|ἄσπονδος|a-s---na-
ξυναδικῶσιν|συναδικέω|v3ppsa---
ἑτέροις|ἕτερος|a-p---md-
προβέβληνται|προβάλλω|v3prie---
ἀδικῶσι|ἀδικέω|v3ppsa---
κρατῶσι|κρατέω|v3ppsa---
βιάζωνται|βιάζω|v3ppse---
λάθωσι|λανθάνω|v3ppsa---
ἔχωσιν|ἔχω|v3ppsa---
πού|πού|d--------
προσλάβωσιν|προσλαμβάνω|v3pasa---
ἀναισχυντῶσιν|ἀναισχυντέω|v3ppsa---
ἄνδρες|ἀνήρ|n-p---mn-
φασίν|φημί|v3ppia---
ἀγαθοί|ἀγαθός|a-p---mn-
ὅσῳ|ὅσος|a-s---nd-
ἀληπτότεροι|ἄληπτος|a-p---mnc
τόσῳ|τόσος|a-s---nd-
φανερωτέραν|φανερός|a-s---fac
ἐξῆν|ἔξεστι|v3siia---
διδοῦσι|δίδωμι|v-pppamd-
δεχομένοις|δέχομαι|v-pppemd-
δίκαια|δίκαιος|a-p---na-
δεικνύναι|δείκνυμι|v--pna---
τοιοίδε|τοιόσδε|p-p---mn-
ἀφεστᾶσί|ἀφεστήξω|v3pria---
πολεμοῦσι|πολεμέω|v3ppia---
λέγοντες|λέγω|v-pppamn-
κακῶς|κακός|d--------
πάσχειν|πάσχω|v--pna---
ἐκπεμφθεῖεν|ἐκπέμπω|v3paop---
αὐτοί|αὐτός|p-p---mn-
φαμεν|φημί|v1ppia---
ὑβρίζεσθαι|ὑβρίζω|v--pne---
κατοικίσαι|κατοικίζω|v--ana---
ἡγεμόνες|ἡγεμών|n-p---mn-
εἰκότα|ἔοικα|v-prpana-
θαυμάζεσθαι|θαυμάζω|v--pne---
τιμῶσιν|τιμάω|v3ppia---
ἀποίκων|ἄποικος|a-p---mg-
στεργόμεθα|στέργω|v1ppie---
πλέοσιν|πλείων|a-p---mdc
ἀρέσκοντές|ἀρέσκω|v-pppamn-
ἐσμεν|εἰμί|v1ppia---
τοῖσδ̓|ὅδε|p-p---md-
μόνοις|μόνος|a-p---md-
ἀπαρέσκοιμεν|ἀπαρέσκω|v1ppoa---
ἐπιστρατεύομεν|ἐπιστρατεύω|v1ppia---
ἐκπρεπῶς|ἐκπρεπής|d--------
διαφερόντως|διαφερόντως|d--------
ἀδικούμενοι|ἀδικέω|v-pppemn-
καλὸν|καλός|a-s---nn-
ἡμαρτάνομεν|ἁμαρτάνω|v1piia---
εἶξαι|εἴκω|v--ana---
ἡμετέρᾳ|ἡμέτερος|a-s---fd-
αἰσχρὸν|αἰσχρός|a-s---nn-
βιάσασθαι|βιάζω|v--anm---
μετριότητα|μετριότης|n-s---fa-
ὕβρει|ὕβρις|n-s---fd-
ἐξουσίᾳ|ἐξουσία|n-s---fd-
πλούτου|πλοῦτος|n-s---mg-
ἡμαρτήκασι|ἁμαρτάνω|v3pria---
ἡμετέραν|ἡμέτερος|a-s---fa-
κακουμένην|κακόω|v-sppefa-
ἐλθόντων|ἔρχομαι|v-papamg-
τιμωρίᾳ|τιμωρία|n-s---fd-
ἑλόντες|αἱρέω|v-papamn-
ἔχουσιν|ἔχω|v3ppia---
δίκῃ|δίκη|n-s---fd-
ἐθελῆσαι|ἐθέλω|v--ana---
κρίνεσθαι|κρίνω|v--pne---
ἥν|ὅς|p-s---fa-
προύχοντα|προέχω|v-sppama-
ἀσφαλοῦς|ἀσφαλής|a-s---ng-
προκαλούμενον|προκαλέω|v-sppema-
λέγειν|λέγω|v--pna---
δοκεῖν|δοκέω|v--pna---
δεῖ|δεῖ|v3siia---
ἴσον|ἴσος|a-s---na-
λόγους|λόγος|n-p---ma-
διαγωνίζεσθαι|διαγωνίζομαι|v--pne---
καθιστάντα|καθίστημι|v-sppama-
πολιορκεῖν|πολιορκέω|v--pna---
περιόψεσθαι|περιοράω|v--fnm---
δίκης|δίκη|n-s---fg-
παρέσχοντο|παρέχω|v3paim---
δεῦρο|δεῦρο|d--------
ἥκουσιν|ἥκω|v3ppia---
ἁμαρτόντες|ἁμαρτάνω|v-papamn-
ἀξιοῦντες|ἀξιόω|v-pppamn-
ξυμμαχεῖν|συμμαχέω|v--pna---
ξυναδικεῖν|συναδικέω|v--pna---
διαφόρους|διάφορος|a-p---ma-
χρῆν|χρή|v3siia---
ἀσφαλέστατοι|ἀσφαλής|a-p---mns
προσιέναι|προσίημι|v--pna---
ἠδικήμεθα|ἀδικέω|v1prie---
κινδυνεύουσι|κινδυνεύω|v3ppia---
μηδ̓|μηδέ|c--------
μεταλαβόντες|μεταλαμβάνω|v-papamn-
μεταδώσετε|μεταδίδωμι|v2pfia---
ἁμαρτημάτων|ἁμάρτημα|n-p---ng-
ἀπογενόμενοι|ἀπογίγνομαι|v-papmmn-
κοινώσαντας|κοινόω|v-papama-
κοινὰ|κοινός|a-p---na-
ἀποβαίνοντα|ἀποβαίνω|v-pppana-
προσηκόντων|προσήκω|v-pppang-
ἐγκλημάτων|ἔγκλημα|n-p---ng-
ἐρχόμεθα|ἔρχομαι|v1ppie---
οἵδε|ὅδε|p-p---mn-
βίαιοι|βίαιος|a-p---mn-
πλεονέκται|πλεονέκτης|n-p---mn-
δικαίως|δίκαιος|d--------
δέχοισθε|δέχομαι|v2ppoe---
μαθεῖν|μανθάνω|v--ana---
χρή|χρή|v3spia---
σπονδαῖς|σπονδή|n-p---fd-
ἀγράφων|ἄγραφος|a-p---fg-
βλάβῃ|βλάβη|n-s---fd-
ἑτέρων|ἕτερος|a-p---mg-
ἰοῦσιν|εἶμι|v-pppamd-
ξυνθήκη|συνθήκη|n-s---fn-
ἐστίν|εἰμί|v3spia---
ἑαυτὸν|ἑαυτοῦ|p-s---ma-
ἀποστερῶν|ἀποστερέω|v-sfpamn-
δεῖται|δέομαι|v3spie---
δεξαμένοις|δέχομαι|v-papmmd-
σωφρονοῦσι|σωφρονέω|v3ppia---
ἀντ̓|ἀντί|r--------
εἰρήνης|εἰρήνη|n-s---fg-
πειθόμενοι|πείθω|v-pppemn-
πάθοιτε|πάσχω|v2paoa---
ἐπίκουροι|ἐπίκουρος|n-p---mn-
γένοισθε|γίγνομαι|v2paom---
ἀντὶ|ἀντί|r--------
ἴτε|εἶμι|v2ppia---
ἀμύνεσθαι|ἀμύνω|v--pne---
δίκαιοί|δίκαιος|a-p---mn-
ἐστὲ|εἰμί|v2ppia---
ἐκποδὼν|ἐκποδών|d--------
στῆναι|ἵστημι|v--ana---
ἀμφοτέροις|ἀμφότερος|a-p---md-
οὐναντίον|ἐναντίος|a-s---na-
ἔνσπονδοί|ἔνσπονδος|a-p---mn-
ἐστε|εἰμί|v2ppia---
ἀνοκωχῆς|ἀνοκωχή|n-s---fg-
πώποτ̓|πώποτε|d--------
ἐγένεσθε|γίγνομαι|v2paim---
καθιστάναι|καθίστημι|v--pna---
ἀφισταμένους|ἀφίστημι|v-pppema-
Σαμίων|Σάμιος|n-p---mg-
ἀποστάντων|ἀφίστημι|v-papamg-
ψῆφον|ψῆφος|n-s---fa-
προσεθέμεθα|προστίθημι|v1paim---
ἐναντίαν|ἐναντίος|a-s---fa-
δίχα|δίχα|d--------
ἐψηφισμένων|ψηφίζομαι|v-prpemg-
ἀμύνειν|ἀμύνω|v--pna---
φανερῶς|φανερός|d--------
ἀντείπομεν|ἀντεῖπον|v1pasa---
προσήκοντας|προσήκω|v-pppama-
αὐτόν|αὐτός|a-s---ma-
κολάζειν|κολάζω|v--pna---
κακόν|κακός|a-s---na-
δρῶντας|δράω|v-pppama-
τιμωρήσετε|τιμωρέω|v2pfia---
πρόσεισι|πρόσειμι|v3spia---
θήσετε|τίθημι|v2pfia---
δικαιώματα|δικαίωμα|n-p---na-
ἔχομεν|ἔχω|v1ppia---
ἱκανὰ|ἱκανός|a-p---na-
νόμους|νόμος|n-p---ma-
παραίνεσιν|παραίνεσις|n-s---fa-
τοιάνδε|τοιόσδε|a-s---fa-
ἐχθροὶ|ἐχθρός|a-p---mn-
βλάπτειν|βλάπτω|v--pna---
φίλοι|φίλος|a-p---mn-
ὥστ̓|ὥστε|c--------
ἐπιχρῆσθαι|ἐπιχράομαι|v--pne---
ἀντιδοθῆναι|ἀντιδίδωμι|v--anp---
φαμὲν|φημί|v1ppia---
χρῆναι|χρή|v--pna---
μακρῶν|μακρός|a-p---fg-
σπανίσαντές|σπανίζω|v-papamn-
Αἰγινητῶν|Αἰγινήτης|n-p---mg-
Μηδικὰ|Μηδικός|a-p---na-
ἐλάβετε|λαμβάνω|v2paia---
εὐεργεσία|εὐεργεσία|n-s---fn-
Σαμίους|Σάμιος|n-p---ma-
Πελοποννησίους|Πελοποννήσιοι|n-p---ma-
βοηθῆσαι|βοηθέω|v--ana---
παρέσχεν|παρέχω|v3saia---
ἐπικράτησιν|ἐπικράτησις|n-s---fa-
κόλασιν|κόλασις|n-s---fa-
καιροῖς|καιρός|n-p---md-
τοιούτοις|τοιοῦτος|a-p---md-
ἰόντες|εἰμί|v-pppamn-
ἁπάντων|ἅπας|a-p---ng-
ἀπερίοπτοί|ἀπερίοπτος|a-p---mn-
εἰσι|εἰμί|v3ppia---
νικᾶν|νικάω|v--pna---
ὑπουργοῦντα|ὑπουργέω|v-sppama-
ἐχθρὸς|ἐχθρός|a-s---mn-
πολέμιόν|πολέμιος|a-s---ma-
ἀντιστάντα|ἀνθίστημι|v-sppama-
τύχῃ|τυγχάνω|v3sasa---
φίλος|φίλος|a-s---mn-
ὤν|εἰμί|v-sppamn-
οἰκεῖα|οἰκεῖος|a-p---na-
χεῖρον|χείρων|a-s---nac
τίθενται|τίθημι|v3ppie---
φιλονικίας|φιλονεικία|n-s---fg-
ἐνθυμηθέντες|ἐνθυμέομαι|v-papemn-
νεώτερός|νεώτερος|a-s---mn-
πρεσβυτέρου|πρέσβυς|a-s---mgc
μαθὼν|μανθάνω|v-sapamn-
ἀξιούτω|ἀξιόω|v3spma---
ὁμοίοις|ὅμοιος|a-p---nd-
νομίσῃ|νομίζω|v3sasa---
πολεμήσει|πολεμέω|v3sfia---
ξυμφέρον|συμφέρω|v-sppann-
ἐλάχιστα|ἐλάχιστος|a-p---na-
ἁμαρτάνῃ|ἁμαρτάνω|v3spsa---
ἕπεται|ἕπομαι|v3spie---
μέλλον|μέλλω|v-sppann-
φοβοῦντες|φοβέω|v-pppamn-
κελεύουσιν|κελεύω|v3ppia---
ἀδικεῖν|ἀδικέω|v--pna---
ἀφανεῖ|ἀφανής|a-s---nd-
ἄξιον|ἄξιος|a-s---nn-
ἐπαρθέντας|ἐπαίρω|v-pappma-
φανερὰν|φανερός|a-s---fa-
ἔχθραν|ἔχθρα|n-s---fa-
μέλλουσαν|μέλλω|v-sppafa-
κτήσασθαι|κτάομαι|v--anm---
ὑπαρχούσης|ὑπάρχω|v-sppafg-
Μεγαρέας||
ὑποψίας|ὑποψία|n-s---fg-
ὑφελεῖν|ὑφαιρέω|v--ana---
τελευταία|τελευταῖος|a-s---fn-
χάρις|χάρις|n-s---fn-
καιρὸν|καιρός|n-s---ma-
ἔχουσα|ἔχω|v-sppafn-
ἐλάσσων|ἐλάσσων|a-s---fnc
δύναται|δύναμαι|v3spie---
ἔγκλημα|ἔγκλημα|n-s---na-
λῦσαι|λύω|v--ana---
μεγάλην|μέγας|a-s---fa-
διδόασι|δίδωμι|v3ppia---
ἐφέλκεσθαι|ἐφέλκω|v--pne---
ὁμοίους|ὅμοιος|a-p---ma-
ἐχυρωτέρα|ἐχυρός|a-s---fnc
φανερῷ|φανερός|a-s---nd-
περιπεπτωκότες|περιπίπτω|v-prpamn-
Λακεδαίμονι|Λακεδαίμων|n-s---fd-
προείπομεν|προεῖπον|v1paia---
ἀξιοῦμεν|ἀξιόω|v1ppia---
κομίζεσθαι|κομίζω|v--pne---
ὠφεληθέντας|ὠφελέω|v-pappma-
ὑμετέρᾳ|ὑμέτερος|a-s---fd-
ἀνταπόδοτε|ἀνταποδίδωμι|v2pama---
ὅ|ὁ|l-s---mn-
ὑπουργῶν|ὑπουργέω|v-sppamn-
ἀντιστὰς|ἀνθίστημι|v-sppamn-
ἐχθρός|ἐχθρός|a-s---mn-
τούσδε|ὅδε|a-p---ma-
δέχεσθε|δέχομαι|v2ppme---
ἀμύνετε|ἀμύνω|v2ppma---
ἀδικοῦσιν|ἀδικέω|v-pppamd-
ποιοῦντες|ποιόω|v-pppamn-
προσήκοντά|προσήκω|v-pppana-
δράσετε|δράω|v2pfia---
ἄριστα|ἄριστος|a-p---na-
βουλεύσεσθε|βουλεύω|v2pfim---
ἀκούσαντες|ἀκούω|v-papamn-
γενομένης|γίγνομαι|v-sapmfg-
δὶς|δίς|d--------
προτέρᾳ|πρότερος|a-s---fd-
ἀπεδέξαντο|ἀποδέχομαι|v3paim---
ὑστεραίᾳ|ὑστεραῖος|a-s---fd-
μετέγνωσαν|μεταγιγνώσκω|v3paia---
ἐλύοντ̓|λύω|v3piie---
σπονδαι|σπονδή|n-p---fn-
ἐπιμαχίαν|ἐπιμαχία|n-s---fa-
ἐάν|ἐάν|c--------
ἴῃ|εἶμι|v3spsa---
ὣς|ὡς|d--------
ἐβούλοντο|βούλομαι|v3piie---
ἔχουσαν|ἔχω|v-sppafa-
ξυγκρούειν|συγκρούω|v--pna---
ἀσθενεστέροις|ἀσθενής|a-p---mdc
οὖσιν|εἰμί|v-pppamd-
ἤν|ἐάν|c--------
δέῃ|δέω|v3spsa---
καθιστῶνται|καθίστημι|v3ppse---
ἐφαίνετο|φαίνω|v3siie---
νῆσος|νῆσος|n-s---fn-
παράπλῳ|παράπλοος|n-s---md-
κεῖσθαι|κεῖμαι|v--pne---
τοιαύτῃ|τοιοῦτος|a-s---fd-
προσεδέξαντο|προσδέχομαι|v3paim---
ἀπελθόντων|ἀπέρχομαι|v-papamg-
βοηθούς|βοηθός|a-p---ma-
Λακεδαιμόνιός|Λακεδαιμόνιος|n-s---mn-
Κίμωνος|Κίμων|n-s---mg-
Διότιμος|Διότιμος|n-s---mn-
Στρομβίχου|Στρόμβιχος|n-s---mg-
Πρωτέας|Πρωτέας|n-s---mn-
Ἐπικλέους|Ἐπικλέης|n-s---mg-
ναυμαχεῖν|ναυμαχέω|v--pna---
πλέωσι|πλέω|v3ppsa---
μέλλωσιν|μέλλω|v3ppsa---
ἀποβαίνειν|ἀποβαίνω|v--pna---
χωρίων|χωρίον|n-p---ng-
λύειν|λύω|v--pna---
σπονδάς|σπονδή|n-p---fa-
ἀφικνοῦνται|ἀφικνέομαι|v3ppie---
παρεσκεύαστο|παρασκευάζω|v3slie---
ἑκατόν|ἑκατόν|a--------
δώδεκα|δώδεκα|a--------
ἑπτὰ|ἑπτά|a--------
Ἀνακτορίων|Ἀνακτόριος|n-p---mg-
μία|εἷς|a-s---fn-
ἐνενήκοντα|ἐνενήκοντα|a--------
στρατηγοὶ|στρατηγός|n-p---mn-
ἑκάστων|ἕκαστος|a-p---mg-
Ξενοκλείδης|Ξενοκλείδης|n-s---mn-
Εὐθυκλέους|Εὐθυκλῆς|n-s---mg-
πέμπτος|πέμπτος|a-s---mn-
αὐτός|αὐτός|a-s---mn-
προσέμειξαν|προσμείγνυμι|v3paia---
ὁρμίζονται|ὁρμίζω|v3ppie---
λιμήν|λιμήν|n-s---mn-
Ἐλαιάτιδι|Ἐλαίατις|n-s---fd-
Ἐφύρη|Ἐφύρα|n-s---fn-
ἐξίησι|ἐξίημι|v3spia---
Ἀχερουσία|Ἀχερουσία|n-s---fn-
λίμνη|λίμνη|n-s---fn-
Ἀχέρων|Ἀχέρων|n-s---mn-
ποταμὸς|ποταμός|n-s---mn-
ῥέων|ῥέω|v-sppamn-
ἐσβάλλει|εἰσβάλλω|v3spia---
αὐτήν|αὐτός|p-s---fa-
ἔχει|ἔχω|v3spia---
ῥεῖ|ῥέω|v3spia---
Θύαμις|Θύαμις|n-s---fn-
ποταμός|ποταμός|n-s---mn-
ὁρίζων|ὁρίζω|v-sppamn-
Θεσπρωτίδα|Θεσπρωτίς|n-s---fa-
Κεστρίνην|Κεστρίνη|n-s---fa-
ἄκρα|ἄκρα|n-s---fn-
ἀνέχει|ἀνέχω|v3spia---
ἠπείρου|ἤπειρος|n-s---fg-
ὁρμίζονταί|ὁρμίζω|v3ppie---
στρατόπεδον|στρατόπεδον|n-s---na-
προσπλέοντας|προσπλέω|v-pppama-
πληρώσαντες|πληρόω|v-papamn-
Μικιάδης|Μικιάδης|n-s---mn-
Αἰσιμίδης|Αἰσιμίδης|n-s---mn-
Εὐρύβατος|Εὐρύβατος|n-s---mn-
ἐστρατοπεδεύσαντο|στρατοπεδεύω|v3paim---
καλοῦνται|καλέω|v3ppie---
Σύβοτα|Σύβοτα|n-p---nn-
Ἀττικαὶ|Ἀττικός|a-p---fn-
πεζὸς|πεζός|a-s---mn-
Ζακυνθίων|Ζακύνθιος|n-p---mg-
χίλιοι|χίλιος|a-p---mn-
βεβοηθηκότες|βοηθέω|v-prpamn-
παραβεβοηθηκότες|παραβοηθέω|v-prpamn-
ἠπειρῶται|ἠπειρώτης|n-p---mn-
λαβόντες|λαμβάνω|v-papamn-
τριῶν|τρεῖς|a-p---fg-
ἡμερῶν|ἡμέρα|n-p---fg-
σιτία|σιτίον|n-p---na-
ἀνήγοντο|ἀνάγω|v3piie---
Χειμερίου|Χειμέριον|n-s---ng-
νυκτός|νύξ|n-s---fg-
ἕῳ|ἠώς|n-s---fd-
καθορῶσι|καθοράω|v3ppia---
μετεώρους|μετέωρος|a-p---fa-
πλεούσας|πλέω|v-pppafa-
κατεῖδον|κατεῖδον|v3paia---
ἀντιπαρετάσσοντο|ἀντιπαρατάσσομαι|v3piie---
δεξιὸν|δεξιός|a-s---na-
κέρας|κέρας|n-s---na-
ἐπεῖχον|ἐπέχω|v3piia---
τέλη|τέλος|n-p---na-
ποιήσαντες|ποιέω|v-papamn-
<|<|u--------
>|>|u--------
στρατηγῶν|στρατηγός|n-p---mg-
εἷς|εἷς|n-s---mn-
ἐτάξαντο|τάσσω|v3paim---
Μεγαρίδες|Μεγαρίς|n-p---fn-
Ἀμπρακιώτιδες|Ἀμπρακιῶτις|n-p---fn-
εὐώνυμον|εὐώνυμος|a-s---na-
πλεούσαις|πλέω|v-pppafd-
ξυμμείξαντες|συμμίγνυμι|v-papamn-
σημεῖα|σημεῖον|n-p---nn-
ἑκατέροις|ἑκάτερος|a-p---md-
ἤρθη|αἴρω|v3saip---
ἐναυμάχουν|ναυμαχέω|v3piia---
ὁπλίτας|ὁπλίτης|n-p---ma-
καταστρωμάτων|κατάστρωμα|n-p---ng-
ἀκοντιστάς|ἀκοντιστής|n-p---ma-
ἀπειρότερον|ἄπειρος|a-s---nac
παρεσκευασμένοι|παρασκευάζω|v-prpemn-
καρτερά|καρτερός|a-s---fn-
τέχνῃ|τέχνη|n-s---fd-
πεζομαχίᾳ|πεζομαχία|n-s---fd-
προσφερὴς|προσφερής|a-s---fn-
οὖσα|εἰμί|v-sppafn-
προσβάλοιεν|προσβάλλω|v3paoa---
ἀπελύοντο|ἀπολύω|v3piie---
πλήθους|πλῆθος|n-s---ng-
ὄχλου|ὄχλος|n-s---mg-
μᾶλλόν|μᾶλλον|d--------
καταστρώματος|κατάστρωμα|n-s---ng-
νίκην|νίκη|n-s---fa-
καταστάντες|καθίστημι|v-papamn-
ἐμάχοντο|μάχομαι|v3piie---
ἡσυχαζουσῶν|ἡσυχάζω|v-pppafg-
διέκπλοι|διέκπλοος|n-p---mn-
θυμῷ|θυμός|n-s---md-
ῥώμῃ|ῥώμη|n-s---fd-
ἐπιστήμῃ|ἐπιστήμη|n-s---fd-
πανταχῇ|πανταχῆ|d--------
θόρυβος|θόρυβος|n-s---mn-
ταραχώδης|ταραχώδης|a-p---fn-
παραγιγνόμεναι|παραγίγνομαι|v-pppefn-
πῃ|πη|d--------
πιέζοιντο|πιέζω|v3ppoe---
παρεῖχον|παρέχω|v3piia---
μάχης|μάχη|n-s---fg-
ἦρχον|ἄρχω|v3piia---
δεδιότες|δείδω|v-prpamn-
πρόρρησιν|πρόρρησις|n-s---fa-
ἐπόνει|πονέω|v3siia---
τρεψάμενοι|τρέπω|v-papmmn-
καταδιώξαντες|καταδιώκω|v-papamn-
σποράδας|σποράς|n-p---ma-
στρατοπέδου|στρατόπεδον|n-s---ng-
ἐπεκβάντες|ἐπεκβαίνω|v-papamn-
ἐνέπρησάν|ἐμπρήθω|v3paia---
σκηνὰς|σκηνή|n-p---fa-
ἐρήμους|ἐρῆμος|a-p---fa-
διήρπασαν|διαρπάζω|v3paia---
ἡσσῶντό|ἡσσάομαι|v3piie---
εὐωνύμῳ|εὐώνυμος|a-s---md-
ἐλάσσονος|ἐλάσσων|a-s---ngc
διώξεως|δίωξις|n-s---fg-
παρουσῶν|πάρειμι|v-pppafg-
ὁρῶντες|ὁράω|v-pppamn-
πιεζομένους|πιέζω|v-pppema-
ἀπροφασίστως|ἀπροφάσιστος|d--------
ἐπεκούρουν|ἐπί-ἐπικουρέω|v3piia---
ἀπεχόμενοι|ἀπέχω|v-pppemn-
ἐμβάλλειν|ἐμβάλλω|v--pna---
τινί|τις|p-s---md-
τροπὴ|τροπή|n-s---fn-
ἐγίγνετο|γίγνομαι|v3siie---
λαμπρῶς|λαμπρός|d--------
ἐνέκειντο|ἔγκειμαι|v3piie---
πᾶς|πᾶς|a-s---mn-
εἴχετο|ἔχω|v3siie---
διεκέκριτο|διακρίνω|v3slie---
ξυνέπεσεν|συμπίτνω|v3saia---
ἀνάγκης|ἀνάγκη|n-s---fg-
ἐπιχειρῆσαι|ἐπιχειρέω|v--ana---
τροπῆς|τροπή|n-s---fg-
σκάφη|σκάφος|n-p---na-
εἷλκον|ἕλκω|v3piia---
ἃς|ὅς|p-p---fa-
καταδύσειαν|κατά-δύω|v3paoa---
φονεύειν|φονεύω|v--pna---
διεκπλέοντες|διεκπλέω|v-pppamn-
ζωγρεῖν|ζωγρέω|v--pna---
ᾐσθημένοι|αἰσθάνομαι|v-prpemn-
ἥσσηντο|ἡσσάομαι|v3plie---
δεξιῷ|δεξιός|a-s---nd-
κέρᾳ|κέρας|n-s---nd-
ἀγνοοῦντες|ἀγνοέω|v-pppamn-
ἔκτεινον|κτείνω|v3piia---
οὐσῶν|εἰμί|v-pppafg-
ἐπεχουσῶν|ἐπώχατο|v-pppafg-
ξυνέμειξαν|συμμίγνυμι|v3paia---
διάγνωσιν|διάγνωσις|n-s---fa-
ὁποῖοι|ὁποῖος|a-p---mn-
ἐκρατοῦντο|κρατέω|v3piie---
γεγένηται|γίγνομαι|v3srie---
κατεδίωξαν|καταδιώκω|v3paia---
ναυάγια|ναυάγιον|n-p---na-
νεκροὺς|νεκρός|n-p---ma-
προσκομίσαι|προσκομίζω|v--ana---
οἷ|οἷ|d--------
στρατὸς|στρατός|n-s---mn-
προσεβεβοηθήκει|προσβοηθέω|v3slia---
λιμὴν|λιμήν|n-s---mn-
ἐρῆμος|ἐρῆμος|a-s---mn-
ἁθροισθέντες|ἀθροίζω|v-pappmn-
πλωίμοις|πλώιμος|a-p---fd-
λοιπαὶ|λοιπός|a-p---fn-
Ἀττικῶν|Ἀττικός|a-p---fg-
ἀντεπέπλεον|ἀντί-ἐπιπλέω|v3piia---
δείσαντες|δείδω|v-papamn-
πειρῶσιν|πειράω|v3ppsa---
ὀψὲ|ὀψέ|d--------
ἐπεπαιάνιστο|παιανίζω|v3slie---
ἐπίπλουν|ἐπίπλοος|n-s---ma-
ἐξαπίνης|ἐξαπίνης|d--------
πρύμναν|πρύμνα|n-s---fa-
ἐκρούοντο|κρούω|v3piie---
κατιδόντες|κατεῖδον|v-papamn-
προσπλεούσας|προσπλέω|v-pppafa-
βοηθοὺς|βοηθός|a-p---fa-
νικηθῶσιν|νικάω|v3pasp---
σφέτεραι|σφέτερος|a-p---fn-
ὀλίγαι|ὀλίγος|a-p---fn-
ὦσιν|εἰμί|v3ppsa---
ταύτας|οὗτος|p-p---fa-
προϊδόντες|προεῖδον|v-papamn-
ὅσας|ὅσος|a-p---fa-
ἑώρων|ὁράω|v3piia---
πλείους|πλείων|a-p---fac
ὑπανεχώρουν|ὑπαναχωρέω|v3piia---
ἀφανοῦς|ἀφανής|a-s---ng-
ἑωρῶντο|ὁράω|v3piie---
ἐθαύμαζον|θαυμάζω|v3piia---
κρουομένους|κρούω|v-pppema-
πρίν|πρίν|c--------
ἰδόντες|εἶδον|v-papamn-
ἐκεῖναι|ἐκεῖνος|a-p---fn-
ἐπιπλέουσιν|ἐπιπλέω|v3ppia---
ξυνεσκόταζε|συσκοτάζω|v3siia---
ἀποτραπόμενοι|ἀποτρέπω|v-papmmn-
διάλυσιν|διάλυσις|n-s---fa-
ἀπαλλαγὴ|ἀπαλλαγή|n-s---fn-
ἐτελεύτα|τελευτάω|v3siia---
νύκτα|νύξ|n-s---fa-
στρατοπεδευομένοις|στρατοπεδεύω|v-pppemd-
Γλαύκων|Γλαύκων|n-s---mn-
Λεάγρου|Λέαγρος|n-s---mg-
†|†|u--------
Ἀνδοκίδης|Ἀνδοκίδης|n-s---mn-
Λεωγόρου|Λεώγορος|n-s---mg-
νεκρῶν|νεκρός|n-p---mg-
ναυαγίων|ναυάγιον|n-p---ng-
προσκομισθεῖσαι|προσκομίζω|v-pappfn-
κατέπλεον|καταπλέω|v3piia---
ὤφθησαν|ὁράω|v3paip---
νύξ|νύξ|n-s---fn-
ἐφοβήθησαν|φοβέω|v3paip---
πολέμιαι|πολέμιος|a-p---fn-
ἔγνωσαν|γιγνώσκω|v3paia---
ὡρμίσαντο|ὁρμίζω|v3paim---
ἀναγαγόμεναι|ἀνάγω|v-papmfn-
πλώιμοι|πλώιμος|a-p---fn-
ἐπέπλευσαν|ἐπιπλέω|v3paia---
Συβότοις|Σύβοτα|n-p---nd-
λιμένα|λιμήν|n-s---ma-
ὥρμουν|ὁρμέω|v3piia---
ναυμαχήσουσιν|ναυμαχέω|v3pfia---
ἡσύχαζον|ἡσυχάζω|v3piia---
ναυμαχίας|ναυμαχία|n-s---fg-
διανοούμενοι|διανοέομαι|v-pppemn-
ἄρχειν|ἄρχω|v--pna---
ἑκόντες|ἑκών|a-p---mn-
προσγεγενημένας|προσγίγνομαι|v-prpefa-
ἀκραιφνεῖς|ἀκραιφνής|a-p---fa-
ἄπορα|ἄπορος|a-p---na-
ξυμβεβηκότα|συμβαίνω|v-prpana-
αἰχμαλώτων|αἰχμάλωτος|a-p---mg-
ἐπισκευὴν|ἐπισκευή|n-s---fa-
χωρίῳ|χωρίον|n-s---nd-
ἐρήμῳ|ἐρῆμος|a-s---nd-
οἴκαδε|οἴκαδε|d--------
πλοῦ|πλόος|n-s---mg-
διεσκόπουν|διασκοπέω|v3piia---
ὅπῃ|ὅπη|d--------
κομισθήσονται|κομίζω|v3pfip---
νομίσαντες|νομίζω|v-papamn-
λελύσθαι|λύω|v--rne---
χεῖρας|χείρ|n-p---fa-
ἐῶσι|ἐάω|v3ppsa---
ἀποπλεῖν|ἀποπλέω|v--pna---
ἄνδρας|ἀνήρ|n-p---ma-
κελήτιον|κελήτιον|n-s---na-
ἐσβιβάσαντας|εἰσβιβάζω|v-papama-
κηρυκείου|κηρύκειον|n-s---ng-
προσπέμψαι|προσπέμπω|v--ana---
Ἀθηναίοις|Ἀθήναιος|n-p---md-
πεῖραν|πείρω|v3ppna---
πέμψαντές|πέμπω|v-papamn-
ἀδικεῖτε|ἀδικέω|v2ppma---
ἄρχοντες|ἄρχων|n-p---mn-
λύοντες|λύω|v-pppamn-
πολεμίους|πολέμιος|a-p---ma-
ἡμετέρους|ἡμέτερος|a-p---ma-
τιμωρουμένοις|τιμωρέω|v-pppemd-
ἐμποδὼν|ἐμποδών|d--------
ἵστασθε|ἵστημι|v2ppie---
ὅπλα|ὅπλον|n-p---na-
ἀνταιρόμενοι|ἀνταίρω|v-pppemn-
γνώμη|γνώμη|n-s---fn-
ἄλλοσε|ἄλλοτε|d--------
ποι|ποι|d--------
βουλόμεθα|βούλομαι|v1ppie---
λύετε|λύω|v2ppia---
πρώτους|πρότερος|a-p---ma-
χρήσασθε|χράω|v2pamm---
ἐπήκουσεν|ἐπακούω|v3saia---
ἀνεβόησεν|ἀναβοάω|v3saia---
λαβεῖν|λαμβάνω|v--ana---
ἀποκτεῖναι|ἀποκτείνω|v--ana---
ἄρχομεν|ἄρχω|v1ppia---
λύομεν|λύω|v1ppia---
οὖσι|εἰμί|v-pppamd-
βοηθοὶ|βοηθός|a-p---mn-
ἤλθομεν|ἔρχομαι|v1paia---
ἄλλοσέ|ἄλλοτε|d--------
βούλεσθε|βούλομαι|v2ppie---
κωλύομεν|κωλύω|v1ppia---
πλευσεῖσθε|πλέω|v2pfim---
περιοψόμεθα|περιοράω|v1pfim---
δυνατόν|δυνατός|a-s---na-
ἀποκριναμένων|ἀποκρίνω|v-papmmg-
πλοῦν|πλόος|n-s---ma-
ἔστησαν|ἵστημι|v3paia---
ἀνείλοντο|ἀναιρέω|v3paim---
ἐξενεχθέντα|ἐκφέρω|v-pappna-
ῥοῦ|ῥόος|n-s---mg-
ἀνέμου|ἄνεμος|n-s---mg-
νυκτὸς|νύξ|n-s---fg-
διεσκέδασεν|διασκεδάννυμι|v3saia---
ἀντέστησαν|ἀνθίστημι|v3paia---
νενικηκότες|νικάω|v-prpamn-
τοιᾷδε|τοιόσδε|a-s---fd-
προσεποιήσαντο|προσποιέω|v3paim---
κρατήσαντες|κρατέω|v-papamn-
ναυμαχίᾳ|ναυμαχία|n-s---fd-
πλεῖστα|πλεῖστος|a-p---na-
προσκομίσασθαι|προσκομίζω|v--anm---
καταδύσαντες|κατά-δύω|v-papamn-
διαφθείραντες|διαφθείρω|v-papamn-
ἀνελόμενοι|ἀναιρέω|v-papmmn-
νεκρούς|νεκρός|n-p---ma-
προτεραίᾳ|προτεραῖος|a-s---fd-
κρουόμενοι|κρούω|v-pppemn-
ὑπεχώρησαν|ὑποχωρέω|v3paia---
Ἀττικὰς|Ἀττικός|a-p---fa-
Συβότων|Σύβοτα|n-p---ng-
ἠξίουν|ἀξιόω|v3piia---
ἀποπλέοντες|ἀποπλέω|v-pppamn-
Ἀνακτόριον|Ἀνακτόριον|n-s---na-
κοινὸν|κοινός|a-s---nn-
καταστήσαντες|καθίστημι|v-papamn-
ὀκτακοσίους|ὀκτακόσιοι|a-p---ma-
ἀπέδοντο|ἀποδίδωμι|v3paim---
διακοσίους|διακόσιοι|a-p---ma-
ἐφύλασσον|φυλάσσω|v3piia---
θεραπείᾳ|θεραπείη|n-s---fd-
πολλῇ|πολύς|a-s---fd-
ἀναχωρήσαντες|ἀναχωρέω|v-papamn-
προσποιήσειαν|προσποιέω|v3paoa---
ἐτύγχανον|τυγχάνω|v3piia---
Κέρκυρα|Κέρκυρα|n-s---fn-
περιγίγνεται|περιγίγνομαι|v3spie---
αἰτία|αἰτία|n-s---fn-
πρώτη|πρῶτος|a-s---fn-
διάφορα|διάφορον|n-p---nn-
πρασσόντων|πράσσω|v-pppamg-
τιμωρήσονται|τιμωρέω|v3pfim---
Ποτειδεάτας|Ποτειδεάτης|n-p---ma-
οἰκοῦσιν|οἰκέω|v3ppia---
ἰσθμῷ|ἰσθμός|n-s---md-
Παλλήνης|Παλλήνη|n-s---fg-
Παλλήνην|Παλλήνη|n-s---fa-
τεῖχος|τεῖχος|n-s---na-
καθελεῖν|καθαιρέω|v--ana---
ὁμήρους|ὅμηρος|n-p---ma-
ἐπιδημιουργοὺς|ἐπιδημιουργοί|n-p---ma-
ἐκπέμπειν|ἐκπέμπω|v--pna---
λοιπὸν|λοιπός|a-s---na-
ἔτος|ἔτος|n-s---na-
ἀποστῶσιν|ἀφεστήξω|v3pasa---
Περδίκκου|Περδίκκας|n-s---mg-
Θρᾴκης|Θρᾳκία|n-s---fg-
ξυναποστήσωσι|συναφίστημι|v3pasa---
προπαρεσκευάζοντο|προπαρασκευάζω|v3piie---
Κερκύρᾳ|Κέρκυρα|n-s---fd-
διάφοροι|διάφορος|a-p---mn-
Περδίκκας|Περδίκκας|n-s---mn-
Ἀλεξάνδρου|Ἀλέξανδρος|n-s---mg-
Μακεδόνων|Μακεδών|n-p---mg-
βασιλεὺς|βασιλεύς|n-s---mn-
ἐπεπολέμωτο|πολεμόω|v3slie---
ξύμμαχος|σύμμαχος|a-s---mn-
ἐπολεμώθη|πολεμόω|v3saip---
Φιλίππῳ|Φίλιππος|n-s---md-
ἀδελφῷ|ἀδελφός|n-s---md-
Δέρδᾳ|Δέρδης|n-s---md-
ἐναντιουμένοις|ἐν-ἀντιόομαι|v-pppemd-
δεδιώς|δείδω|v-srpamn-
ἔπρασσεν|πράσσω|v3siia---
Λακεδαίμονα|Λακεδαίμων|n-s---fa-
πέμπων|πέμπω|v-sppamn-
προσεποιεῖτο|προσποιέω|v3siie---
Ποτειδαίας|Ποτείδαια|n-s---fg-
ἀποστάσεως|ἀπόστασις|n-s---fg-
προσέφερε|προσφέρω|v3siia---
Χαλκιδεῦσι|Χαλκιδεύς|n-p---md-
Βοττιαίοις|Βοττιαῖος|n-p---md-
ξυναποστῆναι|συναφίστημι|v--ana---
ξύμμαχα|σύμμαχος|a-p---na-
ὅμορα|ὅμορος|a-p---na-
ῥᾷον|ῥάιος|a-s---na-
αἰσθόμενοι|αἰσθάνομαι|v-papmmn-
προκαταλαμβάνειν|προκαταλαμβάνω|v--pna---
ἀποστάσεις|ἀπόστασις|n-p---fn-
ἔτυχον|τυγχάνω|v3paia---
ἀποστέλλοντες|ἀποστέλλω|v-pppamn-
χιλίους|χίλιοι|a-p---ma-
Ἀρχεστράτου|Ἀρχέστρατος|n-s---mg-
Λυκομήδους|Λυκομήδης|n-s---mg-
στρατηγοῦντος|στρατηγέω|v-sppamg-
ἐπιστέλλουσι|ἐπιστέλλω|v3ppia---
ἄρχουσι|ἄρχων|n-p---md-
Ποτειδεατῶν|Ποτειδεάτης|n-p---mg-
πλησίον|πλησίος|d--------
φυλακὴν|φυλακή|n-s---fa-
ἀποστήσονται|ἀφεστήξω|v3pfim---
Ποτειδεᾶται|Ποτειδεάτης|n-p---mn-
πως|πως|d--------
πείσειαν|πείθω|v3paoa---
νεωτερίζειν|νεωτερίζω|v--pna---
μηδέν|μηδείς|p-s---na-
ἔπρασσον|πράσσω|v3piia---
ἑτοιμάσαιντο|ἑτοιμάζω|v3paom---
πράσσοντες|πράσσω|v-pppamn-
ηὕροντο|εὑρίσκω|v3paim---
ἐπιτήδειον|ἐπιτήδειος|a-s---na-
Μακεδονίαν|Μακεδονία|n-s---fa-
ὑπέσχετο|ὑπισχνέομαι|v3saim---
Ποτείδαιαν|Ποτειδαία|n-s---fa-
ἴωσιν|εἰμί|v3ppsa---
ἐσβαλεῖν|εἰσβάλλω|v--fna---
ἀφίστανται|ἀφεστήξω|v3ppie---
Βοττιαίων|Βοττιαῖος|n-p---mg-
ξυνομόσαντες|συνόμνυμι|v-papamn-
πείθει|πείθω|v3spia---
Χαλκιδέας|Χαλκιδεύς|n-p---ma-
ἐκλιπόντας|ἐκλείπω|v-papama-
καταβαλόντας|καταβάλλω|v-papama-
ἀνοικίσασθαι|ἀνοικίζω|v--anm---
Ὄλυνθον|Ὄλυνθος|n-s---ma-
ἰσχυρὰν|ἰσχυρός|a-s---fa-
τ̓|τε|d--------
ἐκλιποῦσι|ἐκλείπω|v-papamd-
Μυγδονίας|Μυγδονία|n-s---fg-
Βόλβην|Βόλβη|n-s---fa-
λίμνην|λίμνη|n-s---fa-
ἔδωκε|δίδωμι|v3saia---
νέμεσθαι|νέμω|v--pne---
ἀνῳκίζοντό|ἀνοικίζω|v3piie---
καθαιροῦντες|καθαιρέω|v-pppamn-
καταλαμβάνουσι|καταλαμβάνω|v3ppia---
ἀφεστηκότα|ἀφεστήξω|v-prpana-
Περδίκκαν|Περδίκκας|n-s---ma-
παρούσῃ|πάρειμι|v-sppafd-
ξυναφεστῶτα|συναφίστημι|v-prpana-
ἐξεπέμποντο|ἐκπέμπω|v3piie---
Φιλίππου|Φίλιππος|n-s---mg-
Δέρδου|Δέρδης|n-s---mg-
ἀδελφῶν|ἀδελφός|n-p---mg-
ἄνωθεν|ἄνωθεν|d--------
στρατιᾷ|στρατιά|n-s---fd-
ἐσβεβληκότων|εἰσβάλλω|v-prpamg-
ἀφεστηκυίας|ἀφεστήξω|v-srpafg-
κίνδυνον|κίνδυνος|n-s---ma-
ἐθελοντὰς|ἐθελοντής|n-p---ma-
ἑξακοσίους|ἑξακόσιοι|a-p---ma-
ψιλοὺς|ψιλός|a-p---ma-
τετρακοσίους|τετρακόσιοι|a-p---ma-
Ἀδειμάντου|Ἀδείμαντος|n-s---mg-
φιλίαν|φιλία|n-s---fa-
στρατιῶται|στρατιώτης|n-p---mn-
ἐθελονταὶ|ἐθελοντής|n-p---mn-
ξυνέσποντο|συνέπομαι|v3paim---
Ποτειδεάταις|Ποτειδεάτης|n-p---md-
ἐπιτήδειος|ἐπιτήδειος|a-s---mn-
τεσσαρακοστῇ|τεσσαρακοστός|a-s---fd-
Ποτείδαια|Ποτείδαια|n-s---fn-
ἀπέστη|ἀπίστημι|v3saim---
ἦλθε|ἔρχομαι|v3saia---
ἀγγελία|ἀγγελία|n-s---fn-
ἀφεστᾶσι|ἀφεστήξω|v3pria---
Ἀριστέως|Ἀρίστευς|n-s---mg-
ἐπιπαριόντας|ἐπιπάρειμι|v-pppama-
δισχιλίους|δισχίλιοι|a-p---ma-
ἀφεστῶτα|ἀφεστήξω|v-prpana-
Καλλίαν|Καλλίας|n-s---ma-
Καλλιάδου|Καλλιάδης|n-s---mg-
πέμπτον|πέμπτος|a-s---ma-
στρατηγόν|στρατηγός|n-s---ma-
προτέρους|πρότερος|a-p---ma-
Θέρμην|Θέρμη|n-s---fa-
ἄρτι|ἄρτι|d--------
ᾑρηκότας|αἱρέω|v-prpama-
Πύδναν|Πύδνα|n-s---fa-
ἐπολιόρκησαν|πολιορκέω|v3paia---
ξύμβασιν|σύμβασις|n-s---fa-
ποιησάμενοι|ποιέω|v-papmmn-
ἀναγκαίαν|ἀναγκαῖος|a-s---fa-
κατήπειγεν|κατεπείγω|v3siia---
παρεληλυθώς|παρέρχομαι|v-srpamn-
ἀπανίστανται|ἀπανίστημι|v3ppie---
Μακεδονίας|Μακεδονία|n-s---fg-
Βέροιαν|Βεροία|n-s---fa-
ἀκεῖθεν|ἐκεῖθεν|d--------
Στρέψαν|Στρέψα|n-s---fa-
πειράσαντες|πειράω|v-papamn-
χωρίου|χωρίον|n-s---ng-
ἐπορεύοντο|πορεύω|v3piie---
τρισχιλίοις|τρισχίλιοι|a-p---md-
χωρὶς|χωρίς|d--------
ἱππεῦσι|ἱππεύς|n-p---md-
ἑξακοσίοις|ἑξακόσιοι|a-p---md-
Παυσανίου|Παυσανίας|n-s---mg-
παρέπλεον|παραπλέω|v3piia---
προϊόντες|πρόειμι|v-pppamn-
τριταῖοι|τριταῖος|a-p---mn-
ἀφίκοντο|ἀφικνέομαι|v3paim---
Γίγωνον|Γίγωνος|n-s---ma-
προσδεχόμενοι|προσδέχομαι|v-pppemn-
Ὀλύνθου|Ὄλυνθος|n-s---mg-
ἀγορὰν|ἀγορά|n-s---fa-
ἐπεποίηντο|ποιέω|v3plie---
στρατηγὸν|στρατηγός|n-s---ma-
ᾕρηντο|αἱρέω|v3plie---
Ἀριστέα|Ἀριστεύς|n-s---ma-
ἵππου|ἵππος|n-s---fg-
πάλιν|πάλιν|d--------
ξυνεμάχει|συμμαχέω|v3siia---
Ἰόλαον|Ἰόλαος|n-s---ma-
ἀνθ̓|ἀντί|r--------
αὑτοῦ|ἑαυτοῦ|p-s---mg-
καταστήσας|καθίστημι|v-sapamn-
ἄρχοντα|ἄρχω|v-sppama-
ἔχοντι|ἔχω|v-sppamd-
ἐπιτηρεῖν|ἐπιτηρέω|v--pna---
ἐπίωσι|ἔπειμι|v3ppsa---
ἰσθμοῦ|ἰσθμός|n-s---mg-
διακοσίαν|διακόσιοι|a-s---fa-
ἵππον|ἵππος|n-s---fa-
Ὀλύνθῳ|Ὄλυνθος|n-s---md-
χωρῶσι|χωρέω|v3ppsa---
νώτου|νῶτον|n-s---ng-
βοηθοῦντας|βοηθέω|v-pppama-
μέσῳ|μέσος|a-s---nd-
Καλλίας|Καλλίας|n-s---mn-
στρατηγὸς|στρατηγός|n-s---mn-
ξυνάρχοντες|συνάρχω|v-pppamn-
Μακεδόνας|Μακεδών|n-p---ma-
ἱππέας|ἱππεύς|n-p---ma-
ὀλίγους|ὀλίγος|a-p---ma-
ἀποπέμπουσιν|ἀποπέμπω|v3ppia---
εἴργωσι|ἔργω|v3ppsa---
ἐπιβοηθεῖν|ἐπιβοηθέω|v--pna---
ἀναστήσαντες|ἀνίστημι|v-papamn-
εἶδον|εἶδον|v3paia---
παρασκευαζομένους|παρασκευάζω|v-pppema-
μάχην|μάχη|n-s---fa-
ἀντικαθίσταντο|ἀντικαθίστημι|v3piie---
ξυνέμισγον|συμμίγνυμι|v3piia---
λογάδες|λογάς|n-p---mn-
ἔτρεψαν|τρέπω|v3paia---
ἐπεξῆλθον|ἐπεξέρχομαι|v3paia---
διώκοντες|διώκω|v-pppamn-
πολύ|πολύς|a-s---na-
ἡσσᾶτο|ἡσσάομαι|v3siie---
κατέφυγεν|καταφεύγω|v3saia---
ἐπαναχωρῶν|ἐπαναχωρέω|v-sppamn-
ὁρᾷ|ὁράω|v3spia---
στράτευμα|στράτευμα|n-s---na-
ἡσσημένον|ἡσσάομαι|v-srpena-
ἠπόρησε|ἀπορέω|v3saia---
ὁποτέρωσε|ὁποτέρωσε|d--------
διακινδυνεύσῃ|διακινδυνεύω|v3sasa---
χωρήσας|χωρέω|v-sapamn-
ἔδοξε|δοκέω|v3saia---
ξυναγαγόντι|συνάγω|v-sapamd-
ἐλάχιστον|ἐλάχιστος|a-s---na-
δρόμῳ|δρόμος|n-s---md-
παρῆλθε|παρέρχομαι|v3saia---
χηλὴν|χηλή|n-s---fa-
βαλλόμενός|βάλλω|v-sppemn-
τινας|τις|p-p---ma-
ἀποβαλών|ἀποβάλλω|v-sapamn-
σώσας|σώζω|v-sapamn-
βοηθοί|βοηθός|a-p---mn-
ἀπέχει|ἀπέχω|v3spia---
σταδίους|στάδιον|n-p---ma-
καταφανές|καταφανής|a-s---nn-
βραχὺ|βραχύς|a-s---na-
προῆλθον|προέρχομαι|v3paia---
βοηθήσοντες|βοηθέω|v-pfpamn-
Μακεδόνες|Μακεδών|n-p---mn-
ἱππῆς|ἱππεύς|n-p---mn-
ἀντιπαρετάξαντο|ἀντιπαρατάσσομαι|v3paim---
κωλύσοντες|κωλύω|v-pfpamn-
τάχους|τάχος|n-s---ng-
νίκη|νίκη|n-s---fn-
κατεσπάσθη|κατασπάω|v3saip---
ἐπανεχώρουν|ἐπαναχωρέω|v3piia---
οὐδετέροις|οὐδέτερος|a-p---md-
παρεγένοντο|παραγίγνομαι|v3paim---
ὑποσπόνδους|ὑπόσπονδος|a-p---ma-
ἀπέδοσαν|ἀποδίδωμι|v3paia---
ἀπέθανον|ἀποθνήσκω|v3paia---
τριακοσίων|τριακόσιοι|a-p---mg-
στρατηγός|στρατηγός|n-s---mn-
ἀποτειχίσαντες|ἀποτειχίζω|v-papamn-
ἐφρούρουν|φρουρέω|v3piia---
ἀτείχιστον|ἀτείχιστος|a-s---nn-
ἐνόμιζον|νομίζω|v3piia---
ἔν|ἐν|r--------
φρουρεῖν|φρουρέω|v--pna---
διαβάντες|διαβαίνω|v-papamn-
τειχίζειν|τειχίζω|v--pna---
γενομένοις|γίγνομαι|v-papmmd-
ἐπίθωνται|ἐπιθέω|v3ppse---
Φορμίωνα|Φορμίων|n-s---ma-
Ἀσωπίου|Ἀσώπιος|n-s---mg-
Ἀφύτιος|Ἄφυτις|n-s---fg-
ὁρμώμενος|ὁρμάζω|v-sfpmmn-
προσήγαγε|προσάγω|v3saia---
Ποτειδαίᾳ|Ποτείδαια|n-s---fd-
προϊὼν|πρόειμι|v-sppamn-
κείρων|κείρω|v-sppamn-
ἐπεξῄει|ἐπέξειμι|v3siia---
ἀπετείχισε|ἀποτειχίζω|v3saia---
κράτος|κράτος|n-s---na-
ἀμφοτέρωθεν|ἀμφοτέρωθεν|d--------
ἐπολιορκεῖτο|πολιορκέω|v3siie---
ἐφορμούσαις|ἐφορμέω|v-pppafd-
ἀποτειχισθείσης|ἀποτειχίζω|v-sappfg-
ἐλπίδα|ἐλπίς|n-s---fa-
σωτηρίας|σωτηρία|n-s---fg-
γίγνηται|γίγνομαι|v3spse---
ξυνεβούλευε|συμβουλεύω|v3siia---
πεντακοσίων|πεντακόσιοι|a-p---mg-
ἄνεμον|ἄνεμος|n-s---ma-
τηρήσασι|τηρέω|v-papamd-
ἐκπλεῦσαι|ἐκπλέω|v--ana---
σῖτος|σῖτος|n-s---mn-
ἀντίσχῃ|ἀντέχω|v3sasa---
ἤθελε|ἐθέλω|v3siia---
μενόντων|μένω|v-pppamg-
ἔπειθε|πείθω|v3siia---
βουλόμενος|βούλομαι|v-sppemn-
παρασκευάζειν|παρασκευάζω|v--pna---
ἔξωθεν|ἔξωθεν|d--------
ἔκπλουν|ἔκπλοος|n-s---ma-
ποιεῖται|ποιέω|v3spie---
λαθὼν|λανθάνω|v-sapamn-
παραμένων|παραμένω|v-sppamn-
ξυνεπολέμει|συμπολεμέω|v3siia---
Σερμυλιῶν|Σερμυλιός|n-p---mg-
λοχήσας|λοχάω|v-sapamn-
διέφθειρεν|διαφθείρω|v3saia---
ὠφελία|ὠφέλεια|n-s---fn-
ἀποτείχισιν|ἀποτείχισις|n-s---fa-
Φορμίων|Φορμίων|n-s---mn-
Χαλκιδικὴν|Χαλκιδική|n-s---fa-
Βοττικὴν|Βοττική|n-s---fa-
ἐδῄου|δηιόω|v3siia---
πολίσματα|πόλισμα|n-p---na-
εἷλεν|αἱρέω|v3saia---
προυγεγένηντο|προγίγνομαι|v3plie---
ξυμμαχίδα|συμμαχίς|n-s---fa-
ὑποτελῆ|ὑποτελής|a-s---fa-
ἀπέστησαν|ἀφεστήξω|v3paia---
προυγεγένητο|προγίγνομαι|v3slie---
πόλεμός|πόλεμος|n-s---mn-
ξυνερρώγει|συρράσσω|v3slia---
ἀνοκωχὴ|ἀνοκωχή|n-s---fn-
ἰδίᾳ|ἴδιος|a-s---fd-
πολιορκουμένης|πολιορκέω|v-sppefg-
ἐνόντων|ἐν-εἰμί|v-pppamg-
παρεκάλουν|παρακαλέω|v3piia---
κατεβόων|καταβοάω|v3piia---
λελυκότες|λύω|v-prpamn-
ἀδικοῖεν|ἀδικέω|v3ppoa---
Αἰγινῆταί|Αἰγινήτης|n-p---mn-
πρεσβευόμενοι|πρεσβεύω|v-pppemn-
κρύφα|κρύφα|d--------
ἐνῆγον|ἐνάγω|v3piia---
αὐτόνομοι|αὐτόνομος|a-p---mn-
προσπαρακαλέσαντες|προσπαρακαλέω|v-papamn-
ἔφη|φημί|v3siia---
ἠδικῆσθαι|ἀδικέω|v--rne---
ξύλλογον|σύλλογος|n-s---ma-
εἰωθότα|ἔθω|v-srpama-
παριόντες|πάρειμι|v-pppamn-
Μεγαρῆς|Μεγαρεύς|n-p---mn-
ὀλίγα|ὀλίγος|a-p---na-
λιμένων|λιμήν|n-p---mg-
εἴργεσθαι|ἔργω|v--pne---
ἀγορᾶς|ἀγορά|n-s---fg-
παρελθόντες|παρέρχομαι|v-papamn-
ἐάσαντες|ἐάω|v-papamn-
παροξῦναι|παροξύνω|v--ana---
ἐπεῖπον|ἐπεῖπον|v3paia---
πιστὸν|πιστός|a-s---nn-
πολιτείας|πολιτεία|n-s---fg-
ὁμιλίας|ὁμιλία|n-s---fg-
ἀπιστοτέρους|ἄπιστος|a-p---mac
λέγωμεν|λέγω|v1ppsa---
καθίστησιν|καθιστάω|v3spia---
σωφροσύνην|σωφροσύνη|n-s---fa-
ἔχετε|ἔχω|v2ppia---
ἀμαθίᾳ|ἀμαθία|n-s---fd-
πράγματα|πρᾶγμα|n-p---na-
χρῆσθε|χράω|v2ppie---
πολλάκις|πολλάκις|d--------
προαγορευόντων|προαγορεύω|v-pppamg-
ἐμέλλομεν|μέλλω|v1piia---
βλάπτεσθαι|βλάπτω|v--pne---
ἐδιδάσκομεν|διδάσκω|v1piia---
ἑκάστοτε|ἑκάστοτε|d--------
μάθησιν|μάθησις|n-s---fa-
ἐποιεῖσθε|ποιέω|v2piie---
λεγόντων|λέγω|v-pppamg-
ὑπενοεῖτε|ὑπονοέω|v2piia---
αὑτοῖς|ἑαυτοῦ|p-p---md-
διαφόρων|διάφορος|a-p---ng-
λέγουσιν|λέγω|v3ppia---
ἐσμέν|εἰμί|v1ppia---
παρεκαλέσατε|παρακαλέω|v2paia---
προσήκει|προσήκω|v3spia---
ὑβριζόμενοι|ὑβρίζω|v-pppemn-
ἀμελούμενοι|ἀμελέω|v-pppemn-
ἀφανεῖς|ἀφανής|a-p---mn-
διδασκαλίας|διδασκαλία|n-s---fg-
εἰδόσι|οἶδα|v-prpamd-
προσέδει|προσδέομαι|v3siia---
τί|τίς|x-s---na-
μακρηγορεῖν|μακρηγορέω|v--pna---
δεδουλωμένους|δουλόω|v-prpema-
ὁρᾶτε|ὁράω|v2ppia---
ἐπιβουλεύοντας|ἐπιβουλεύω|v-pppama-
ἡμετέροις|ἡμέτερος|a-p---md-
προπαρεσκευασμένους|προπαρασκευάζω|v-prpema-
πολεμήσονται|πολεμέω|v3pfim---
;|;|u--------
Κέρκυράν|Κέρκυρα|n-s---fa-
ὑπολαβόντες|ὑπολαμβάνω|v-papamn-
ἐπικαιρότατον|ἐπίκαιρος|a-s---nns
ἀποχρῆσθαι|ἀποχράομαι|v--pne---
αἴτιοι|αἴτιος|a-p---mn-
κρατῦναι|κρατύνω|v--ana---
μακρὰ|μακρός|a-p---na-
στῆσαι|ἵστημι|v--ana---
ἀποστεροῦντες|ἀποστερέω|v-pppamn-
ἐλευθερίας|ἐλευθερία|n-s---fg-
ὑμετέρους|ὑμέτερος|a-p---ma-
ἐστέ|εἰμί|v2ppia---
δουλωσάμενος|δουλόω|v-sapmmn-
δυνάμενος|δύναμαι|v-sppemn-
παῦσαι|παύω|v2samm---
περιορῶν|περιοράω|v-sppamn-
δρᾷ|δράω|v3spia---
εἴπερ|εἴπερ|c--------
ἀρετῆς|ἀρετή|n-s---fg-
ἐλευθερῶν|ἐλευθερόω|v-sppamn-
φέρεται|φέρω|v3spie---
ξυνήλθομεν|συνέρχομαι|v1paia---
φανεροῖς|φανερός|a-p---nd-
ἀδικούμεθα|ἀδικέω|v1ppie---
ἀμυνούμεθα|ἀμύνω|v1pfim---
δρῶντες|δράω|v-pppamn-
βεβουλευμένοι|βουλεύω|v-prpemn-
διεγνωκότας|διαγιγνώσκω|v-prpama-
ἐπέρχονται|ἐπέρχομαι|v3ppie---
ἐπιστάμεθα|ἐφίστημι|v1ppie---
οἵᾳ|οἷος|a-s---fd-
ὁδῷ|ὁδός|n-s---fd-
χωροῦσιν|χωρέω|v3ppia---
λανθάνειν|λανθάνω|v--pna---
οἰόμενοι|οἴομαι|v-pppemn-
ἀναίσθητον|ἀναίσθητος|a-s---na-
θαρσοῦσι|θαρσέω|v3ppia---
εἰδότας|οἶδα|v-prpama-
ἰσχυρῶς|ἰσχυρός|d--------
ἐγκείσονται|ἔγκειμαι|v3pfim---
ἡσυχάζετε|ἡσυχάζω|v2ppia---
μόνοι|μόνος|a-p---mn-
τινά|τις|p-s---ma-
μελλήσει|μέλλησις|n-s---fd-
ἀμυνόμενοι|ἀμύνω|v-pppemn-
ἀρχομένην|ἄρχω|v-sppefa-
αὔξησιν|αὔξησις|n-s---fa-
διπλασιουμένην|διπλασιόομαι|v-sppefa-
καταλύοντες|καταλύω|v-pppamn-
ἐλέγεσθε|λέγω|v2piie---
Μῆδον|Μῆδος|n-s---ma-
περάτων|πέρας|n-p---ng-
ἐλθόντα|ἔρχομαι|v-sapama-
ἀξίως|ἄξιος|d--------
προαπαντῆσαι|προαπαντάω|v--ana---
ἑκάς|ἑκάς|d--------
ἐγγὺς|ἐγγύς|d--------
περιορᾶτε|περιοράω|v2ppia---
ἐπιόντας|ἔπειμι|v-pppama-
τύχας|τύχη|n-p---fa-
δυνατωτέρους|δυνατός|a-p---mac
ἀγωνιζόμενοι|ἀγωνίζομαι|v-pppemn-
ἐπιστάμενοι|ἐπίσταμαι|v-pppemn-
αὑτῷ|ἑαυτοῦ|p-s---nd-
σφαλέντα|σφάλλω|v-sappma-
ἁμαρτήμασιν|ἁμάρτημα|n-p---nd-
περιγεγενημένους|περιγίγνομαι|v-prpema-
ὑμέτεραι|ὑμέτερος|a-p---fn-
ἐλπίδες|ἐλπίς|n-p---fn-
τινάς|τις|p-p---ma-
ἀπαρασκεύους|ἀπαράσκευος|a-p---ma-
ἔφθειραν|φθείρω|v3paia---
μηδεὶς|μηδείς|p-s---mn-
ἔχθρᾳ|ἔχθρα|n-s---fd-
φίλων|φίλος|a-p---mg-
ἐστὶν|εἰμί|v3spia---
ἁμαρτανόντων|ἁμαρτάνω|v-pppamg-
κατηγορία|κατηγορία|n-s---fn-
ἀδικησάντων|ἀδικέω|v-papamg-
ἄξιοι|ἄξιος|a-p---mn-
νομίζομεν|νομίζω|v1ppia---
ψόγον|ψόγος|n-s---ma-
ἐπενεγκεῖν|ἐπιφέρω|v--ana---
μεγάλων|μέγας|a-p---ng-
διαφερόντων|διαφέρω|v-pppang-
καθεστώτων|καθίστημι|v-prpang-
αἰσθάνεσθαι|αἰσθάνομαι|v--pne---
δοκεῖτε|δοκέω|v2ppia---
ἐκλογίσασθαι|ἐκλογίζομαι|v--ane---
οἵους|οἷος|a-p---ma-
πᾶν|πᾶς|a-s---na-
διαφέροντας|διαφέρω|v-pppama-
ἀγὼν|ἀγών|n-s---mn-
νεωτεροποιοὶ|νεωτεροποιός|a-p---mn-
ἐπινοῆσαι|ἐπινοέω|v--ana---
ὀξεῖς|ὀξύς|a-p---mn-
ἐπιτελέσαι|ἐπιτελέω|v--ana---
γνῶσιν|γιγνώσκω|v3pasa---
ὑπάρχοντά|ὑπάρχω|v-pppana-
σῴζειν|σώζω|v--pna---
ἐπιγνῶναι|ἐπιγιγνώσκω|v--ana---
ἀναγκαῖα|ἀναγκαῖος|a-p---na-
ἐξικέσθαι|ἐξικνέομαι|v--anm---
τολμηταὶ|τολμητής|n-p---mn-
γνώμην|γνώμη|n-s---fa-
κινδυνευταὶ|κινδυνευτής|n-p---mn-
δεινοῖς|δεινός|a-p---nd-
εὐέλπιδες|εὔελπις|n-p---mn-
ὑμέτερον|ὑμέτερος|a-s---nn-
ἐνδεᾶ|ἐνδεής|a-p---na-
πρᾶξαι|πράσσω|v--ana---
βεβαίοις|βέβαιος|a-p---nd-
δεινῶν|δεινός|a-p---ng-
μηδέποτε|μηδέποτε|d--------
οἴεσθαι|οἴομαι|v--pne---
ἀπολυθήσεσθαι|ἀπολύω|v--fnp---
ἄοκνοι|ἄοκνος|a-p---mn-
μελλητὰς|μελλητής|n-p---ma-
ἀποδημηταὶ|ἀποδημητής|n-p---mn-
ἐνδημοτάτους|ἔνδημος|a-p---mas
ἀπουσίᾳ|ἀπουσία|n-s---fd-
κτᾶσθαι|κτάομαι|v--pne---
κρατοῦντές|κρατέω|v-pppamn-
ἐξέρχονται|ἐξέρχομαι|v3ppie---
νικώμενοι|νικάω|v-pppemn-
ἀναπίπτουσιν|ἀναπίπτω|v3ppia---
σώμασιν|σῶμα|n-p---nd-
ἀλλοτριωτάτοις|ἀλλότριος|a-p---nds
οἰκειοτάτῃ|οἰκεῖος|a-s---fds
πράσσειν|πράσσω|v--pna---
ἐπινοήσαντες|ἐπινοέω|v-papamn-
ἐπεξέλθωσιν|ἐπεξέρχομαι|v3pasa---
οἰκείων|οἰκεῖος|a-p---ng-
στέρεσθαι|στέρομαι|v--pne---
κτήσωνται|κτάομαι|v3pasm---
τυχεῖν|τυγχάνω|v--ana---
πράξαντες|πράσσω|v-papamn-
του|τις|p-s---ng-
πείρᾳ|πεῖρα|n-s---fd-
σφαλῶσιν|σφάλλω|v3pasp---
ἀντελπίσαντες|ἀντελπίζω|v-papamn-
ἐπλήρωσαν|πληρόω|v3paia---
ἔχουσί|ἔχω|v3ppia---
ἐλπίζουσιν|ἐλπίζω|v3ppia---
ἐπινοήσωσι|ἐπινοέω|v3pasa---
πόνων|πόνος|n-p---mg-
ὅλου|ὅλοξ|a-s---mg-
αἰῶνος|αἰών|n-s---mg-
μοχθοῦσι|μοχθόω|v3ppia---
ἀπολαύουσιν|ἀπολαύω|v3ppia---
ὑπαρχόντων|ὑπάρχω|v-pppang-
ἑορτὴν|ἑορτή|n-s---fa-
ἡγεῖσθαι|ἡγέομαι|v--pne---
ξυμφοράν|συμφορά|n-s---fa-
ἡσυχίαν|ἡσυχία|n-s---fa-
ἀπράγμονα|ἀπράγμων|a-s---fa-
ἀσχολίαν|ἀσχολία|n-s---fa-
ἐπίπονον|ἐπίπονος|a-s---fa-
ξυνελὼν|συναιρέω|v-sapamn-
φαίη|φημί|v3spoa---
πεφυκέναι|φύω|v--rna---
εἴποι|εἶπον|v3saoa---
ταύτης|οὗτος|a-s---fg-
τοιαύτης|τοιοῦτος|a-s---fg-
ἀντικαθεστηκυίας|ἀντικαθίστημι|v-srpafg-
διαμέλλετε|διαμέλλω|v2ppia---
οἴεσθε|οἴομαι|v2ppie---
ἀρκεῖν|ἀρκέω|v--pna---
πράσσωσι|πράσσω|v3ppsa---
ἀδικῶνται|ἀδικέω|v3ppse---
δῆλοι|δῆλος|a-p---mn-
ὦσι|εἰμί|v3ppsa---
ἐπιτρέψοντες|ἐπιτρέπω|v-pfpamn-
λυπεῖν|λυπέω|v--pna---
νέμετε|νέμω|v2ppia---
παροικοῦντες|παροικέω|v-pppamn-
ἐτυγχάνετε|τυγχάνω|v2piia---
ἐδηλώσαμεν|δηλόω|v1paia---
ἀρχαιότροπα|ἀρχαιότροπος|a-p---nn-
ἐπιτηδεύματα|ἐπιτήδευμα|n-p---nn-
τέχνης|τέχνη|n-s---fg-
ἐπιγιγνόμενα|ἐπιγίγνομαι|v-pppenn-
ἡσυχαζούσῃ|ἡσυχάζω|v-sppafd-
ἀκίνητα|ἀκίνητος|a-p---nn-
νόμιμα|νόμιμος|a-p---nn-
ἀναγκαζομένοις|ἀναγκάζω|v-pppemd-
ἐπιτεχνήσεως|ἐπιτέχνησις|n-s---fg-
πολυπειρίας|πολυπειρία|n-s---fg-
κεκαίνωται|καινόω|v3srie---
ὡρίσθω|ὁρίζω|v3srme---
βραδυτής|βραδυτής|n-s---fn-
ὑπεδέξασθε|ὑποδέχομαι|v2paim---
βοηθήσατε|βοηθέω|v2pama---
τάχος|τάχος|n-s---na-
ἐσβαλόντες|εἰσβάλλω|v-papamn-
Ἀττικήν|Ἀττική|n-s---fa-
ἐχθίστοις|ἔχθιστος|a-p---md-
προῆσθε|προίημι|v2pasa---
ἀθυμίᾳ|ἀθυμία|n-s---fd-
ἑτέραν|ἕτερος|a-s---fa-
τρέψητε|τρέπω|v2pasa---
δρῷμεν|δράω|v1ppoa---
ἄδικον|ἄδικος|a-s---na-
θεῶν|θεός|n-p---mg-
ὁρκίων|ὅρκιον|n-p---ng-
αἰσθανομένων|αἰσθάνομαι|v-pppemg-
λύουσι|λύω|v3ppia---
ἐρημίαν|ἐρημία|n-s---fa-
προσιόντες|πρόσειμι|v-pppamn-
βοηθοῦντες|βοηθέω|v-pppamn-
ξυνομόσωσιν|συνόμνυμι|v3pasa---
προθύμων|πρόθυμος|a-p---mg-
μενοῦμεν|μένω|v1pfia---
ὅσια|ὅσιος|a-p---na-
ποιοῖμεν|ποιέω|v1ppoa---
μεταβαλλόμενοι|μεταβάλλω|v-pppemn-
ξυνηθεστέρους|συνήθης|a-p---mac
εὕροιμεν|εὑρίσκω|v1paoa---
βουλεύεσθε|βουλεύω|v2ppme---
πειρᾶσθε|πειράω|v2ppme---
ἐξηγεῖσθαι|ἐξηγέομαι|v--pne---
πατέρες|πατήρ|n-p---mn-
ἔτυχε|τυγχάνω|v3saia---
πρεσβεία|πρεσβεία|n-s---fn-
παροῦσα|πάρειμι|v-sppafn-
λόγων|λόγος|n-p---mg-
παριτητέα|παριτητέα|a-p---na-
ἀπολογησομένους|ἀπολογέομαι|v-pfpmma-
ἐνεκάλουν|ἐγκαλέω|v3piia---
δηλῶσαι|δηλόω|v--ana---
ταχέως|ταχέως|d--------
βουλευτέον|βουλευτέον|a-s---nn-
σκεπτέον|σκεπτέος|a-s---nn-
σφετέραν|σφέτερος|a-s---fa-
σημῆναι|σημαίνω|v--ana---
ὅση|ὅσος|a-s---fn-
ὑπόμνησιν|ὑπόμνησις|n-s---fa-
πρεσβυτέροις|πρέσβυς|a-p---mdc
ᾔδεσαν|οἶδα|v3plia---
νεωτέροις|νεώτερος|a-p---md-
ἐξήγησιν|ἐξήγησις|n-s---fa-
ἄπειροι|ἄπειρος|a-p---mn-
ἡσυχάζειν|ἡσυχάζω|v--pna---
τραπέσθαι|τρέπω|v--anm---
προσελθόντες|προσέρχομαι|v-papamn-
βούλεσθαι|βούλομαι|v--pne---
ἀποκωλύοι|ἀποκωλύω|v3spoa---
ἐκέλευόν|κελεύω|v3piia---
παριέναι|παρίημι|v--pna---
πρέσβευσις|πρέσβευσις|n-s---fn-
ὑμετέροις|ὑμέτερος|a-p---md-
ἔπεμψεν|πέμπω|v3saia---
αἰσθανόμενοι|αἰσθάνομαι|v-pppemn-
καταβοὴν|καταβοή|n-s---fa-
ὀλίγην|ὀλίγος|a-s---fa-
παρήλθομεν|παρέρχομαι|v1paia---
ἐγκλήμασι|ἔγκλημα|n-p---nd-
ἀντεροῦντες|ἀντερῶ|v-pfpamn-
δικασταῖς|δικαστής|n-p---md-
λόγοι|λόγος|n-p---mn-
γίγνοιντο|γίγνομαι|v3ppoe---
βουλεύσησθε|βουλεύω|v2pasm---
καθεστῶτος|καθίστημι|v-srpamg-
ἀπεικότως|ἀπεικότως|d--------
ἀξία|ἄξιος|a-s---fn-
ἀκοαὶ|ἀκοή|n-p---fn-
μάρτυρες|μάρτυς|n-p---mn-
ὄψις|ὄψις|n-s---fn-
ἀκουσομένων|ἀκούω|v-pfpmmg-
ξύνιστε|σύνοιδα|v2pria---
προβαλλομένοις|προβάλλω|v-pppemd-
ἐδρῶμεν|δράω|v1piia---
ἐκινδυνεύετο|κινδυνεύω|v3siie---
ἧς|ὅς|p-s---fg-
μετέσχετε|μετέχω|v2paia---
παντός|πᾶς|a-s---mg-
ὠφελεῖ|ὠφελέω|v3spia---
στερισκώμεθα|στερίσκω|v1ppse---
ῥηθήσεται|ἐρῶ|v3sfip---
παραιτήσεως|παραίτησις|n-s---fg-
δηλώσεως|δήλωσις|n-s---fg-
οἵαν|οἷος|a-s---fa-
βουλευομένοις|βουλεύω|v-pppemd-
καταστήσεται|καθίστημι|v3sfim---
Μαραθῶνί|Μαραθών|n-s---md-
προκινδυνεῦσαι|προκινδυνεύω|v--ana---
βαρβάρῳ|βάρβαρος|n-s---md-
πανδημεὶ|πανδημεί|d--------
Σαλαμῖνι|Σαλαμίς|n-s---fd-
ξυνναυμαχῆσαι|συνναυμαχέω|v--ana---
ἔσχε|ἔχω|v3saia---
ἐπιπλέοντα|ἐπιπλέω|v-sppama-
πορθεῖν|πορθέω|v--pna---
ἀδυνάτων|ἀδύνατος|a-p---mg-
ἐποίησεν|ποιέω|v3saia---
νικηθεὶς|νικάω|v-sappmn-
ὁμοίας|ὅμοιος|a-s---fg-
στρατοῦ|στρατός|n-s---mg-
τοιούτου|τοιοῦτος|a-s---ng-
ξυμβάντος|συμβαίνω|v-sapang-
δηλωθέντος|δηλόω|v-sappng-
ὠφελιμώτατα|ὠφέλιμος|a-p---nas
παρεσχόμεθα|παρέχω|v1paim---
ἀριθμόν|ἀριθμός|n-s---ma-
ἄνδρα|ἀνήρ|n-s---ma-
ξυνετώτατον|συνετός|a-s---mas
προθυμίαν|προθυμία|n-s---fa-
ἀοκνοτάτην|ἄοκνος|a-s---fas
τετρακοσίας|τετρακόσιοι|a-p---fa-
μοιρῶν|μοῖρα|n-p---fg-
Θεμιστοκλέα|Θεμιστοκλῆς|n-s---ma-
αἰτιώτατος|αἴτιος|a-s---mns
στενῷ|στενός|a-s---nd-
ναυμαχῆσαι|ναυμαχέω|v--ana---
ἔσωσε|σώζω|v3saia---
ἐτιμήσατε|τιμάω|v2paia---
ξένον|ξένος|a-s---ma-
τολμηροτάτην|τολμηρός|a-s---fas
ἐδείξαμεν|δείκνυμι|v1paia---
ἐβοήθει|βοηθέω|v3siia---
δουλευόντων|δουλεύω|v-pppamg-
ἠξιώσαμεν|ἀξιόω|v1paia---
ἐκλιπόντες|ἐκλείπω|v-papamn-
περιλοίπων|περίλοιπος|a-p---mg-
προλιπεῖν|προλείπω|v--ana---
σκεδασθέντες|σκεδάννυμι|v-pappmn-
ἀχρεῖοι|ἀχρεῖος|a-p---mn-
ὀργισθῆναι|ὀργίζω|v--anp---
προυτιμωρήσατε|προτιμωρέω|v2paia---
ὠφελῆσαι|ὠφελέω|v--ana---
οἰκουμένων|οἰκέω|v-pppefg-
ἐδείσατε|δείδω|v2paia---
ἐβοηθήσατε|βοηθέω|v2paia---
ἦμεν|εἰμί|v1piia---
σῶοι|σῶς|a-p---mn-
παρεγένεσθε|παραγίγνομαι|v2paim---
ὁρμώμενοι|ὁρμάω|v-pppemn-
βραχείᾳ|βραχύς|a-s---fd-
ἐλπίδι|ἐλπίς|n-s---fd-
κινδυνεύοντες|κινδυνεύω|v-pppamn-
ξυνεσώσαμεν|συσσῴζω|v1paia---
προσεχωρήσαμεν|προσχωρέω|v1paia---
Μήδῳ|Μῆδος|n-s---md-
χώρᾳ|χώρα|n-s---fd-
ἐτολμήσαμεν|τολμάω|v1paia---
ἐσβῆναι|εἰσβαίνω|v--ana---
διεφθαρμένοι|διαφθείρω|v-prpemn-
ἔδει|δέω|v3siia---
ἱκανὰς|ἱκανός|a-p---fa-
προυχώρησε|προχωρέω|v3saia---
ἐβούλετο|βούλομαι|v3siie---
ἆῤ|ἆρα|d--------
ἄξιοί|ἄξιος|a-p---mn-
προθυμίας|προθυμία|n-s---fg-
ξυνέσεως|σύνεσις|n-s---fg-
ἄγαν|ἄγαν|d--------
ἐπιφθόνως|ἐπίφθονος|d--------
διακεῖσθαι|διάκειμαι|v--pne---
τήνδε|ὅδε|p-s---fa-
ἐλάβομεν|λαμβάνω|v1paia---
βιασάμενοι|βιάω|v-papmmn-
ἐθελησάντων|ἐθέλω|v-papamg-
παραμεῖναι|παραμένω|v--ana---
ὑπόλοιπα|ὑπόλοιπος|a-p---na-
προσελθόντων|προσέρχομαι|v-papamg-
δεηθέντων|δέω|v-pappmg-
κατηναγκάσθημεν|καταναγκάζω|v1paip---
προαγαγεῖν|προάγω|v--ana---
δέους|δέος|n-s---ng-
τιμῆς|τιμή|n-s---fg-
ἀσφαλὲς|ἀσφαλής|a-s---nn-
ἀπηχθημένους|ἀπό-ἀχθέω|v-prpema-
κατεστραμμένων|καταστρέφω|v-prpemg-
ὑπόπτων|ὕποπτος|a-p---mg-
ἀνέντας|ἀνίημι|v-papama-
κινδυνεύειν|κινδυνεύω|v--pna---
ἀνεπίφθονον|ἀνεπίφθονος|a-s---nn-
τίθεσθαι|τίθημι|v--pne---
ὠφέλιμον|ὠφέλιμος|a-s---na-
καταστησάμενοι|καθίστημι|v-papmmn-
ἐξηγεῖσθε|ἐξηγέομαι|v2ppie---
ὑπομείναντες|ὑπομένω|v-papamn-
ἀπήχθεσθε|ἀπεχθάνομαι|v2paim---
ἡγεμονίᾳ|ἡγεμονία|n-s---fd-
λυπηροὺς|λυπηρός|a-p---ma-
γενομένους|γίγνομαι|v-papmma-
ἀναγκασθέντας|ἀναγκάζω|v-pappma-
ἐγκρατῶς|ἐγκρατής|d--------
θαυμαστὸν|θαυμαστός|a-s---na-
πεποιήκαμεν|ποιέω|v1pria---
ἀνθρωπείου|ἀνθρώπειος|a-s---mg-
ἀρχήν|ἀρχή|n-s---fa-
διδομένην|δίδωμι|v-sppefa-
ἐδεξάμεθα|δέχομαι|v1paim---
ἀνεῖμεν|ἀνέω|v1ppoa---
νικηθέντες|νικάω|v-pappmn-
ὑπάρξαντες|ὑπάρχω|v-papamn-
ἥσσω|ἥσσων|a-s---mac
δυνατωτέρου|δυνατός|a-s---mgc
κατείργεσθαι|κατείργω|v--pne---
δοκοῦντες|δοκέω|v-pppamn-
λογιζόμενοι|λογίζομαι|v-pppemn-
δικαίῳ|δίκαιος|a-s---md-
ὃν|ὅς|p-s---na-
οὐδείς|οὐδείς|p-s---mn-
παρατυχὸν|παρατυγχάνω|v-sapana-
ἰσχύι|ἰσχύς|n-s---fd-
προθεὶς|προτίθημι|v-sapamn-
ἀπετράπετο|ἀποτρέπω|v3saim---
ἐπαινεῖσθαί|ἐπαινέω|v--pne---
οἵτινες|ὅστις|p-p---mn-
ἀνθρωπείᾳ|ἀνθρώπειος|a-s---fd-
φύσει|φύσις|n-s---fd-
δικαιότεροι|δίκαιος|a-p---mnc
ὑπάρχουσαν|ὑπάρχω|v-sppafa-
γένωνται|γίγνομαι|v3pasm---
οἰόμεθα|οἴομαι|v1ppie---
λαβόντας|λαμβάνω|v-papama-
δεῖξαι|δείκνυμι|v--ana---
μετριάζομεν|μετριάζω|v1ppia---
ἐπιεικοῦς|ἐπιεικής|a-s---ng-
ἀδοξία|ἀδοξία|n-s---fn-
ἔπαινος|ἔπαινος|n-s---mn-
περιέστη|περιίστημι|v3saia---
ἐλασσούμενοι|ἐλασσόω|v-pppemn-
ξυμβολαίαις|συμβόλαιος|a-p---fd-
δίκαις|δίκη|n-p---fd-
νόμοις|νόμος|n-p---md-
κρίσεις|κρίσις|n-p---fa-
φιλοδικεῖν|φιλοδικέω|v--pna---
δοκοῦμεν|δοκέω|v1ppia---
σκοπεῖ|σκοπέω|v3spia---
ἄλλοθί|ἄλλοθι|d--------
ἔχουσι|ἔχω|v-pppamd-
μετρίοις|μέτριος|a-p---md-
ὀνειδίζεται|ὀνειδίζω|v3spie---
βιάζεσθαι|βιάζω|v--pne---
ἐξῇ|ἔξεστι|v3spsa---
προσδέονται|προσδέομαι|v3ppie---
εἰθισμένοι|ἐθίζω|v-prpemn-
ἴσου|ἴσος|a-s---ng-
ὁμιλεῖν|ὁμιλέω|v--pna---
ὁπωσοῦν|ὁπωσοῦν|d--------
ἐλασσωθῶσιν|ἐλασσόω|v3pasp---
πλέονος|πλείων|a-s---ngc
στερισκόμενοι|στερίσκω|v-pppemn-
ἐνδεοῦς|ἐνδεής|a-s---ng-
χαλεπώτερον|χαλεπός|a-s---nac
φέρουσιν|φέρω|v3ppia---
πρώτης|πρῶτος|a-s---fg-
ἀποθέμενοι|ἀποτίθημι|v-papmmn-
ἐπλεονεκτοῦμεν|πλεονεκτέω|v1piia---
ἐκείνως|ἐκεῖνος|d-p---ma-
χρεὼν|χρεών|x--------
κρατοῦντι|κρατέω|v-sppamd-
ὑποχωρεῖν|ὑποχωρέω|v--pna---
ἀδικούμενοί|ἀδικέω|v-pppemn-
ἔοικεν|ἔοικα|v3sria---
ὀργίζονται|ὀργίζω|v3ppie---
πλεονεκτεῖσθαι|πλεονεκτέω|v--pne---
κρείσσονος|κρείσσων|a-s---ngc
καταναγκάζεσθαι|καταναγκάζω|v--pne---
Μήδου|Μῆδος|n-s---mg-
δεινότερα|δεινός|a-p---nac
πάσχοντες|πάσχω|v-pppamn-
ἠνείχοντο|ἀνέχω|v3piie---
ἡμετέρα|ἡμέτερος|a-s---fn-
ἀρχὴ|ἀρχή|n-s---fn-
χαλεπὴ|χαλεπός|a-s---fn-
παρὸν|πάρειμι|v-sppann-
βαρὺ|βαρύς|a-s---nn-
ὑπηκόοις|ὑπήκοος|a-p---md-
καθελόντες|καθαιρέω|v-papamn-
ἄρξαιτε|ἄρχω|v2paoa---
τάχα|τάχα|d--------
εὔνοιαν|εὔνοια|n-s---fa-
δέος|δέος|n-s---na-
εἰλήφατε|λαμβάνω|v2pria---
μεταβάλοιτε|μεταβάλλω|v2paoa---
ὀλίγου|ὀλίγος|a-s---ng-
ἡγησάμενοι|ἡγέομαι|v-papmmn-
ὑπεδείξατε|ὑποδείκνυμι|v2paia---
γνώσεσθε|γιγνώσκω|v2pfim---
ἄμεικτα|ἄμεικτος|a-p---na-
ἕκαστος|ἕκαστος|a-s---mn-
ἐξιὼν|ἔξειμι|v-sppamn-
χρῆται|χράομαι|v3spie---
οὔθ̓|οὔτε|c--------
ἄλλη|ἄλλος|a-s---fn-
νομίζει|νομίζω|v3spia---
βραδέως|βραδύς|d--------
βραχέων|βραχύς|a-p---ng-
ἀλλοτρίαις|ἀλλότριος|a-p---fd-
γνώμαις|γνώμη|n-p---fd-
πεισθέντες|πείθω|v-pappmn-
πόνον|πόνος|n-s---ma-
πρόσθησθε|προστίθημι|v2pasa---
παράλογον|παράλογος|n-s---ma-
ὅσος|ὅσος|a-s---mn-
ἐστί|εἰμί|v3spia---
προδιάγνωτε|προδιαγιγνώσκω|v2pama---
μηκυνόμενος|μηκύνω|v-sppemn-
φιλεῖ|φιλέω|v3spia---
περιίστασθαι|περιίστημι|v--pne---
ἀπέχομεν|ἀπέχω|v1ppia---
ὁποτέρως|ὁπότερος|d--------
ἀδήλῳ|ἄδηλος|a-s---nd-
κινδυνεύεται|κινδυνεύω|v3spie---
ἔχονται|ἔχω|v3ppie---
κακοπαθοῦντες|κακοπαθέω|v-pppamn-
ἅπτονται|ἅπτω|v3ppie---
οὐδεμιᾷ|οὐδείς|a-s---fd-
οὔτ̓|οὔτε|d--------
λέγομεν|λέγω|v1ppia---
αὐθαίρετος|αὐθαίρετος|a-s---fn-
εὐβουλία|εὐβουλία|n-s---fn-
παραβαίνειν|παραβαίνω|v--pna---
ὅρκους|ὅρκος|n-p---ma-
λύεσθαι|λύω|v--pne---
ξυνθήκην|συνθήκη|n-s---fa-
θεοὺς|θεός|n-p---ma-
ὁρκίους|ὅρκιος|a-p---ma-
μάρτυρας|μάρτυς|n-p---ma-
πειρασόμεθα|πειράω|v1pfim---
ἄρχοντας|ἄρχω|v-pppama-
ὑφηγῆσθε|ὑφηγέομαι|v2ppse---
ἤκουσαν|ἀκούω|v3paia---
μεταστησάμενοι|μεθίστημι|v-papmmn-
ἐβουλεύοντο|βουλεύω|v3piie---
πλεόνων|πλείων|a-p---mgc
γνῶμαι|γνώμη|n-p---fn-
πολεμητέα|πολεμητέος|a-p---na-
τάχει|ταχύς|a-s---nd-
παρελθὼν|παρέρχομαι|v-sapamn-
Ἀρχίδαμος|Ἀρχίδαμος|n-s---mn-
ἀνὴρ|ἀνήρ|n-s---mn-
ξυνετὸς|συνετός|a-s---mn-
δοκῶν|δοκέω|v-sppamn-
σώφρων|σώφρων|a-s---mn-
ἔλεξε|λέγω|v3saia---
πολέμων|πόλεμος|n-p---mg-
ἔμπειρός|ἔμπειρος|a-s---mn-
εἰμι|εἰμί|v1spia---
ἡλικίᾳ|ἡλικία|n-s---fd-
ὁρῶ|ὁράω|v1spia---
ἀπειρίᾳ|ἀπειρία|n-s---fd-
ἐπιθυμῆσαί|ἐπιθυμέω|v--ana---
πάθοιεν|πάσχω|v3paoa---
ἀγαθὸν|ἀγαθός|a-s---na-
νομίσαντα|νομίζω|v-sapama-
εὕροιτε|εὑρίσκω|v2paoa---
σωφρόνως|σώφρων|d--------
ἐκλογίζοιτο|ἐκλογίζομαι|v3spoe---
ἀστυγείτονας|ἀστυγείτων|a-p---ma-
παρόμοιος|παρόμοιος|a-s---fn-
ἀλκή|ἀλκή|n-s---fn-
ταχέων|ταχύς|a-p---ng-
οἷόν|οἷος|a-s---nn-
ἕκαστα|ἕκαστος|a-p---na-
ἑκὰς|ἑκάς|d--------
ἐμπειρότατοί|ἔμπειρος|a-p---mns
ἐξήρτυνται|ἐξαρτύω|v3prie---
πλούτῳ|πλοῦτος|n-s---md-
ἰδίῳ|ἴδιος|a-s---md-
δημοσίῳ|δημόσιος|a-s---md-
ἵπποις|ἵππος|n-p---md-
ὅπλοις|ὅπλον|n-p---nd-
ὄχλῳ|ὄχλος|n-s---md-
ἄλλῳ|ἄλλος|a-s---nd-
ἑνί|εἷς|n-s---nd-
Ἑλληνικῷ|Ἑλληνικός|a-s---nd-
πῶς|πως|d--------
ἄρασθαι|αἴρω|v--anm---
τίνι|τις|p-s---nd-
πιστεύσαντας|πιστεύω|v-papama-
ἐπειχθῆναι|ἐπείγω|v--anp---
πότερον|πότερος|a-s---na-
μελετήσομεν|μελετάω|v1pasa---
ἀντιπαρασκευασόμεθα|ἀντιπαρασκευάζομαι|v1pase---
ἐνέσται|ἐν-εἰμί|v3sfim---
χρήμασιν|χρῆμα|n-p---nd-
ἐλλείπομεν|ἐλλείπω|v1ppia---
ἑτοίμως|ἑτοῖμος|d--------
ἰδίων|ἴδιος|a-p---ng-
φέρομεν|φέρω|v1ppia---
τάχ̓|τάχα|d--------
θαρσοίη|θαρσέω|v3spoa---
ὑπερφέρομεν|ὑπερφέρω|v1ppia---
δῃοῦν|δηιόω|v3piia---
ἐπιφοιτῶντες|ἐπιφοιτάω|v-pppamn-
γῆ|γῆ|n-s---fn-
πολλὴ|πολύς|a-s---fn-
ἐπάξονται|ἐπάγω|v3pfim---
ἀφιστάναι|ἀφεστήξω|v--pna---
δεήσει|δέω|v3sfia---
νησιώταις|νησιώτης|n-p---md-
κρατήσομεν|κρατέω|v1pfia---
ἀφαιρήσομεν|ἀφαιρέω|v1pfia---
τρέφουσι|τρέφω|v3ppia---
βλαψόμεθα|βλάπτω|v1pfim---
ἀν|ἐάν|c--------
καταλύεσθαι|καταλύω|v--pne---
καλόν|καλός|a-s---nn-
δόξομεν|δοκέω|v1pfia---
ἄρξαι|ἄρχω|v--ana---
διαφορᾶς|διαφορά|n-s---fg-
ἐπαιρώμεθα|ἐπαίρω|v1ppse---
ταχὺ|ταχύς|a-s---na-
παυσθήσεται|παύω|v3sfip---
τέμωμεν|τέμνω|v1pasa---
δέδοικα|δείδω|v1sria---
παισὶν|παῖς|n-p---md-
ὑπολίπωμεν|ὑπολείπω|v1pasa---
φρονήματι|φρόνημα|n-s---nd-
δουλεῦσαι|δουλεύω|v--ana---
ἀπείρους|ἄπειρος|a-p---ma-
καταπλαγῆναι|καταπλήσσω|v--anp---
ἀναισθήτως|ἀναίσθητος|d--------
κελεύω|κελεύω|v1spia---
καταφωρᾶν|καταφωράω|v--pna---
μήπω|μήπω|d--------
κινεῖν|κινέω|v--pna---
αἰτιᾶσθαι|αἰτιάομαι|v--pne---
δηλοῦντας|δηλόω|v-pppama-
μήθ̓|μήτε|c--------
ἐπιτρέψομεν|ἐπιτρέπω|v1pasa---
ἡμέτεῤ|ἡμέτερος|a-p---na-
ἐξαρτύεσθαι|ἐξαρτύω|v--pne---
προσαγωγῇ|προσαγωγή|n-s---fd-
ποθέν|ποθεν|d--------
προσληψόμεθα|προσλαμβάνω|v1pfim---
ἐπιβουλευόμεθα|ἐπιβουλεύω|v1ppie---
προσλαβόντας|προσλαμβάνω|v-papama-
διασωθῆναἰ|διασῴζω|v--anp---
ἐκποριζώμεθα|ἐκπορίζω|v1ppse---
ἐσακούωσί|εἰσακούω|v3ppsa---
πρεσβευομένων|πρεσβεύω|v-pppemg-
διελθόντων|διέρχομαι|v-papang-
ἐτῶν|ἔτος|n-p---ng-
ἄμεινον|ἀμείνων|a-s---nac
δοκῇ|δοκέω|v3spsa---
πεφραγμένοι|φράζω|v-prpemn-
ἴμεν|εἶμι|v1ppia---
ἐσακούωσι|εἰσακούω|v3ppsa---
ὑποσημαίνοντας|ὑποσημαίνω|v-pppama-
εἴκοιεν|εἴκω|v3ppoa---
ἄτμητον|ἄτμητος|a-s---fa-
ἀγαθῶν|ἀγαθός|a-p---ng-
ἐφθαρμένων|φθείρω|v-prpeng-
βουλευόμενοι|βουλεύω|v-pppemn-
νομίσητε|νομίζω|v2pasa---
ὅμηρον|ὅμηρος|n-s---ma-
ἐξείργασται|ἐξεργάζομαι|v3srie---
φείδεσθαι|φείδομαι|v--pne---
ἀπόνοιαν|ἀπόνοια|n-s---fa-
καταστήσαντας|καθίστημι|v-papama-
ἀληπτοτέρους|ἄληπτος|a-p---mac
ἀπαράσκευοι|ἀπαράσκευος|a-p---mn-
ἐγκλήμασιν|ἔγκλημα|n-p---nd-
ἐπειχθέντες|ἐπείγω|v-pappmn-
τεμοῦμεν|τέμνω|v1pfia---
αἴσχιον|αἰσχρός|a-s---nac
ἀπορώτερον|ἄπορος|a-s---nac
πράξομεν|πράσσω|v1pfia---
ἰδιωτῶν|ἰδιώτης|n-p---mg-
ἀραμένους|αἴρω|v-papmma-
ὑπάρχει|ὑπάρχω|v3spia---
χωρήσει|χωρέω|v3sfia---
ῥᾴδιον|ῥᾴδιος|a-s---nn-
εὐπρεπῶς|εὐπρεπής|d--------
ἀνανδρία|ἀνανδρία|n-s---fn-
μηδενὶ|μηδείς|a-s---fd-
δοκείτω|δοκέω|v3spma---
ἐκείνοις|ἐκεῖνος|p-p---md-
θαλασσίους|θαλάσσιος|a-p---ma-
πορισώμεθα|πορίζω|v1pasm---
λόγοις|λόγος|n-p---md-
ἀποβαινόντων|ἀποβαίνω|v-pppang-
προΐδωμεν|προεῖδον|v1pasa---
βραδὺ|βραδύς|a-s---na-
μέμφονται|μέμφομαι|v3ppie---
αἰσχύνεσθε|αἰσχύνω|v2ppme---
σπεύδοντές|σπεύδω|v-pppamn-
σχολαίτερον|σχολαῖος|a-s---nac
παύσαισθε|παύω|v2paom---
ἐγχειρεῖν|ἐγχειρέω|v--pna---
ἐλευθέραν|ἐλεύθερος|a-s---fa-
εὐδοξοτάτην|εὔδοξος|a-s---fas
νεμόμεθα|νέμω|v1ppie---
ἔμφρων|ἔμφρων|a-s---fn-
τοῦτ̓|οὗτος|p-s---nn-
εὐπραγίαις|εὐπραγία|n-p---fd-
ἐξυβρίζομεν|ἐξυβρίζω|v1ppia---
ξυμφοραῖς|συμφορά|n-p---fd-
εἴκομεν|εἴκω|v1ppia---
ἐπαίνῳ|ἔπαινος|n-s---md-
ἐξοτρυνόντων|ἐξοτρύνω|v-pppamg-
δεινὰ|δεινός|a-p---na-
δοκοῦν|δοκόω|v--pna---
ἐπαιρόμεθα|ἐπαίρω|v1ppie---
ἡδονῇ|ἡδονή|n-s---fd-
κατηγορίᾳ|κατηγορία|n-s---fd-
παροξύνῃ|παροξύνω|v3spsa---
ἀχθεσθέντες|ἄχθομαι|v-pappmn-
ἀνεπείσθημεν|ἀναπείθω|v1paip---
πολεμικοί|πολεμικός|a-p---mn-
εὔβουλοι|εὔβουλος|a-p---mn-
εὔκοσμον|εὔκοσμος|a-s---na-
γιγνόμεθα|γίγνομαι|v1ppie---
αἰδὼς|αἰδώς|n-s---fn-
σωφροσύνης|σωφροσύνη|n-s---fg-
μετέχει|μετέχω|v3spia---
αἰσχύνης|αἰσχύνη|n-s---fg-
εὐψυχία|εὐψυχία|n-s---fn-
ἀμαθέστερον|ἀμαθής|a-s---nac
νόμων|νόμος|n-p---mg-
ὑπεροψίας|ὑπεροψία|n-s---fg-
παιδευόμενοι|παιδεύω|v-pppemn-
χαλεπότητι|χαλεπότης|n-s---fd-
σωφρονέστερον|σώφρων|a-s---nac
ἀνηκουστεῖν|ἀνηκουστέω|v--pna---
ἀχρεῖα|ἀχρεῖος|a-p---na-
ξυνετοὶ|συνετός|a-p---mn-
πολεμίων|πολέμιος|a-p---mg-
παρασκευὰς|παρασκευή|n-p---fa-
μεμφόμενοι|μέμφομαι|v-pppemn-
ἀνομοίως|ἀνόμοιος|d--------
ἐπεξιέναι|ἐπέξειμι|v--pna---
διανοίας|διάνοια|n-p---fa-
παραπλησίους|παραπλήσιος|a-p---ma-
προσπιπτούσας|προσπίτνω|v-pppafa-
διαιρετάς|διαιρετός|a-p---fa-
βουλευομένους|βουλεύω|v-pppema-
παρασκευαζόμεθα|παρασκευάζω|v1piie---
ἁμαρτησομένων|ἁμαρτάνω|v-pfpmmg-
ἐλπίδας|ἐλπίς|n-p---fa-
ἀσφαλῶς|ἀσφαλής|d--------
προνοουμένων|προνοέω|v-pppemg-
διαφέρειν|διαφέρω|v--pna---
ἄνθρωπον|ἄνθρωπος|n-s---ma-
ἀνθρώπου|ἄνθρωπος|n-s---mg-
κράτιστον|κράτιστος|a-s---ma-
ἀναγκαιοτάτοις|ἀναγκαῖος|a-p---nds
παιδεύεται|παιδεύω|v3spie---
ὠφελούμενοι|ὠφελέω|v-pppemn-
παρῶμεν|παρίημι|v1pasa---
βραχεῖ|βραχύς|a-s---nd-
μορίῳ|μόριον|n-s---nd-
ἡμέρας|ἡμέρα|n-s---fg-
σωμάτων|σῶμα|n-p---ng-
βουλεύσωμεν|βουλεύω|v1pasa---
ἔξεστι|ἔξεστι|v3spia---
πέμπετε|πέμπω|v2ppma---
φασιν|φημί|v3ppia---
ἀδικεῖσθαι|ἀδικέω|v--pne---
ἑτοίμων|ἑτοῖμος|a-p---mg-
διδόντα|δίδωμι|v-sppama-
νόμιμον|νόμιμος|a-s---nn-
ἀδικοῦντα|ἀδικέω|v-sppama-
παρασκευάζεσθε|παρασκευάζω|v2ppme---
φοβερώτατα|φοβερός|a-p---nas
εἶπεν|εἶπον|v3saia---
Σθενελαΐδας|Σθενελαΐδης|n-s---mn-
τελευταῖος|τελευταῖος|a-s---mn-
ἐφόρων|ἔφορος|n-p---mg-
ἔλεξεν|λέγω|v3saia---
ὧδε|ὧδε|d--------
γιγνώσκω|γιγνώσκω|v1spia---
ἐπαινέσαντες|ἐπαινέω|v-papamn-
ἀντεῖπον|ἀντεῖπον|v3paia---
ἀδικοῦσι|ἀδικέω|v3ppia---
Μήδους|Μῆδος|n-p---ma-
ἀγαθοὶ|ἀγαθός|a-p---mn-
κακοὶ|κακός|a-p---mn-
διπλασίας|διπλάσιος|a-s---fg-
ζημίας|ζημία|n-s---fg-
γεγένηνται|γίγνομαι|v3prie---
γίγνονται|γίγνομαι|v3ppie---
σωφρονῶμεν|σωφρονέω|v1ppsa---
ἀδικουμένους|ἀδικέω|v-pppema-
μελλήσομεν|μέλλω|v1pfia---
τιμωρεῖν|τιμωρέω|v--pna---
μέλλουσι|μέλλω|v3ppia---
χρήματά|χρῆμα|n-p---nn-
ἵπποι|ἵππος|n-p---mn-
παραδοτέα|παραδοτέος|a-p---nn-
διακριτέα|διακριτέος|a-p---nn-
βλαπτομένους|βλάπτω|v-pppema-
τιμωρητέα|τιμωρητέος|a-p---nn-
σθένει|σθένος|n-s---nd-
πρέπει|πρέπω|v3spia---
βουλεύεσθαι|βουλεύω|v--pne---
διδασκέτω|διδάσκω|v3spma---
ψηφίζεσθε|ψηφίζομαι|v2ppme---
Σπάρτης|Σπάρτη|n-s---fg-
ἐᾶτε|ἐάω|v2ppma---
καταπροδιδῶμεν|καταπροδίδωμι|v1ppsa---
θεοῖς|θεός|n-p---md-
ἐπίωμεν|ἐφίημι|v1ppsa---
ἀδικοῦντας|ἀδικέω|v-pppama-
λέξας|λέγω|v-sapamn-
ἐπεψήφιζεν|ἐπιψηφίζω|v3siia---
ἔφορος|ἔφορος|n-s---mn-
ἐκκλησίαν|ἐκκλησία|n-s---fa-
κρίνουσι|κρίνω|v3ppia---
βοῇ|βοή|n-s---fd-
διαγιγνώσκειν|διαγιγνώσκω|v--pna---
βοὴν|βοή|n-s---fa-
ὁποτέρα|ὁπότερος|a-s---fn-
ἀποδεικνυμένους|ἀποδείκνυμι|v-pppema-
ὁρμῆσαι|ὁρμάω|v--ana---
δοκοῦσι|δοκέω|v3ppia---
σπονδαὶ|σπονδή|n-p---fn-
ἀναστήτω|ἀνίστημι|v3sama---
ἐκεῖνο|ἐκεῖνος|a-s---na-
δείξας|δείκνυμι|v-sapamn-
δοκοῦσιν|δοκέω|v3ppia---
θάτερα|ἕτερος|a-p---na-
διέστησαν|διίστημι|v3paia---
προσκαλέσαντές|προσκαλέω|v-papamn-
δοκοῖεν|δοκέω|v3ppoa---
παρακαλέσαντες|παρακαλέω|v-papamn-
ἐπαγαγεῖν|ἐπάγω|v--ana---
βουλευσάμενοι|βουλεύω|v-papmmn-
ποιῶνται|ποιέω|v3ppse---
ἀπεχώρησαν|ἀποχωρέω|v3paia---
διαπραξάμενοι|διαπράσσω|v-papmmn-
ἅπερ|ὅσπερ|p-p---na-
χρηματίσαντες|χρηματίζω|v-papamn-
διαγνώμη|διαγνώμη|n-s---fn-
τετάρτῳ|τέταρτος|a-s---nd-
τριακοντουτίδων|τριακονταετής|n-p---fg-
σπονδῶν|σπονδή|n-p---fg-
προκεχωρηκυιῶν|προχωρέω|v-prpafg-
Εὐβοϊκά|Εὐβοικός|a-p---na-
ἐψηφίσαντο|ψηφίζω|v3paim---
φοβούμενοι|φοβέω|v-pppemn-
δυνηθῶσιν|δύναμαι|v3pasp---
ὑποχείρια|ὑποχείριος|a-p---na-
τοιῷδε|τοιόσδε|a-s---md-
ηὐξήθησαν|αὐξάνω|v3paip---
Μῆδοι|Μῆδος|n-p---mn-
Εὐρώπης|Εὐρώπη|n-s---fg-
καταφυγόντες|καταφεύγω|v-papamn-
Μυκάλην|Μυκάλη|n-s---fa-
διεφθάρησαν|διαφθείρω|v3paip---
Λεωτυχίδης|Λεωτυχίδης|n-s---mn-
ὅσπερ|ὅς|p-s---mn-
ἡγεῖτο|ἡγέομαι|v3siie---
Μυκάλῃ|Μυκάλη|n-s---fd-
ἀπεχώρησεν|ἀποχωρέω|v3saia---
Ἰωνίας|Ἰωνία|n-s---fg-
Ἑλλησπόντου|Ἑλλήσποντος|n-s---mg-
ἀφεστηκότες|ἀφίστημι|v-prpamn-
Σηστὸν|Σηστός|n-s---fa-
ἐπιχειμάσαντες|ἐπιχειμάζω|v-papamn-
ἐκλιπόντων|ἐκλείπω|v-papamg-
ἀπέπλευσαν|ἀποπλέω|v3paia---
κοινόν|κοινός|a-s---nn-
ἀπῆλθον|ἀπέρχομαι|v3paia---
διεκομίζοντο|διακομίζω|v3piie---
ὑπεξέθεντο|ὑπεκτίθεμαι|v3paim---
γυναῖκας|γυνή|n-p---fa-
περιοῦσαν|περίειμι|v-sppafa-
κατασκευήν|κατασκευή|n-s---fa-
ἀνοικοδομεῖν|ἀνοικοδομέω|v--pna---
περιβόλου|περίβολος|a-s---ng-
εἱστήκει|ἵστημι|v3slia---
οἰκίαι|οἰκία|n-p---fn-
ἐπεπτώκεσαν|πίπτω|v3plia---
περιῆσαν|περίειμι|v3piia---
ἐσκήνωσαν|σκηνόω|v3paia---
πρεσβείᾳ|πρεσβεία|n-s---fd-
ἥδιον|ἡδύς|a-s---nac
μήτ̓|μήτε|d--------
ἐκείνους|ἐκεῖνος|p-p---ma-
ἔχοντα|ἔχω|v-sppama-
φοβουμένων|φοβέω|v-pppemg-
ὑπῆρχε|ὑπάρχω|v3siia---
Μηδικὸν|Μηδικός|a-s---ma-
τόλμαν|τόλμα|n-s---fa-
ὅσοις|ὅσος|a-p---md-
ξυγκαθελεῖν|συγκαθαιρέω|v--fna---
περιβόλους|περίβολος|a-p---ma-
ὕποπτον|ὕποπτος|a-s---na-
ἐπέλθοι|ἐπέρχομαι|v3saoa---
ἔχοντος|ἔχω|v-sppamg-
ἐχυροῦ|ἐχυρός|a-s---ng-
Θηβῶν|Θῆβαι|n-p---fg-
ὁρμᾶσθαι|ὁρμάω|v--pne---
πᾶσιν|πᾶς|a-p---md-
ἀναχώρησίν|ἀναχώρησις|n-s---fa-
ἀφορμὴν|ἀφορμή|n-s---fa-
ἱκανὴν|ἱκανός|a-s---fa-
Θεμιστοκλέους|Θεμιστοκλῆς|n-s---mg-
ταῦτ̓|οὗτος|p-p---na-
εἰπόντας|εἶπον|v-papama-
ἀποκρινάμενοι|ἀποκρίνω|v-papmmn-
πέμψουσιν|πέμπω|v3pasa---
ἀπήλλαξαν|ἀπαλλαξείω|v3paia---
ἐκέλευεν|κελεύω|v3siia---
ἀποστέλλειν|ἀποστέλλω|v--pna---
τάχιστα|τάχιστος|a-p---na-
ἑαυτῷ|ἑαυτοῦ|p-s---nd-
ἑλομένους|αἱρέω|v-papmma-
ἐπισχεῖν|ἐπίσχω|v--pna---
τοσούτου|τοσοῦτος|p-s---ng-
ἱκανὸν|ἱκανός|a-s---na-
ἄρωσιν|αἴρω|v3pasa---
ἀπομάχεσθαι|ἀπομάχομαι|v--pne---
ἀναγκαιοτάτου|ἀναγκαῖος|a-s---ngs
ὕψους|ὕψος|n-s---ng-
φειδομένους|φείδομαι|v-pppema-
ἰδίου|ἴδιος|a-s---ng-
δημοσίου|δημόσιος|a-s---ng-
οἰκοδομήματος|οἰκοδόμημα|n-s---ng-
καθαιροῦντας|καθαιρέω|v-pppama-
διδάξας|διδάσκω|v-sapamn-
ὑπειπὼν|ὑπεῖπον|v-sapamn-
πράξοι|πράσσω|v3sfoa---
ᾤχετο|οἴχομαι|v3siie---
ἐλθὼν|ἔρχομαι|v-sapamn-
προσῄει|πρόσειμι|v3siia---
ἀρχάς|ἀρχή|n-p---fa-
διῆγε|διάγω|v3siia---
προυφασίζετο|προφασίζομαι|v3siie---
ἔροιτο|ἔρομαι|v3saom---
ἐπέρχεται|ἐπέρχομαι|v3spie---
ξυμπρέσβεις|σύμπρεσβυς|n-p---mn-
ἀναμένειν|ἀναμένω|v--pna---
ἀσχολίας|ἀσχολία|n-s---fg-
τινος|τις|a-s---fg-
ὑπολειφθῆναι|ὑπολείπω|v--anp---
προσδέχεσθαι|προσδέχομαι|v--pne---
ἥξειν|ἥκω|v--fna---
θαυμάζειν|θαυμάζω|v--pna---
πάρεισιν|πάρειμι|v3ppia---
ἀκούοντες|ἀκούω|v-pppamn-
Θεμιστοκλεῖ|Θεμιστοκλῆς|n-s---md-
ἀφικνουμένων|ἀφικνέομαι|v-pppemg-
κατηγορούντων|κατηγορέω|v-pppamg-
τειχίζεταί|τειχίζω|v3spie---
ὕψος|ὕψος|n-s---na-
λαμβάνει|λαμβάνω|v3spia---
ἀπιστῆσαι|ἀπιστέω|v--ana---
γνοὺς|γιγνώσκω|v-sapamn-
ἐκεῖνος|ἐκεῖνος|p-s---mn-
κελεύει|κελεύω|v3spia---
πέμψαι|πέμπω|v--ana---
χρηστοὶ|χρηστός|a-p---mn-
πιστῶς|πιστός|d--------
ἀναγγελοῦσι|ἀναγγέλλω|v3pfia---
σκεψάμενοι|σκέπτομαι|v-papemn-
ἀποστέλλουσιν|ἀποστέλλω|v3ppia---
πέμπει|πέμπω|v3spia---
κελεύων|κελεύω|v-sppamn-
ἐπιφανῶς|ἐπιφανής|d--------
κατασχεῖν|κατέχω|v--ana---
ἀφεῖναι|ἀφίημι|v--ana---
κομισθῶσιν|κομίζω|v3pasp---
ἧκον|ἥκω|v3piia---
Ἁβρώνιχός|Ἁβρώνιχος|n-s---mn-
Λυσικλέους|Λυσικλῆς|n-s---mg-
Ἀριστείδης|Ἀριστείδης|n-s---mn-
Λυσιμάχου|Λυσίμαχος|n-s---mg-
ἀγγέλλοντες|ἀγγέλλω|v-pppamn-
ἱκανῶς|ἱκανός|d--------
ἐφοβεῖτο|φοβέω|v3siie---
ἀκούσειαν|ἀκούω|v3paoa---
ἀφῶσιν|ἀφίημι|v3pasa---
ἐπεστάλη|ἐπιστέλλω|v3saip---
κατεῖχον|κατέχω|v3piia---
τετείχισται|τειχίζω|v3srie---
ἱκανὴ|ἱκανός|a-s---fn-
ἐνοικοῦντας|ἐνοικέω|v-pppama-
πρεσβεύεσθαι|πρεσβεύω|v--pne---
διαγιγνώσκοντας|διαγιγνώσκω|v-pppama-
κοινά|κοινός|a-p---na-
τολμῆσαι|τολμάω|v--ana---
ὕστεροι|ὕστερος|a-p---mn-
φανῆναι|φανάω|v--pna---
πολίταις|πολίτης|n-p---md-
ὠφελιμώτερον|ὠφέλιμος|a-s---nac
ἀντιπάλου|ἀντίπαλος|a-s---fg-
παρασκευῆς|παρασκευή|n-s---fg-
ὁμοῖόν|ὅμοιος|a-s---na-
ἀτειχίστους|ἀτείχιστος|a-p---ma-
ὀργὴν|ὀργή|n-s---fa-
κωλύμῃ|κωλύμη|n-s---fd-
παραινέσει|παραίνεσις|n-s---fd-
δῆθεν|δῆθεν|d--------
ἐπρεσβεύσαντο|πρεσβεύω|v3paim---
προσφιλεῖς|προσφιλής|a-p---mn-
βουλήσεως|βούλησις|n-s---fg-
ἁμαρτάνοντες|ἁμαρτάνω|v-pppamn-
ἀδήλως|ἄδηλος|d--------
ἤχθοντο|ἄχθομαι|v3piie---
ἀνεπικλήτως|ἀνεπίκλητος|d--------
ἐτείχισαν|τειχίζω|v3paia---
δήλη|δῆλος|a-s---fn-
οἰκοδομία|οἰκοδομία|n-s---fn-
σπουδὴν|σπουδή|n-s---fa-
θεμέλιοι|θεμέλιος|a-p---mn-
παντοίων|παντοῖος|a-p---mg-
λίθων|λίθος|n-p---mg-
ὑπόκεινται|ὑπόκειμαι|v3ppie---
ξυνειργασμένων|συνεργάζομαι|v-prpemg-
ἕκαστόν|ἕκαστος|a-s---ma-
προσέφερον|προσφέρω|v3piia---
πολλαί|πολύς|a-p---fn-
στῆλαι|στήλη|n-p---fn-
σημάτων|σῆμα|n-p---ng-
λίθοι|λίθος|n-p---mn-
εἰργασμένοι|ἐργάζομαι|v-prpemn-
ἐγκατελέγησαν|ἐγκαταλέγω|v3paip---
περίβολος|περίβολος|a-s---mn-
ἐξήχθη|ἐξάγω|v3saip---
κινοῦντες|κινέω|v-pppamn-
ἠπείγοντο|ἐπείγω|v3piie---
ἔπεισε|πείθω|v3saia---
Πειραιῶς|Πειραιεύς|n-s---mg-
λοιπὰ|λοιπός|a-p---na-
οἰκοδομεῖν|οἰκοδομέω|v--pna---
ὑπῆρκτο|ὑπάρχω|v3slie---
ἐκείνου|ἐκεῖνος|p-s---mg-
ἦρξε|ἄρχω|v3saia---
λιμένας|λιμήν|n-p---ma-
τρεῖς|τρεῖς|a-p---ma-
αὐτοφυεῖς|αὐτοφυής|a-p---ma-
ναυτικοὺς|ναυτικός|a-p---ma-
γεγενημένους|γίγνομαι|v-prpema-
προφέρειν|προφέρω|v--pna---
ἐτόλμησεν|τολμάω|v3saia---
ἀνθεκτέα|ἀνθεκτέον|a-p---nn-
ξυγκατεσκεύαζεν|συγκατασκευάζω|v3siia---
ᾠκοδόμησαν|οἰκοδομέω|v3paia---
πάχος|πάχος|n-s---na-
τείχους|τεῖχος|n-s---ng-
δῆλόν|δῆλος|a-s---nn-
Πειραιᾶ|Πειραιεύς|n-s---ma-
ἅμαξαι|ἄμαξα|n-p---fn-
ἐναντίαι|ἐναντίος|a-p---fn-
ἀλλήλαις|ἀλλήλων|p-p---fd-
λίθους|λίθος|n-p---ma-
ἐπῆγον|ἐπάγω|v3piia---
χάλιξ|χάλιξ|n-s---mn-
πηλὸς|πηλός|n-s---mn-
ξυνῳκοδομημένοι|συνοικοδομέω|v-prpemn-
ἐντομῇ|ἐντομή|n-s---fd-
ἐγγώνιοι|ἐγγώνιος|a-p---mn-
σιδήρῳ|σίδηρος|n-s---md-
μολύβδῳ|μόλυβδος|n-s---md-
δεδεμένοι|δέω|v-prpemn-
ἐτελέσθη|τελέω|v3saip---
διενοεῖτο|διανοέομαι|v3siie---
πάχει|πάχος|n-s---nd-
ἐπιβουλάς|ἐπιβουλή|n-p---fa-
ἐνόμιζεν|νομίζω|v3siia---
ὀλίγων|ὀλίγος|a-p---fg-
ἀχρειοτάτων|ἀχρεῖος|a-p---fgs
ἀρκέσειν|ἀρκέω|v--fna---
φυλακήν|φυλακή|n-s---fa-
ἐσβήσεσθαι|εἰσβαίνω|v--fnm---
προσέκειτο|πρόσκειμαι|v3siie---
ἰδών|εἶδον|v-sapamn-
στρατιᾶς|στρατιά|n-s---fg-
ἔφοδον|ἔφοδος|n-s---fa-
εὐπορωτέραν|εὔπορος|a-s---fac
ἐνόμιζε|νομίζω|v3siia---
ἄνω|ἄνω|d--------
παρῄνει|παραινέω|v3siia---
βιασθῶσι|βιάζω|v3pasp---
καταβάντας|καταβαίνω|v-papama-
ἅπαντας|ἅπας|a-p---ma-
ἀνθίστασθαι|ἀνθίστημι|v--pne---
ἐτειχίσθησαν|τειχίζω|v3paip---
κατεσκευάζοντο|κατασκευάζω|v3piie---
ἀναχώρησιν|ἀναχώρησις|n-s---fa-
Παυσανίας|Παυσανίας|n-s---mn-
Κλεομβρότου|Κλεόμβροτος|n-s---mg-
Λακεδαίμονος|Λακεδαίμων|n-s---fg-
ἐξεπέμφθη|ἐκπέμπω|v3saip---
ξυνέπλεον|συμπλέω|v3piia---
Κύπρον|Κύπρος|n-s---fa-
κατεστρέψαντο|καταστρέφω|v3paim---
Βυζάντιον|Βυζάντιος|n-s---na-
ἐξεπολιόρκησαν|ἐκπολιορκέω|v3paia---
τῇδε|ὅδε|a-s---fd-
βιαίου|βίαιος|a-s---mg-
Ἴωνες|Ἴωνες|n-p---mn-
νεωστὶ|νεωστί|d--------
ἠλευθέρωντο|ἐλευθερόω|v3plie---
φοιτῶντές|φοιτάω|v-pppamn-
Παυσανίᾳ|Παυσανίας|n-s---md-
ἐπιτρέπειν|ἐπιτρέπω|v--pna---
βιάζηται|βιάζω|v3spse---
ἐδέξαντό|δέχομαι|v3paim---
προσεῖχον|προσέχω|v3piia---
περιοψόμενοι|περιοράω|v-pfpmmn-
ἆλλά|ἄλλος|p-p---na-
καταστησόμενοι|καθίστημι|v-pfpmmn-
φαίνοιτο|φαίνω|v3spoe---
μετεπέμποντο|μεταπέμπω|v3piie---
Παυσανίαν|Παυσανίας|n-s---ma-
ἀνακρινοῦντες|ἀνακρίνω|v-pfpamn-
ἐπυνθάνοντο|πυνθάνομαι|v3piie---
ἀδικία|ἀδικία|n-s---fn-
κατηγορεῖτο|κατηγορέω|v3siie---
τυραννίδος|τυραννίς|n-s---fg-
μίμησις|μίμησις|n-s---fn-
στρατηγία|στρατηγία|n-s---fn-
καλεῖσθαί|καλέω|v--pne---
μετατάξασθαι|μετατάσσω|v--anm---
στρατιωτῶν|στρατιώτης|n-p---mg-
ἀδικημάτων|ἀδίκημα|n-p---ng-
ηὐθύνθη|εὐθύνω|v3saip---
ἀπολύεται|ἀπολύω|v3spie---
μηδισμὸς|Μηδισμός|n-s---mn-
σαφέστατον|σαφής|a-s---nas
ἐκπέμπουσιν|ἐκπέμπω|v3ppia---
Δόρκιν|Δόρκις|n-s---ma-
τινὰς|τις|p-p---ma-
στρατιὰν|στρατιά|n-s---fa-
πολλήν|πολύς|a-s---fa-
ἐφίεσαν|ἐφίημι|v3piia---
ἡγεμονίαν|ἡγεμονία|n-s---fa-
ἐξιόντες|ἔξεστι|v-pppamn-
χείρους|χείρων|a-p---mnc
γίγνωνται|γίγνομαι|v3ppse---
ἐνεῖδον|ἐνεῖδον|v3paia---
ἀπαλλαξείοντες|ἀπαλλαξείω|v-pppamn-
Μηδικοῦ|Μηδικός|a-s---mg-
ἱκανοὺς|ἱκανός|a-p---ma-
ἐπιτηδείους|ἐπιτήδειος|a-p---ma-
ἑκόντων|ἑκών|a-p---mg-
μῖσος|μῖσος|n-s---na-
ἔταξαν|τάσσω|v3paia---
ἅς|ὅς|p-p---fa-
παρέχειν|παρέχω|v--pna---
πρόσχημα|πρόσχημα|n-s---nn-
ἔπαθον|πάσχω|v3paia---
δῃοῦντας|δηϊόω|v-pppama-
Ἑλληνοταμίαι|Ἑλληνοταμίαι|n-p---mn-
ἀρχή|ἀρχή|n-s---fn-
ἐδέχοντο|δέχομαι|v3piie---
φόρον|φόρος|n-s---ma-
ὠνομάσθη|ὀνομάζω|v3saip---
φορά|φορά|n-s---fn-
φόρος|φόρος|n-s---mn-
ταχθεὶς|τάσσω|v-sappmn-
τάλαντα|τάλαντον|n-p---nn-
ταμιεῖόν|ταμιεῖον|n-s---nn-
Δῆλος|Δῆλος|n-s---fn-
ξύνοδοι|σύνοδος|n-p---fn-
αὐτονόμων|αὐτόνομος|a-p---mg-
κοινῶν|κοινός|a-p---fg-
ξυνόδων|σύνοδος|n-p---fg-
βουλευόντων|βουλεύω|v-pppamg-
τοσάδε|τοσόσδε|p-p---na-
ἐπῆλθον|ἐπέρχομαι|v3paia---
διαχειρίσει|διαχείρισις|n-s---fd-
μεταξὺ|μεταξύ|r--------
νεωτερίζοντας|νεωτερίζω|v-pppama-
προστυγχάνοντας|προστυγχάνω|v-pppama-
ἑκάστῳ|ἕκαστος|a-s---nd-
ἔγραψα|γράφω|v1saia---
ἐκβολὴν|ἐκβολή|n-s---fa-
ἐποιησάμην|ποιέω|v1saim---
ἐμοῦ|ἐγώ|p1s---mg-
ἐκλιπὲς|ἐκλιπής|a-s---nn-
Ἑλληνικὰ|Ἑλληνικός|a-p---na-
ξυνετίθεσαν|συντίθημι|v3piia---
Μηδικά|Μηδικός|a-p---na-
ἥψατο|ἅπτω|v3saim---
ξυγγραφῇ|συγγραφή|n-s---fd-
Ἑλλάνικος|Ἑλλάνικος|n-s---mn-
βραχέως|βραχύς|d--------
χρόνοις|χρόνος|n-p---md-
ἀκριβῶς|ἀκριβῶς|d--------
ἐπεμνήσθη|ἐπιμιμνήσκομαι|v3saip---
ἀπόδειξιν|ἀπόδειξις|n-s---fa-
οἵῳ|οἷος|a-s---md-
Ἠιόνα|Ἠϊών|n-s---fa-
Στρυμόνι|Στρυμών|n-s---md-
ἠνδραπόδισαν|ἀνδραποδίζω|v3paia---
Μιλτιάδου|Μιλτιάδης|n-s---mg-
Σκῦρον|Σκῦρος|n-s---fa-
Αἰγαίῳ|Αἰγαῖος|a-s---md-
νῆσον|νῆσος|n-s---fa-
Δόλοπες|Δόλοψ|n-p---mn-
Καρυστίους|Καρύστιος|n-p---ma-
Εὐβοέων|Εὐβοεύς|n-p---mg-
ὁμολογίαν|ὁμολογία|n-s---fa-
Ναξίοις|Νάξιος|n-p---md-
ἀποστᾶσι|ἀφεστήξω|v-papamd-
παρεστήσαντο|παρίστημι|v3paim---
ξυμμαχὶς|συμμαχίς|n-s---fn-
καθεστηκὸς|καθίστημι|v-srpana-
ἐδουλώθη|δουλόω|v3saip---
ἑκάστῃ|ἕκαστος|a-s---fd-
ἀποστάσεων|ἀπόστασις|n-p---fg-
μέγισται|μέγας|a-p---fn-
φόρων|φόρος|n-p---mg-
ἔκδειαι|ἔκδεια|n-p---fn-
λιποστράτιον|λιποστράτιον|n-s---nn-
λυπηροὶ|λυπηρός|a-p---mn-
εἰωθόσιν|ἔθω|v-prpamd-
βουλομένοις|βούλομαι|v-pppemd-
ταλαιπωρεῖν|ταλαιπωρέω|v--pna---
προσάγοντες|προσάγω|v-pppamn-
ἀνάγκας|ἀνάγκη|n-p---fa-
ξυνεστράτευον|συστρατεύω|v3piia---
ῥᾴδιόν|ῥᾴδιος|a-s---nn-
προσάγεσθαι|προσάγω|v--pne---
ἀπόκνησιν|ἀπόκνησις|n-s---fa-
στρατειῶν|στρατεία|n-p---fg-
ἱκνούμενον|ἱκνέομαι|v-sppena-
ἀνάλωμα|ἀνάλωμα|n-s---na-
ηὔξετο|αὐξάνω|v3siie---
ξυμφέροιεν|συμφέρω|v3ppoa---
ἀποσταῖεν|ἀφίστημι|v3paoa---
Εὐρυμέδοντι|Εὐρυμέδων|n-s---md-
ποταμῷ|ποταμός|n-s---md-
Παμφυλίᾳ|Παμφυλία|n-s---fd-
πεζομαχία|πεζομαχία|n-s---fn-
πάσας|πᾶς|a-p---fa-
διακοσίας|διακόσιοι|a-p---fa-
Θασίους|Θάσιος|n-p---ma-
ἀποστῆναι|ἀφεστήξω|v--ana---
διενεχθέντας|διαφέρω|v-pappma-
ἀντιπέρας|ἀντιπέρας|d--------
Θρᾴκῃ|Θρᾳκία|n-s---fd-
ἐμπορίων|ἐμπόριον|n-p---ng-
μετάλλου|μέταλλον|n-s---ng-
ἐνέμοντο|νέμω|v3piie---
Θάσον|Θάσος|n-s---ma-
ἀπέβησαν|ἀποβαίνω|v3paia---
Στρυμόνα|Στρυμών|n-s---ma-
μυρίους|μυρίος|a-p---ma-
χρόνους|χρόνος|n-p---ma-
οἰκιοῦντες|οἰκίζω|v-pfpamn-
καλουμένας|καλέω|v-pppefa-
Ἐννέα|ἐννέα|a--------
ὁδούς|ὁδός|n-p---fa-
Ἀμφίπολιν|Ἀμφίπολις|n-s---fa-
ὁδῶν|ὁδός|n-p---fg-
Ἠδωνοί|Ἠδωνοί|n-p---mn-
προελθόντες|προέρχομαι|v-papamn-
μεσόγειαν|μεσόγεια|n-s---fa-
Δραβησκῷ|Δραβησκός|n-s---md-
Ἠδωνικῇ|Ἠδωνική|n-s---fd-
Θρᾳκῶν|Θρᾷξ|n-p---mg-
ξυμπάντων|σύμπας|a-p---mg-
πολέμιον|πολέμιος|a-s---nn-
ὁδοὶ|ὁδός|n-p---fn-
κτιζόμενον|κτίζω|v-sppenn-
Θάσιοι|Θάσιος|n-p---mn-
πολιορκούμενοι|πολιορκέω|v-pppemn-
ἐπεκαλοῦντο|ἐπικαλέω|v3piie---
ἐπαμύνειν|ἐπαμύνω|v--pna---
ἐσβαλόντας|εἰσβάλλω|v-papama-
ὑπέσχοντο|ὑπισχνέομαι|v3paim---
ἔμελλον|μέλλω|v3piia---
διεκωλύθησαν|διακωλύω|v3paip---
γενομένου|γίγνομαι|v-sapmmg-
σεισμοῦ|σεισμός|n-s---mg-
Εἵλωτες|Εἵλως|n-p---mn-
περιοίκων|περίοικος|a-p---mg-
Θουριᾶταί|Θουριάτης|n-p---mn-
Αἰθαιῆς|Αἰθαιεύς|n-p---mn-
Ἰθώμην|Ἰθώμη|n-s---fa-
Εἱλώτων|Εἵλως|n-p---mg-
Μεσσηνίων|Μεσσήνιος|n-p---mg-
δουλωθέντων|δουλόω|v-pappmg-
ἀπόγονοι|ἀπόγονος|a-p---mn-
Μεσσήνιοι|Μεσσήνιος|n-p---mn-
ἐκλήθησαν|καλέω|v3paip---
Ἰθώμῃ|Ἰθώμη|n-s---fd-
καθειστήκει|καθίστημι|v3slia---
τρίτῳ|τρίτος|a-s---nd-
ὡμολόγησαν|ὁμολογέω|v3paia---
τεῖχός|τεῖχος|n-s---na-
παραδόντες|παραδίδωμι|v-papamn-
ἀποδοῦναι|ἀποδίδωμι|v--ana---
ταξάμενοι|τάσσω|v-papmmn-
μέταλλον|μέταλλον|n-s---na-
ἀφέντες|ἀφίημι|v-papamn-
ἐμηκύνετο|μηκύνω|v3siie---
ἐπεκαλέσαντο|ἐπικαλέω|v3paim---
τειχομαχεῖν|τειχομαχέω|v--pna---
πολιορκίας|πολιορκία|n-s---fg-
μακρᾶς|μακρός|a-s---fg-
καθεστηκυίας|καθίστημι|v-srpafg-
διαφορὰ|διαφορά|n-s---fn-
φανερὰ|φανερός|a-p---nn-
ἡλίσκετο|ἁλίσκομαι|v3siie---
τολμηρὸν|τολμηρός|a-s---na-
νεωτεροποιίαν|νεωτεροποιία|n-s---fa-
ἀλλοφύλους|ἀλλόφυλος|a-p---ma-
παραμείνωσιν|παραμένω|v3pasa---
νεωτερίσωσι|νεωτερίζω|v3pasa---
μόνους|μόνος|a-p---ma-
ὑποψίαν|ὑποψία|n-s---fa-
εἰπόντες|εἶπον|v-papamn-
βελτίονι|βελτίων|a-s---mdc
ἀποπεμπόμενοι|ἀποπέμπω|v-pppemn-
ἀλλά|ἀλλά|c--------
ὑπόπτου|ὕποπτος|a-s---ng-
ἀξιώσαντες|ἀξιόω|v-papamn-
παθεῖν|πάσχω|v--ana---
Ἀργείοις|Ἀργεῖος|n-p---md-
Θεσσαλοὺς|Θεσσαλός|n-p---ma-
ὅρκοι|ὅρκος|n-p---mn-
ξυμμαχία|συμμαχία|n-s---fn-
ἀντέχειν|ἀντέχω|v--pna---
ἐξίασιν|ἔξειμι|v3ppia---
ὑπόσπονδοι|ὑπόσπονδος|a-p---mn-
ἐπιβήσονται|ἐπιβαίνω|v3pfim---
ἁλίσκηται|ἁλίσκομαι|v3spse---
λαβόντος|λαμβάνω|v-sapamg-
δοῦλον|δοῦλος|a-s---ma-
Πυθικὸν|Πυθικός|a-s---nn-
ἱκέτην|ἱκέτης|n-s---ma-
Διὸς|Ζεύς|n-s---mg-
Ἰθωμήτα|Ἰθωμήτης|n-s---mg-
ἀφιέναι|ἀφίημι|v--pna---
ἐξῆλθον|ἐξέρχομαι|v3paia---
παῖδες|παῖς|n-p---mn-
γυναῖκες|γυνή|n-p---fn-
ἔχθος|ἔχθος|n-s---na-
Ναύπακτον|Ναύπακτος|n-s---fa-
κατῴκισαν|κατοικίζω|v3paia---
ᾑρηκότες|αἱρέω|v-prpamn-
Λοκρῶν|Λοκροί|n-p---mg-
Ὀζολῶν|Ὀζόλαι|n-p---mg-
προσεχώρησαν|προσχωρέω|v3paia---
ὅρων|ὅρος|n-p---mg-
Μέγαρα|Μέγαρα|n-p---na-
Πηγάς|Πηγαί|n-p---fa-
Μεγαρεῦσι|Μεγαρεύς|n-p---md-
Νίσαιαν|Νίσαια|n-s---fa-
σφοδρὸν|σφοδρός|a-s---nn-
ἤρξατο|ἄρχω|v3saim---
Ἰνάρως|Ἰνάρως|n-s---mn-
Ψαμμητίχου|Ψαμμήτιχος|n-s---mg-
Λίβυς|Λίβυς|n-s---mn-
Λιβύων|Λίβυς|n-p---mg-
Αἰγύπτῳ|Αἴγυπτος|n-s---fd-
Μαρείας|Μάρεια|n-s---fg-
Φάρου|Φάρος|n-s---fg-
ἀπέστησεν|ἀφίστημι|v3saia---
Αἰγύπτου|Αἴγυπτος|n-s---fg-
Ἀρταξέρξου|Ἀρταξέρξης|n-s---mg-
ἄρχων|ἄρχων|n-s---mn-
ἐπηγάγετο|ἐπάγω|v3saim---
στρατευόμενοι|στρατεύω|v-pppemn-
διακοσίαις|διακόσιοι|a-p---fd-
ἀπολιπόντες|ἀπολείπω|v-dapamn-
ἀναπλεύσαντες|ἀναπλέω|v-papamn-
Νεῖλον|Νεῖλος|n-s---ma-
Μέμφιδος|Μέμφις|n-s---fg-
μερῶν|μέρος|n-p---ng-
τρίτον|τρίτος|a-s---na-
καλεῖται|καλέω|v3spie---
Λευκὸν|λευκός|a-s---nn-
ἐνῆσαν|ἐν-εἰμί|v3piia---
αὐτόθι|αὐτόθι|d--------
Αἰγυπτίων|Αἰγύπτιος|n-p---mg-
ξυναποστάντες|συναφίστημι|v-papamn-
ἀποβᾶσιν|ἀποβαίνω|v-papamd-
Ἁλιᾶς|Ἁλιέαι|n-p---fa-
Ἐπιδαυρίους|Ἐπιδαύριος|n-p---ma-
Κεκρυφαλείᾳ|Κεκρυφαλεία|n-s---fd-
Αἰγινήτας|Αἰγινήτης|n-p---ma-
Αἰγίνῃ|Αἴγινα|n-s---fd-
Λεωκράτους|Λεωκράτης|n-s---mg-
Στροίβου|Στροῖβος|n-s---mg-
Αἴγιναν|Αἴγινα|n-s---fa-
τριακοσίους|τριακόσιοι|a-p---ma-
ἐπικούρους|ἐπίκουρος|n-p---ma-
διεβίβασαν|διαβιβάζω|v3paia---
Γερανείας|Γερανεία|n-s---fg-
κατέλαβον|καταλαμβάνω|v3paia---
Μεγαρίδα|Μεγαρίς|n-s---fa-
κατέβησαν|καταβαίνω|v3paia---
ἀδυνάτους|ἀδύνατος|a-p---ma-
Μεγαρεῦσιν|Μεγαρεύς|n-p---md-
ἀπούσης|ἄπειμι|v-sppafg-
βοηθῶσιν|βοηθέω|v3ppsa---
Αἰγίνης|Αἴγινα|n-s---fg-
ἀναστήσεσθαι|ἀνίστημι|v--fnm---
ἐκίνησαν|κινέω|v3paia---
ὑπολοίπων|ὑπόλοιπος|a-p---mg-
πρεσβύτατοι|πρέσβυς|a-p---mns
νεώτατοι|νέος|a-p---mns
Μυρωνίδου|Μυρωνίδης|n-s---mg-
ἰσορρόπου|ἰσόρροπος|a-s---fg-
ἐνόμισαν|νομίζω|v3paia---
ἔλασσον|ἐλάσσων|a-s---nac
κακιζόμενοι|κακίζω|v-pppemn-
πρεσβυτέρων|πρέσβυς|a-p---mgc
παρασκευασάμενοι|παρασκευάζω|v-papmmn-
ἡμέραις|ἡμέρα|n-p---fd-
ἀνθίστασαν|ἀνθιστάω|v3piia---
νικήσαντες|νικάω|v-papamn-
ἐκβοηθήσαντες|ἐκβοηθέω|v-papamn-
Μεγάρων|Μέγαρα|n-p---ng-
ἱστάντας|ἵστημι|v-pppama-
διαφθείρουσι|διαφθείρω|v3ppia---
ξυμβαλόντες|συμβάλλω|v-papamn-
ὑπεχώρουν|ὑποχωρέω|v3piia---
προσβιασθὲν|προσβιάζομαι|v-sapenn-
διαμαρτὸν|διαμαρτάνω|v-sapann-
ὁδοῦ|ὁδός|n-s---fg-
ἐσέπεσεν|εἰσπίπτω|v3saia---
ἰδιώτου|ἰδιώτης|n-s---mg-
ἔτυχεν|τυγχάνω|v3saia---
ὄρυγμα|ὄρυγμα|n-s---nn-
περιεῖργον|περιέργω|v-sppann-
ἔξοδος|ἔξοδος|n-s---fn-
πρόσωπόν|πρόσωπον|n-s---na-
εἶργον|ἔργω|v3piia---
περιστήσαντες|περιίστημι|v-papamn-
κύκλῳ|κύκλος|n-s---md-
κατέλευσαν|καταλεύω|v3paia---
ἐσελθόντας|εἰσέρχομαι|v-papama-
πάθος|πάθος|n-s---nn-
Φαληρόνδε|Φαληρόνδε|d--------
Φωκέων|Φωκεύς|n-p---mg-
στρατευσάντων|στρατεύω|v-papamg-
Δωριᾶς|Δωριεύς|n-p---ma-
Βοιὸν|βοιόν|n-s---na-
Κυτίνιον|Κυτίνιον|n-s---na-
Ἐρινεόν|ἐρινεόν|n-s---na-
ἑλόντων|αἱρέω|v-papamg-
πολισμάτων|πόλισμα|n-p---ng-
Νικομήδους|Νικομήδης|n-s---mg-
Πλειστοάνακτος|Πλειστόαναξ|n-s---mg-
νέου|νέος|a-s---mg-
ἡγουμένου|ἡγέομαι|v-sppemg-
ἐβοήθησαν|βοηθέω|v3paia---
Δωριεῦσιν|Δωριεύς|n-p---md-
πεντακοσίοις|πεντακόσιοι|a-p---md-
χιλίοις|χίλιοι|a-p---md-
μυρίοις|μυρίος|a-p---md-
Φωκέας|Φωκεύς|n-p---ma-
ἀναγκάσαντες|ἀναγκάζω|v-papamn-
ἀπεχώρουν|ἀποχωρέω|v3piia---
Κρισαίου|Κρισαῖος|a-s---mg-
βούλοιντο|βούλομαι|v3ppoe---
περιπλεύσαντες|περιπλέω|v-papamn-
κωλύσειν|κωλύω|v--fna---
Πηγὰς|Πηγαί|n-p---fa-
πορεύεσθαι|πορεύω|v--pne---
δύσοδός|δύσοδος|a-s---fn-
Γερανεία|Γερανείη|n-s---fn-
ἐφρουρεῖτο|φρουρέω|v3siie---
ᾐσθάνοντο|αἰσθάνομαι|v3piie---
Βοιωτοῖς|Βοιωτός|n-p---md-
περιμείνασι|περιμένω|v-papamd-
σκέψασθαι|σκέπτομαι|v--ane---
ἀσφαλέστατα|ἀσφαλής|a-p---nas
διαπορεύσονται|διαπορεύω|v3pfim---
ἐλπίσαντες|ἐλπίζω|v-papamn-
δῆμόν|δῆμος|n-s---ma-
καταπαύσειν|καταπαύω|v--fna---
οἰκοδομούμενα|οἰκοδομέω|v-pppena-
Ἀργείων|Ἀργεῖος|n-p---mg-
τετρακισχίλιοι|τετρακισχίλιοι|a-p---mn-
μύριοι|μυρίος|a-p---mn-
ἀπορεῖν|ἀπορέω|v--pna---
διέλθωσιν|διέρχομαι|v3pasa---
ἐπεστράτευσαν|ἐπιστρατεύω|v3paia---
δήμου|δῆμος|n-s---mg-
καταλύσεως|κατάλυσις|n-s---fg-
ὑποψίᾳ|ὑποψία|n-s---fd-
ξυμμαχικόν|συμμαχικός|a-s---na-
Τανάγρᾳ|Τάναγρα|n-s---fd-
Βοιωτίας|Βοιωτία|n-s---fg-
πολύς|πολύς|a-s---mn-
δενδροτομήσαντες|δενδροτομέω|v-papamn-
δευτέρᾳ|δεύτερος|a-s---fd-
ἑξηκοστῇ|ἑξηκοστός|a-s---fd-
Βοιωτοὺς|Βοιωτός|n-p---ma-
Οἰνοφύτοις|Οἰνόφυτα|n-p---nd-
Φωκίδος|Φωκίς|n-s---fg-
Ταναγραίων|Ταναγραῖος|n-p---mg-
περιεῖλον|περιαιρέω|v3paia---
Ὀπουντίων|Ὀπούντιοι|n-p---mg-
πλουσιωτάτους|πλούσιος|a-p---mas
ἀπετέλεσαν|ἀποτελέω|v3paia---
περιελόντες|περιαιρέω|v-papamn-
περιέπλευσαν|περιπλέω|v3paia---
Τολμίδου|Τολμίδης|n-s---mg-
Τολμαίου|Τόλμαιος|n-s---mg-
νεώριον|νεώριον|n-s---na-
Χαλκίδα|Χαλκίς|n-s---fa-
Σικυωνίους|Σικυώνιος|n-p---ma-
ἀποβάσει|ἀπόβασις|n-s---fd-
ἐπέμενον|ἐπιμένω|v3piia---
ἰδέαι|ἰδέα|n-p---fn-
Μεγάβαζον|Μεγάβαζος|n-s---ma-
Πέρσην|Πέρσης|n-s---ma-
ἀπαγάγοι|ἀπάγω|v3saoa---
προυχώρει|προχωρέω|v3siia---
ἀνηλοῦτο|ἀναλίσκω|v3siie---
Μεγάβαζος|Μεγάβαζος|n-s---mn-
Ἀσίαν|Ἀσία|n-s---fa-
ἀνεκομίσθη|ἀνακομίζω|v3saip---
Μεγάβυζον|Μεγάβυζος|n-s---ma-
Ζωπύρου|Ζώπυρος|n-s---mg-
Αἰγυπτίους|Αἰγύπτιος|n-p---ma-
ἐξήλασε|ἐξελαύνω|v3saia---
τέλος|τέλος|n-s---na-
Προσωπίτιδα|Προσώπιτις|n-s---fa-
κατέκλῃσε|κατακλείω|v3saia---
ἐπολιόρκει|πολιορκέω|v3siia---
ἓξ|ἕξ|a--------
μῆνας|μείς|n-p---ma-
ξηράνας|ξηραίνω|v-sapamn-
διώρυχα|διῶρυξ|n-s---fa-
παρατρέψας|παρατρέπω|v-sapamn-
ὕδωρ|ὕδωρ|n-s---na-
ξηροῦ|ξηρός|a-s---ng-
ἐποίησε|ποιέω|v3saia---
νήσου|νῆσος|n-s---fg-
διαβὰς|διαβαίνω|v-sapamn-
εἷλε|αἱρέω|v3saia---
ἐφθάρη|φθείρω|v3saip---
πολεμήσαντα|πολεμέω|v-papann-
πορευόμενοι|πορεύω|v-pppemn-
Λιβύης|Λιβύη|n-s---fg-
Κυρήνην|Κυρήνη|n-s---fa-
ἐσώθησαν|σώζω|v3paip---
ἀπώλοντο|ἀπόλλυμι|v3paim---
Αἴγυπτος|Αἴγυπτος|n-s---fn-
βασιλέα|βασιλεύς|n-s---ma-
Ἀμυρταίου|Ἀμυρταῖος|n-s---mg-
ἕλεσι|ἕλος|n-p---nd-
μέγεθός|μέγεθος|n-s---na-
ἕλους|ἕλος|n-s---ng-
ἑλεῖν|αἱρέω|v--ana---
μαχιμώτατοί|μάχιμος|a-p---mns
ἕλειοι|ἕλειος|a-p---mn-
βασιλεύς|βασιλεύς|n-s---mn-
ἔπραξε|πράσσω|v3saia---
προδοσίᾳ|προδοσία|n-s---fd-
ληφθεὶς|λαμβάνω|v-sappmn-
ἀνεσταυρώθη|ἀνασταυρόω|v3saip---
ξυμμαχίδος|συμμαχίς|n-s---fg-
διάδοχοι|διάδοχος|n-p---fn-
πλέουσαι|πλέω|v-pppafn-
Αἴγυπτον|Αἴγυπτος|n-s---fa-
Μενδήσιον|Μενδήσιος|a-s---na-
εἰδότες|οἶδα|v-prpamn-
γεγονότων|γίγνομαι|v-prpang-
οὐδέν|οὐδείς|p-s---na-
ἐπιπεσόντες|ἐπιπίπτω|v-papamn-
πεζοὶ|πεζός|a-p---mn-
διέφυγον|διαφεύγω|v3paia---
ἐτελεύτησεν|τελευτάω|v3saia---
Θεσσαλίας|Θεσσαλία|n-s---fg-
Ὀρέστης|Ὀρέστης|n-s---mn-
Ἐχεκρατίδου|Ἐχεκρατίδης|n-s---mg-
υἱὸς|υἱός|n-s---mn-
φεύγων|φεύγω|v-sppamn-
Φάρσαλον|Φάρσαλος|n-s---ma-
Ὀρέστην|Ὀρέστης|n-s---ma-
ἄπρακτοι|ἄπρακτος|a-p---mn-
Πηγαῖς|Πηγαί|n-p---fd-
ἐπιβάντες|ἐπιβαίνω|v-papamn-
παρέπλευσαν|παραπλέω|v3paia---
Σικυῶνα|Σικυών|n-s---fa-
Περικλέους|Περικλῆς|n-s---mg-
Ξανθίππου|Ξάνθιππος|n-s---mg-
ἀποβάντες|ἀποβαίνω|v-papamn-
προσμείξαντας|προσμείγνυμι|v-papama-
διαπλεύσαντες|διαπλέω|v-papamn-
πέραν|πέραν|d--------
Ἀκαρνανίας|Ἀκαρνανία|n-s---fg-
Οἰνιάδας|Οἰνιάδαι|n-p---fa-
εἷλόν|αἱρέω|v3paia---
διαλιπόντων|διαλείπω|v-papang-
πεντέτεις|πεντέτης|a-p---fn-
Ἑλληνικοῦ|Ἑλληνικός|a-s---mg-
ἐστρατεύοντο|στρατεύω|v3piie---
ἔπλευσαν|πλέω|v3paia---
μεταπέμποντος|μεταπέμπω|v-sppamg-
Κίτιον|Κίτιον|n-s---na-
λιμοῦ|λιμός|n-s---mg-
Κιτίου|Κίτιον|n-s---ng-
Σαλαμῖνος|Σαλαμίς|n-s---fg-
Κύπρῳ|Κύπρος|n-s---fd-
Φοίνιξι|Φοῖνιξ|n-p---md-
Κυπρίοις|Κύπριος|n-p---md-
Κίλιξιν|Κίλιξ|n-p---md-
ἐπεζομάχησαν|πεζομαχέω|v3paia---
ἐλθοῦσαι|ἔρχομαι|v-papafn-
ἱεροῦ|ἱερόν|n-s---na-
ἀποχωρησάντων|ἀποχωρέω|v-papamg-
στρατεύσαντες|στρατεύω|v-papamn-
Φωκεῦσιν|Φωκεύς|n-p---md-
ἐγγενομένου|ἐγγίγνομαι|v-sapmmg-
φευγόντων|φεύγω|v-pppamg-
Ὀρχομενὸν|Ὀρχομενός|n-s---fa-
Χαιρώνειαν|Χαιρώνεια|n-s---fa-
ἄλλ̓|ἄλλος|a-p---na-
ἄττα|τίς|a-p---na-
ἀνδραποδίσαντες|ἀνδραποδίζω|v-papamn-
πορευομένοις|πορεύω|v-pppemd-
Κορωνείᾳ|Κορώνεια|n-s---fd-
ἐπιτίθενται|ἐπιτίθημι|v3ppie---
Ὀρχομενοῦ|Ὀρχομενός|n-s---fg-
Λοκροὶ|Λοκροί|n-p---mn-
ζῶντας|ζάω|v-pppama-
ἐξέλιπον|ἐκλείπω|v3paia---
πᾶσαν|πᾶς|a-s---fa-
κομιοῦνται|κομίζω|v3pfim---
φεύγοντες|φεύγω|v-pppamn-
κατελθόντες|κατέρχομαι|v-papamn-
Εὔβοια|Εὔβοια|n-s---fn-
διαβεβηκότος|διαβαίνω|v-srpamg-
ἠγγέλθη|ἀγγέλλω|v3saip---
ἀφέστηκε|ἀφίστημι|v3sria---
μέλλουσιν|μέλλω|v3ppia---
φρουροὶ|φρουρός|n-p---mn-
εἰσὶν|εἰμί|v3ppia---
ἀπέφυγον|ἀποφεύγω|v3paia---
ἐπαγαγόμενοι|ἐπάγω|v-papmmn-
Περικλῆς|Περικλῆς|n-s---mn-
ἐκόμιζε|κομίζω|v3siia---
Ἐλευσῖνα|Ἐλευσίς|n-s---fa-
Θριῶζε|Θρῖα|d--------
ἐδῄωσαν|δηιόω|v3paia---
Εὔβοιαν|Εὔβοια|n-s---fa-
ἄλλην|ἄλλος|p-s---fa-
κατεστήσαντο|καθίστημι|v3paim---
Ἑστιαιᾶς|Ἑστιαιεύς|n-p---ma-
ἐξοικίσαντες|ἐξοικίζω|v-papamn-
ἀποδόντες|ἀποδίδωμι|v-papamn-
Τροιζῆνα|Τροιζήν|n-s---fa-
Ἀχαΐαν|Ἀχαία|n-s---fa-
ἕκτῳ|ἕκτος|a-s---nd-
Μιλησίοις|Μιλήσιος|n-p---md-
Πριήνης|Πριήνη|n-s---fg-
Μιλήσιοι|Μιλήσιος|n-p---mn-
ξυνεπελάβοντο|συνεπιλαμβάνομαι|v3paim---
ἰδιῶται|ἰδιώτης|n-p---mn-
νεωτερίσαι|νεωτερίζω|v--ana---
πολιτείαν|πολιτεία|n-s---fa-
Σάμον|Σάμος|n-s---fa-
δημοκρατίαν|δημοκρατία|n-s---fa-
ἴσους|ἴσος|a-p---ma-
Λῆμνον|Λῆμνος|n-s---fa-
φρουρὰν|φρουρά|n-s---fa-
ἐγκαταλιπόντες|ἐγκαταλείπω|v-papamn-
ὑπέμειναν|ὑπομένω|v3paia---
ἔφυγον|φεύγω|v3paia---
ξυνθέμενοι|συντίθημι|v-papmmn-
δυνατωτάτοις|δυνατός|a-p---mds
Πισσούθνῃ|Πισσούθνης|n-s---md-
Ὑστάσπου|Ὑστάσπης|n-s---mg-
εἶχε|ἔχω|v3siia---
Σάρδεις|Σάρδεις|n-p---fa-
ξυλλέξαντες|σύν-λέγω|v-papamn-
ἑπτακοσίους|ἑπτακόσιοι|a-p---ma-
διέβησαν|διαβαίνω|v3paia---
δήμῳ|δῆμος|n-s---md-
ἐπανέστησαν|ἐπανίστημι|v3paia---
ἐκκλέψαντες|ἐκκλέπτω|v-papamn-
Λήμνου|Λῆμνος|n-s---fg-
ἐξέδοσαν|ἐκδίδωμι|v3paia---
ἐπί|ἐπί|r--------
Μίλητον|Μίλητος|n-s---fa-
στρατεύειν|στρατεύω|v--pna---
ξυναπέστησαν|συναφίστημι|v3paia---
Βυζάντιοι|Βυζάντιος|n-p---mn-
ἑκκαίδεκα|ἑκκαίδεκα|a--------
Καρίας|Καρία|n-s---fg-
προσκοπὴν|προσκοπή|n-s---fa-
Φοινισσῶν|Φοῖνιξ|n-p---fg-
οἰχόμεναι|οἴχομαι|v-pppefn-
Χίου|Χίος|n-s---fg-
Λέσβου|Λέσβος|n-s---fg-
περιαγγέλλουσαι|περιαγγέλλω|v-pppafn-
τέσσαρσι|τέσσαρες|n-p---fd-
δεκάτου|δέκατος|a-s---mg-
Τραγίᾳ|Τραγίη|n-s---fd-
στρατιώτιδες|στρατιῶτις|n-p---fn-
πᾶσαι|πᾶς|a-p---fn-
Μιλήτου|Μίλητος|n-s---fg-
τρισὶ|τρεῖς|a-p---nd-
τείχεσι|τεῖχος|n-p---nd-
λαβὼν|λαμβάνω|v-sapamn-
ἐφορμουσῶν|ἐφορμάω|v-pppafg-
Καύνου|Καῦνος|n-s---fg-
ἐσαγγελθέντων|εἰσαγγέλλω|v-pappng-
Φοίνισσαι|Φοῖνιξ|n-p---fn-
πλέουσιν|πλέω|v3ppia---
Στησαγόρας|Στησαγόρας|n-s---mn-
Φοινίσσας|Φοῖνιξ|n-p---fa-
Σάμιοι|Σάμιος|n-p---mn-
ἐξαπιναίως|ἐξαπίναιος|d--------
ἀφάρκτῳ|ἄφρακτος|a-s---nd-
προφυλακίδας|προφυλακὶς|n-p---fa-
ἀνταναγομένας|ἀντανάγω|v-pppefa-
ἐσεκομίσαντο|εἰσκομίζω|v3paim---
ἐξεκομίσαντο|ἐκκομίζω|v3paim---
ἐλθόντος|ἔρχομαι|v-sapamg-
κατεκλῄσθησαν|κατακλείω|v3paip---
προσεβοήθησαν|προσβοηθέω|v3paia---
Θουκυδίδου|Θουκυδίδης|n-s---mg-
Ἅγνωνος|Ἅγνων|n-s---mg-
Φορμίωνος|Φορμίων|n-s---mg-
Τληπολέμου|Τληπόλεμος|n-s---mg-
Ἀντικλέους|Ἀντικλῆς|n-s---mg-
βραχεῖαν|βραχύς|a-s---fa-
ἀντίσχειν|ἀντί-ἴσχω|v--pna---
ἐξεπολιορκήθησαν|ἐκπολιορκέω|v3paip---
ἐνάτῳ|ἔνατος|a-s---md-
μηνὶ|μείς|n-s---md-
δόντες|δίδωμι|v-papamn-
ἀναλωθέντα|ἀναλίσκω|v-pappna-
προειρημένα|προερέω|v-prpenn-
Κερκυραϊκὰ|Κερυκυραῖος|a-p---nn-
Ποτειδεατικὰ|Ποτειδεατικός|a-p---nn-
πρόφασις|πρόφασις|n-s---fn-
ξύμπαντα|σύμπας|a-p---nn-
ἔτεσι|ἔτος|n-p---nd-
ἀναχωρήσεως|ἀναχώρησις|n-s---fg-
ἐγκρατεστέραν|ἐγκρατής|a-s---fac
ἐκώλυον|κωλύω|v3piia---
βραχύ|βραχύς|a-s---na-
ἡσύχαζόν|ἡσυχάζω|v3piia---
ταχεῖς|ταχύς|a-p---mn-
ἀναγκάζωνται|ἀναγκάζω|v3ppse---
πολέμοις|πόλεμος|n-p---md-
οἰκείοις|οἰκεῖος|a-p---md-
ἐξειργόμενοι|ἐξέργω|v-pppemn-
ᾔρετο|αἴρω|v3siie---
ἥπτοντο|ἅπτω|v3piie---
ἀνασχετὸν|ἀνασχετός|a-s---na-
ἐπιχειρητέα|ἐπιχειρητέον|a-s---fn-
προθυμίᾳ|προθυμία|n-s---fd-
καθαιρετέα|καθαιρετέος|a-s---fn-
ἰσχύς|ἰσχύς|n-s---fn-
δύνωνται|δύναμαι|v3ppse---
ἀραμένοις|αἴρω|v-papmmd-
διέγνωστο|διαγιγνώσκω|v3slie---
ἐπηρώτων|ἐπερωτάω|v3piia---
πολεμοῦσιν|πολεμόω|v-pppamd-
ἀνεῖλεν|ἀναιρέω|v3saia---
ξυλλήψεσθαι|συλλαμβάνω|v--fnm---
παρακαλούμενος|παρακαλέω|v-sppemn-
ἄκλητος|ἄκλητος|a-s---mn-
ξυνόδου|σύνοδος|n-s---fg-
κατηγοροῦντες|κατηγορέω|v-pppamn-
δεηθέντες|δέω|v-pappmn-
ψηφίσασθαι|ψηφίζομαι|v--ane---
προδιαφθαρῇ|προδιαφθείρω|v3sasp---
αἰτιασαίμεθα|αἰτιάομαι|v1paoe---
ἐψηφισμένοι|ψηφίζω|v-prpemn-
πόλεμόν|πόλεμος|n-s---ma-
ξυνήγαγον|συνάγω|v3paia---
ἴδια|ἴδιος|a-p---na-
νέμοντας|νέμω|v-pppama-
προσκοπεῖν|προσκοπέω|v--pna---
προτιμῶνται|προτιμάω|v3ppie---
ἐνηλλάγησαν|ἐναλλάσσω|v3paip---
οὐχὶ|οὐ|d--------
διδαχῆς|διδαχή|n-s---fg-
φυλάξασθαι|φυλάσσω|v--anm---
πόρῳ|πόρος|n-s---md-
κατῳκημένους|κατοικέω|v-prpema-
ἀμύνωσι|ἀμύνω|v3ppsa---
χαλεπωτέραν|χαλεπός|a-s---fac
ἕξουσι|ἔχω|v3pfia---
κατακομιδὴν|κατακομιδή|n-s---fa-
ὡραίων|ὡραῖος|a-p---ng-
ἀντίληψιν|ἀντίληψις|n-s---fa-
θάλασσα|θάλασσα|n-s---fn-
δίδωσι|δίδωμι|v3spia---
λεγομένων|λέγω|v-pppeng-
κακοὺς|κακός|a-p---ma-
κριτὰς|κριτής|n-p---ma-
πρόοιντο|προίημι|v3paom---
προελθεῖν|προέρχομαι|v--ana---
ὀκνεῖν|ὀκνέω|v--pna---
μεταλαμβάνειν|μεταλαμβάνω|v--pna---
σωφρόνων|σώφρων|a-p---mg-
ἀδικοῖντο|ἀδικέω|v3ppoe---
παρασχὸν|παρέχω|v-sapana-
ξυμβῆναι|συμβαίνω|v--ana---
εὐτυχίᾳ|εὐτυχία|n-s---fd-
ἐπαίρεσθαι|ἐπαίρω|v--pne---
ἡσύχῳ|ἥσυχος|a-s---nd-
ἡδόμενον|ἥδομαι|v-sppema-
ἡδονὴν|ἡδονή|n-s---fa-
ὀκνῶν|ὀκνέω|v-sppamn-
τάχιστ̓|τάχιστος|a-p---na-
ἀφαιρεθείη|ἀφαιρέω|v3saop---
ῥᾳστώνης|ῥᾳστώνη|n-s---fg-
τερπνὸν|τερπνός|a-s---na-
ὀκνεῖ|ὀκνέω|v3spia---
ἡσυχάζοι|ἡσυχάζω|v3spoa---
πλεονάζων|πλεονάζω|v-sppamn-
ἐντεθύμηται|ἐνθυμέομαι|v3srie---
θράσει|θράσις|n-s---fd-
ἀπίστῳ|ἄπιστος|a-s---fd-
ἐπαιρόμενος|ἐπαίρω|v-sppemn-
γνωσθέντα|γιγνώσκω|v-pappnn-
ἀβουλοτέρων|ἄβουλος|a-p---mgc
ἐναντίων|ἐναντίος|a-p---mg-
τυχόντα|τυγχάνω|v-papann-
κατωρθώθη|κατορθόω|v3saip---
βουλευθῆναι|βουλεύω|v--anp---
αἰσχρῶς|αἰσχρός|d--------
ἐνθυμεῖται|ἐνθυμέομαι|v3spie---
πίστει|πίστις|n-s---fd-
ἐπεξέρχεται|ἐπεξέρχομαι|v3spie---
δοξάζομεν|δοξάζω|v1ppia---
ἐγείρομεν|ἐγείρω|v1ppia---
ἀμυνώμεθα|ἀμύνω|v1ppse---
καταθησόμεθα|κατατίθημι|v1pfim---
καιρῷ|καιρός|n-s---md-
ἐπικρατῆσαι|ἐπικρατέω|v--ana---
προύχοντας|προέχω|v-pppama-
ἐμπειρίᾳ|ἐμπειρία|n-s---fd-
πολεμικῇ|πολεμικός|a-s---fd-
παραγγελλόμενα|παραγγέλλω|v-pppena-
ἰόντας|εἶμι|v-pppama-
ἰσχύουσιν|ἰσχύω|v3ppia---
οὐσίας|οὐσία|n-s---fg-
ἐξαρτυσόμεθα|ἐξαρτύω|v1pfim---
Ὀλυμπίᾳ|Ὀλυμπία|n-s---fd-
δάνεισμα|δάνεισμα|n-s---na-
ὑπολαβεῖν|ὑπολαμβάνω|v--ana---
οἷοί|οἷος|a-p---mn-
ἐσμὲν|εἰμί|v1ppia---
ναυβάτας|ναυβάτης|n-p---ma-
ὠνητὴ|ὠνητός|a-s---fn-
οἰκεία|οἰκεῖος|a-s---fn-
πάθοι|πάσχω|v3saoa---
σώμασι|σῶμα|n-p---nd-
ἰσχύουσα|ἰσχύω|v-sppafn-
νίκῃ|νίκη|n-s---fd-
ἁλίσκονται|ἁλίσκομαι|v3ppie---
ἀντίσχοιεν|ἀντέχω|v3paoa---
ἐπιστήμην|ἐπιστήμη|n-s---fa-
καταστήσωμεν|καθίστημι|v1pasa---
εὐψυχίᾳ|εὐψυχία|n-s---fd-
δήπου|δήπου|d--------
περιεσόμεθα|περίειμι|v1pfim---
ἀγαθόν|ἀγαθός|a-s---na-
διδαχῇ|διδαχή|n-s---fd-
προύχουσι|προέχω|v3ppia---
καθαιρετὸν|καθαιρετός|a-s---nn-
μελέτῃ|μελέτη|n-s---fd-
οἴσομεν|φέρω|v1pfia---
δουλείᾳ|δουλεία|n-s---fd-
ἀπεροῦσιν|ἀπεράω|v3ppia---
τιμωρούμενοι|τιμωρέω|v-pppemn-
σῴζεσθαι|σώζω|v--pne---
δαπανήσομεν|δαπανάω|v1pasa---
ἀφαιρεθέντες|ἀφαιρέω|v-pappmn-
ὑπάρχουσι|ὑπάρχω|v3ppia---
ἀπόστασις|ἀπόστασις|n-s---fn-
παραίρεσις|παραίρεσις|n-s---fn-
ἰσχύουσι|ἰσχύω|v3ppia---
ἐπιτειχισμὸς|ἐπιτειχισμός|n-s---mn-
προΐδοι|προεῖδον|v3saoa---
χωρεῖ|χωρέω|v3spia---
τεχνᾶται|τεχνάομαι|v3spie---
παρατυγχάνον|παρατυγχάνω|v-sppana-
εὐοργήτως|εὐόργητος|d--------
προσομιλήσας|προσομιλέω|v-sapamn-
βεβαιότερος|βέβαιος|a-s---mnc
ὀργισθεὶς|ὀργίζω|v-sappmn-
πταίει|πταίω|v3spia---
ἐνθυμώμεθα|ἐνθυμέομαι|v1ppse---
ἀντιπάλους|ἀντίπαλος|a-p---ma-
διαφοραί|διαφορά|n-p---fn-
οἰστὸν|οἰστός|a-s---nn-
ξύμπαντάς|σύμπας|a-p---ma-
ἄστυ|ἄστυ|n-s---na-
ἀπόνως|ἄπονος|d--------
χειρώσονται|χειρόω|v3pfim---
ἧσσαν|ἧσσα|n-s---fa-
δεινόν|δεινός|a-s---nn-
ἀκοῦσαι|ἀκούω|v--ana---
ἴστω|οἶδα|v3srma---
φέρουσαν|φέρω|v-sppafa-
ἄντικρυς|ἄντικρυς|d--------
ἐνδοιασθῆναι|ἐνδοιάζω|v--anp---
τοσάσδε|τοσόσδε|a-p---fa-
μιᾶς|εἷς|a-s---fg-
κακοπαθεῖν|κακοπαθέω|v--pna---
δοκοῖμεν|δοκέω|v1ppoa---
δειλίαν|δειλία|n-s---fa-
ἀνέχεσθαι|ἀνέχω|v--pne---
πατέρων|πατήρ|n-p---mg-
φαίνεσθαι|φαίνω|v--pne---
ἠλευθέρωσαν|ἐλευθερόω|v3paia---
βεβαιοῦμεν|βεβαιόω|v1ppia---
αὐτό|αὐτός|p-s---na-
ἐῶμεν|ἐάω|v1ppia---
ἐγκαθεστάναι|ἐγκαθίστημι|v--rna---
μονάρχους|μόναρχος|n-p---ma-
καταλύειν|καταλύω|v--pna---
ξυμφορῶν|ξυμφορά|n-p---fg-
ἀπήλλακται|ἀπαλλάσσω|v3srie---
ἀξυνεσίας|ἀσυνεσία|n-s---fg-
μαλακίας|μαλακία|n-s---fg-
ἀμελείας|ἀμέλεια|n-s---fg-
πεφευγότες|φεύγω|v-prpamn-
πλείστους|πλεῖστος|a-p---ma-
βλάψασαν|βλάπτω|v-sapafa-
καταφρόνησιν|καταφρόνησις|n-s---fa-
κεχωρήκατε|χωρέω|v2pria---
ἣ|ὅς|p-s---fn-
σφάλλειν|σφάλλω|v--pna---
ἐναντίον|ἐναντίος|a-s---nn-
ἀφροσύνη|ἀφροσύνη|n-s---fn-
μετωνόμασται|μετονομάζω|v3srie---
προγεγενημένα|προγίγνομαι|v-prpena-
μακρότερον|μακρός|a-------c
ξυμφέρει|συμφέρω|v3spia---
παροῦσι|πάρειμι|v-pppand-
ἐπιταλαιπωρεῖν|ἐπιταλαιπωρέω|v--pna---
πάτριον|πάτριος|a-s---nn-
ἀρετὰς|ἀρετή|n-p---fa-
μεταβάλλειν|μεταβάλλω|v--pna---
ἔθος|ἔθος|n-s---na-
προφέρετε|προφέρω|v2ppia---
ἐκτήθη|κτέομαι|v3saie---
περιουσίᾳ|περιουσία|n-s---fd-
ἀπολέσθαι|ἀπόλλυμι|v--anm---
θαρσοῦντας|θαρσέω|v-pppama-
θεοῦ|θεός|n-s---mg-
χρήσαντος|χράω|v-sapamg-
ὑποσχομένου|ὑπισχνέομαι|v-sapmmg-
ξυναγωνιουμένης|συναγωνίζομαι|v-sfpefg-
πρότεροι|πρότερος|a-p---mn-
θεὸς|θεός|n-s---mn-
παραβεβάσθαι|παρά-βάζω|v--rne---
ἠδικημέναις|ἀδικέω|v-prpefd-
βοηθήσετε|βοηθέω|v2pfia---
ἐπιόντες|ἔπειμι|v-pppamn-
ὑπάρχον|ὑπάρχω|v-sppana-
παραινούντων|παραινέω|v-pppamg-
βεβαιότατον|βέβαιος|a-s---nns
ἰδιώταις|ἰδιώτης|n-p---md-
μέλλετε|μέλλω|v2ppma---
Δωριεῦσι|Δωριεύς|n-p---md-
πολιορκουμένοις|πολιορκέω|v-pppemd-
ἐλευθερίαν|ἐλευθερία|n-s---fa-
ἐνδέχεται|ἐνδέχομαι|v3spie---
περιμένοντας|περιμένω|v-pppama-
γνωσθησόμεθα|γιγνώσκω|v1pfip---
ξυνελθόντες|συνέρχομαι|v-papamn-
τολμῶντες|τολμάω|v-pppamn-
ἀνάγκην|ἀνάγκη|n-s---fa-
ἀφῖχθαι|ἀφικνέομαι|v--rne---
ψηφίσασθε|ψηφίζομαι|v2pame---
φοβηθέντες|φοβέω|v-pappmn-
πλείονος|πλείων|a-s---ngc
ἐπιθυμήσαντες|ἐπιθυμέω|v-papamn-
εἰρήνη|εἰρήνη|n-s---fn-
βεβαιοῦται|βεβαιόω|v3spie---
ἡσυχίας|ἡσυχία|n-s---fg-
πολεμῆσαι|πολεμέω|v--ana---
ἀκίνδυνον|ἀκίνδυνος|a-s---nn-
καθεστηκυῖαν|καθίστημι|v-srpafa-
καθεστάναι|καθίστημι|v--rna---
διανοεῖσθαι|διανοέω|v--pne---
παραστησώμεθα|παρίστημι|v1pasm---
ἀκινδύνως|ἀκίνδυνος|d--------
οἰκῶμεν|οἰκέω|v1ppsa---
ἐλευθερώσωμεν|ἐλευθερόω|v1pasa---
ἐπήγαγον|ἐπάγω|v3paia---
ἐλάσσονι|ἐλάσσων|a-s---fdc
δεδογμένον|δοκέω|v-srpena-
ἐπιχειρεῖν|ἐπιχειρέω|v--pna---
ἀπαρασκεύοις|ἀπαράσκευος|a-p---md-
ἐκπορίζεσθαι|ἐκπορίζω|v--pne---
πρόσφορα|πρόσφορος|a-p---nn-
μέλλησιν|μέλλησις|n-s---fa-
καθισταμένοις|καθίστημι|v-pppemd-
ἐνιαυτὸς|ἐνιαυτός|n-s---mn-
διετρίβη|διατρίβω|v3saip---
ἐπρεσβεύοντο|πρεσβεύω|v3piie---
ἐσακούωσιν|εἰσακούω|v3ppsa---
ἄγος|ἄγος|n-s---na-
ἐλαύνειν|ἐλαύνω|v--pna---
τοιόνδε|τοιόσδε|p-s---nn-
Κύλων|Κύλων|n-s---mn-
Ὀλυμπιονίκης|Ὀλυμπιονίκης|n-s---mn-
εὐγενής|εὐγενής|a-s---mn-
δυνατός|δυνατός|a-s---mn-
ἐγεγαμήκει|γαμέω|v3slia---
θυγατέρα|θυγάτηρ|n-s---fa-
Θεαγένους|Θεαγένης|n-s---mg-
Μεγαρέως|Μεγαρεύς|n-s---mg-
ἀνδρός|ἀνήρ|n-s---mg-
ἐτυράννει|τυραννεύω|v3siia---
χρωμένῳ|χράω|v-sppemd-
Κύλωνι|Κύλων|n-s---md-
μεγίστῃ|μέγας|a-s---fds
ἑορτῇ|ἑορτή|n-s---fd-
καταλαβεῖν|καταλαμβάνω|v--ana---
ἀκρόπολιν|ἀκρόπολις|n-s---fa-
παρά|παρά|r--------
ἀναπείσας|ἀναπείθω|v-sapamn-
ἐπῆλθεν|ἐπέρχομαι|v3saia---
Ὀλύμπια|Ὀλυμπιεῖον|n-p---nn-
κατέλαβε|καταλαμβάνω|v3saia---
τυραννίδι|τυραννίς|n-s---fd-
νομίσας|νομίζω|v-sapamn-
ἑορτήν|ἑορτή|n-s---fa-
προσήκειν|προσήκω|v--pna---
νενικηκότι|νικάω|v-srpamd-
ἑορτὴ|ἑορτή|n-s---fn-
εἴρητο|ἐρῶ|v3slie---
κατενόησε|κατανοέω|v3saia---
ἐδήλου|δηλόω|v3siia---
Διάσια|Διάσιος|a-s---fn-
Μειλιχίου|Μειλίχιος|a-s---mg-
θύουσι|θύω|v3ppia---
ἱερεῖα|ἱερεῖον|n-p---na-
ἁγνὰ|ἁγνός|a-p---nn-
θύματα|θῦμα|n-p---na-
γιγνώσκειν|γιγνώσκω|v--pna---
ἐπεχείρησε|ἐπιχειρέω|v3saia---
ἐβοήθησάν|βοηθέω|v3paia---
ἀγρῶν|ἀγρός|n-p---mg-
ἐγγιγνομένου|ἐγγίγνομαι|v-sppemg-
τρυχόμενοι|τρύχω|v-pppemn-
προσεδρίᾳ|προσεδρεία|n-s---fd-
πολλοί|πολύς|a-p---mn-
ἐπιτρέψαντες|ἐπιτρέπω|v-papamn-
ἐννέα|ἐννέα|a--------
αὐτοκράτορσι|αὐτοκράτωρ|n-p---md-
διαθεῖναι|διατίθημι|v--ana---
διαγιγνώσκωσιν|διαγιγνώσκω|v3ppsa---
πολιτικῶν|πολιτικός|a-p---ng-
Κύλωνος|Κύλων|n-s---mg-
φλαύρως|φλαῦρος|d--------
σίτου|σῖτος|n-s---mg-
ὕδατος|ὕδωρ|n-s---ng-
ἀδελφὸς|ἀδελφός|n-s---mn-
ἐκδιδράσκουσιν|ἐκδιδράσκω|v3ppia---
ἀπέθνῃσκον|ἀποθνήσκω|v3piia---
καθίζουσιν|καθίζω|v3ppia---
βωμὸν|βωμός|n-s---ma-
ἀκροπόλει|ἀκρόπολις|n-s---fd-
ἐπιτετραμμένοι|ἐπιτρέπω|v-prpemn-
ἀποθνῄσκοντας|ἀποθνήσκω|v-pppama-
ἱερῷ|ἱερόν|n-s---nd-
κακὸν|κακός|a-s---na-
ποιήσουσιν|ποιέω|v3pasa---
ἀπαγαγόντες|ἀπάγω|v-papamn-
καθεζομένους|κατά-καθέζομαι|v-pppema-
σεμνῶν|σεμνός|a-p---mg-
βωμοῖς|βωμός|n-p---md-
παρόδῳ|πάροδος|n-s---fd-
ἀπεχρήσαντο|ἀπό-χράω|v3paim---
ἐναγεῖς|ἐναγής|a-p---mn-
ἀλιτήριοι|ἀλιτήριος|a-p---mn-
ἐκεῖνοί|ἐκεῖνος|p-p---mn-
ἐκαλοῦντο|καλέω|v3piie---
ἤλασαν|ἐλαύνω|v3paia---
ἤλασε|ἐλαύνω|v3saia---
Κλεομένης|Κλεομένης|n-s---mn-
Λακεδαιμόνιος|Λακεδαιμόνιος|a-s---mn-
στασιαζόντων|στασιάζω|v-pppamg-
ἐλαύνοντες|ἐλαύνω|v-pppamn-
ὀστᾶ|ὀστέον|n-p---na-
ἀνελόντες|ἀναιρέω|v-papamn-
ἐξέβαλον|ἐκβάλλω|v3paia---
κατῆλθον|κατέρχομαι|v3paia---
τιμωροῦντες|τιμωρέω|v-pppamn-
Περικλέα|Περικλῆς|n-s---ma-
προσεχόμενον|προσέχω|v-sppema-
μητέρα|μήτηρ|n-s---fa-
ἐκπεσόντος|ἐκπίτνω|v-sapamg-
προχωρεῖν|προχωρέω|v--pna---
διαβολὴν|διαβολή|n-s---fa-
οἴσειν|φέρω|v--fna---
ξυμφορὰν|συμφορά|n-s---fa-
δυνατώτατος|δυνατός|a-s---mns
ἠναντιοῦτο|ἐναντιόομαι|v3siie---
εἴα|ἐάω|v3siia---
ὑπείκειν|ὑπείκω|v--pna---
ὥρμα|ὁρμάω|v3siia---
ἀντεκέλευον|ἀντικελεύω|v3piia---
Ταινάρου|Ταίναρος|n-s---fg-
ἀναστήσαντές|ἀνίστημι|v-papamn-
Ποσειδῶνος|Ποσειδῶν|n-s---mg-
ἱκέτας|ἱκέτης|n-p---ma-
νομίζουσι|νομίζω|v3ppia---
σεισμὸν|σεισμός|n-s---ma-
Σπάρτῃ|Σπάρτη|n-s---fd-
Χαλκιοίκου|χαλκίοικος|a-s---fg-
μεταπεμφθεὶς|μεταπέμπω|v-sappmn-
Σπαρτιατῶν|Σπαρτιάτης|n-p---mg-
Ἑλλησπόντῳ|Ἑλλήσποντος|n-s---md-
κριθεὶς|κρίνω|v-sappmn-
ἀπελύθη|ἀπολύω|v3saip---
δημοσίᾳ|δημοσίᾳ|d--------
τριήρη|τριήρης|n-s---fa-
Ἑρμιονίδα|Ἑρμιονίς|n-s---fa-
ἀφικνεῖται|ἀφικνέομαι|v3spie---
Ἑλλήσποντον|Ἑλλήσποντος|n-s---ma-
ἐπεχείρησεν|ἐπιχειρέω|v3saia---
ἐφιέμενος|ἐφίημι|v-sppemn-
εὐεργεσίαν|εὐεργεσία|n-s---fa-
κατέθετο|κατατίθημι|v3saim---
πράγματος|πρᾶγμα|n-s---ng-
παρουσίᾳ|παρουσία|n-s---fd-
Κύπρου|Κύπρος|n-s---fg-
προσήκοντές|προσήκω|v-pppamn-
ἑάλωσαν|ἁλίσκομαι|v3paia---
αὐτῳ|αὐτός|p-s---nd-
ἔλαβεν|λαμβάνω|v3saia---
ἀποπέμπει|ἀποπέμπω|v3spia---
βασιλεῖ|βασιλεύς|n-s---md-
ἀπέδρασαν|ἀποδιδράσκω|v3paia---
ἔπρασσε|πράσσω|v3siia---
Γογγύλου|Γογγύλος|n-s---mg-
Ἐρετριῶς|Ἐρετριεύς|n-s---mg-
ᾧπερ|ὅς|p-s---md-
ἐπέτρεψε|ἐπιτρέπω|v3saia---
ἔπεμψε|πέμπω|v3saia---
ἐπιστολὴν|ἐπιστολή|n-s---fa-
Γόγγυλον|Γόγγυλος|n-s---ma-
φέροντα|φέρω|v-sppama-
ἐνεγέγραπτο|ἐγγράφω|v3slie---
ἀνηυρέθη|ἀνευρίσκω|v3saip---
ἡγεμὼν|ἡγεμών|n-s---mn-
σοι|σύ|p2s----d-
δορὶ|δόρυ|n-s---nd-
ἑλών|αἱρέω|v-sapamn-
ποιοῦμαι|ποιέω|v1spie---
σοὶ|σύ|p2s----d-
σὴν|σός|a-s---fa-
γῆμαι|γαμέω|v--ana---
Σπάρτην|Σπάρτη|n-s---fa-
ὑποχείριον|ὑποχείριος|a-s---fa-
ποιῆσαι|ποιέω|v--ana---
δυνατὸς|δυνατός|a-s---mn-
δοκῶ|δοκέω|v1spia---
σοῦ|σύ|p2s----g-
σε|σύ|p2s----a-
ἀρέσκει|ἀρέσκω|v3spia---
πέμπε|πέμπω|v3siia---
ποιησόμεθα|ποιέω|v1pfim---
τοσαῦτα|τοσοῦτος|p-p---na-
γραφὴ|γραφὴ|n-s---fn-
Ξέρξης|Ξέρξης|n-s---mn-
ἥσθη|ἥδομαι|v3saip---
ἐπιστολῇ|ἐπιστολή|n-s---fd-
ἀποστέλλει|ἀποστέλλω|v3spia---
Ἀρτάβαζον|Ἀρτάβαζος|n-s---ma-
Φαρνάκου|Φαρνάκης|n-s---mg-
Δασκυλῖτιν|Δασκυλῖτις|n-s---fa-
σατραπείαν|σατραπεία|n-s---fa-
Μεγαβάτην|Μεγαβάτης|n-s---ma-
ἀπαλλάξαντα|ἀπαλλάσσω|v-sapama-
ἀντεπετίθει|ἀντεπιτίθημι|v3siia---
διαπέμψαι|διαπέμπω|v--ana---
σφραγῖδα|σφραγίς|n-s---fa-
ἀποδεῖξαι|ἀποδείκνυμι|v--ana---
παραγγέλλῃ|παραγγέλλω|v3spsa---
πιστότατα|πιστός|a-p---nas
διέπεμψεν|διαπέμπω|v3saia---
ἀντενεγέγραπτο|ἀντεγγράφω|v3slie---
λέγει|λέγω|v3spia---
οὕς|ὅς|p-p---ma-
Βυζαντίου|Βυζάντιος|n-s---ng-
ἔσωσας|σώζω|v2saia---
κείσεταί|κεῖμαι|v3sfim---
ἡμετέρῳ|ἡμέτερος|a-s---md-
οἴκῳ|οἶκος|n-s---md-
ἀνάγραπτος|ἀνάγραπτος|a-s---fn-
ἀρέσκομαι|ἀρέσκω|v1spie---
νὺξ|νύξ|n-s---fn-
ἡμέρα|ἡμέρα|n-s---fn-
ἐπισχέτω|ἐπίσχω|v3spma---
ἀνεῖναι|ἀνίημι|v--ana---
ὑπισχνῇ|ὑπισχνέομαι|v2spie---
χρυσοῦ|χρυσός|n-s---mg-
ἀργύρου|ἄργυρος|n-s---mg-
δαπάνῃ|δαπάνη|n-s---fd-
κεκωλύσθω|κωλύω|v3srme---
παραγίγνεσθαι|παραγίγνομαι|v--pne---
Ἀρταβάζου|Ἀρτάβαζος|n-s---mg-
ἀνδρὸς|ἀνήρ|n-s---mg-
ἀγαθοῦ|ἀγαθός|a-s---mg-
ὅν|ὅς|p-s---ma-
ἔπεμψα|πέμπω|v1saia---
πρᾶσσε|πράσσω|v2spma---
θαρσῶν|θαρσέω|v-sppamn-
ἐμὰ|ἐμός|a-p---na-
σὰ|σός|a-p---na-
κάλλιστα|καλός|a-p---na-
γράμματα|γράμμα|n-p---na-
ἀξιώματι|ἀξίωμα|n-s---nd-
Πλαταιᾶσιν|Πλαταιᾶσι|d--------
ἦρτο|αἴρω|v3slie---
καθεστῶτι|καθίστημι|v-srpamd-
βιοτεύειν|βιοτεύω|v--pna---
σκευάς|σκευή|n-p---fa-
Μηδικὰς|Μηδικός|a-p---fa-
ἐνδυόμενος|ἐνδύω|v-sppemn-
ἐξῄει|ἔξειμι|v3siia---
πορευόμενον|πορεύω|v-sppema-
Αἰγύπτιοι|Αἰγύπτιος|n-p---mn-
ἐδορυφόρουν|δορυφορέω|v3piia---
τράπεζάν|τράπεζα|n-s---fa-
Περσικὴν|Περσικός|a-s---fa-
παρετίθετο|παρατίθημι|v3siie---
κατέχειν|κατέχω|v--pna---
διάνοιαν|διάνοια|n-s---fa-
βραχέσι|βραχύς|a-p---nd-
προυδήλου|προδηλόω|v3siia---
μειζόνως|μέγας|d-------c
ἔμελλε|μέλλω|v3siia---
πράξειν|πράσσω|v--fna---
δυσπρόσοδόν|δυσπρόσοδος|a-s---ma-
αὑτὸν|ἑαυτοῦ|p-s---ma-
παρεῖχε|παρέχω|v3siia---
χαλεπῇ|χαλεπός|a-s---fd-
ἐχρῆτο|χράομαι|v3siie---
δύνασθαι|δύναμαι|v--pne---
μετέστη|μεθίστημι|v3saia---
ἀνεκάλεσαν|ἀνακαλέω|v3paia---
Ἑρμιονίδι|Ἑρμιονίς|n-s---fd-
νηὶ|ναῦς|n-s---fd-
δεύτερον|δεύτερος|a-s---na-
ἐκπλεύσας|ἐκπλέω|v-sapamn-
κελευσάντων|κελεύω|v-papamg-
ποιῶν|ποιέω|v-sppamn-
ἐκπολιορκηθεὶς|ἐκπολιορκέω|v-sappmn-
ἐπανεχώρει|ἐπαναχωρέω|v3siia---
Κολωνὰς|Κολώνη|n-p---fa-
Τρῳάδας|Τρῳάς|n-p---fa-
ἱδρυθεὶς|ἱδρύω|v-sappmn-
πράσσων|πράσσω|v-sppamn-
ἐσηγγέλλετο|εἰσαγγέλλω|v3saim---
ἀγαθῷ|ἀγαθός|a-s---nd-
μονὴν|μονή|n-s---fa-
ποιούμενος|ποιέω|v-sppemn-
ἔφοροι|ἔφορος|n-p---mn-
σκυτάλην|σκυτάλη|n-s---fa-
κήρυκος|κῆρυξ|n-s---mg-
λείπεσθαι|λείπω|v--pne---
Σπαρτιάτας|Σπαρτιάτης|n-p---ma-
προαγορεύειν|προαγορεύω|v--pna---
ὕποπτος|ὕποπτος|a-s---mn-
χρήμασι|χρῆμα|n-p---nd-
διαλύσειν|διαλύω|v--fna---
ἀνεχώρει|ἀναχωρέω|v3siia---
εἱρκτὴν|εἱρκτή|n-s---fa-
ἐσπίπτει|εἰσπίπτω|v3spia---
ἐφόροις|ἔφορος|n-p---md-
δρᾶσαι|δράω|v--ana---
διαπραξάμενος|διαπράσσω|v-sapmmn-
ἐξῆλθε|ἐξέρχομαι|v3saia---
ἐλέγχειν|ἐλέγχω|v--pna---
Σπαρτιᾶται|Σπαρτιάτης|n-p---mn-
πιστεύσαντες|πιστεύω|v-papamn-
ἐτιμωροῦντο|τιμωρέω|v3piie---
βασιλείου|βασίλειος|a-s---ng-
τιμὴν|τιμή|n-s---fa-
Πλείσταρχον|Πλείσταρχος|n-s---ma-
Λεωνίδου|Λεωνίδας|n-s---mg-
νέον|νέος|a-s---ma-
ἀνεψιὸς|ἀνεψιός|n-s---mn-
ἐπετρόπευεν|ἐπί-τροπεύω|v3siia---
παρανομίᾳ|παρανομία|n-s---fd-
ζηλώσει|ζήλωσις|n-s---fd-
ἴσος|ἴσος|a-s---mn-
ἀνεσκόπουν|ἀνασκοπέω|v3piia---
ἐξεδεδιῄτητο|ἐκδιαιτάω|v3slie---
νομίμων|νόμιμος|a-p---ng-
τρίποδά|τρίπους|n-s---ma-
ἀνέθεσαν|ἀνατίθημι|v3paia---
ἀκροθίνιον|ἀκροθίνιον|n-s---na-
ἠξίωσεν|ἀξιόω|v3saia---
ἐπιγράψασθαι|ἐπιγράφω|v--anm---
ἐλεγεῖον|ἐλεγεῖον|n-s---na-
ἀρχηγὸς|ἀρχηγός|a-s---mn-
ὤλεσε|ὄλλυμι|v3saia---
Φοίβῳ|Φοῖβος|n-s---md-
μνῆμ̓|μνῆμα|n-s---na-
ἐξεκόλαψαν|ἐκκολάπτω|v3paia---
τρίποδος|τρίπους|n-s---mg-
ἐπέγραψαν|ἐπιγράφω|v3paia---
ὀνομαστὶ|ὀνομαστί|d--------
ξυγκαθελοῦσαι|συγκαθαιρέω|v-papafn-
ἀνάθημα|ἀνάθημα|n-s---na-
ἀδίκημα|ἀδίκημα|n-s---nn-
τότ̓|τότε|d--------
ἐπεί|ἐπεί|c--------
παρόμοιον|παρόμοιος|a-s---na-
πραχθῆναι|πράσσω|v--anp---
διανοίᾳ|διάνοια|n-s---fd-
Εἵλωτας|Εἵλως|n-p---ma-
ἐλευθέρωσίν|ἐλευθέρωσις|n-s---fa-
ὑπισχνεῖτο|ὑπισχνέομαι|v3siie---
ξυνεπαναστῶσι|συνεπανίστημι|v3pasa---
ξυγκατεργάσωνται|συγκατεργάζομαι|v3pase---
μηνυταῖς|μηνυτής|n-p---md-
ἠξίωσαν|ἀξιόω|v3paia---
νεώτερόν|νεώτερος|a-s---na-
εἰώθασιν|ἔθω|v3pria---
Σπαρτιάτου|Σπαρτιάτης|n-s---mg-
ἀναμφισβητήτων|ἀναμφισβήτητος|a-p---ng-
βουλεῦσαί|βουλεύω|v--ana---
ἀνήκεστον|ἀνήκεστος|a-s---na-
μέλλων|μέλλω|v-sppamn-
τελευταίας|τελευταῖος|a-p---fa-
ἐπιστολὰς|ἐπιστολή|n-p---fa-
κομιεῖν|κομίζω|v--fna---
Ἀργίλιος|Ἀργίλιος|n-s---mn-
παιδικά|παιδικόν|n-p---nn-
πιστότατος|πιστός|a-s---mns
ἐκείνῳ|ἐκεῖνος|p-s---md-
μηνυτὴς|μηνυτής|n-s---mn-
δείσας|δείδω|v-sapamn-
ἐνθύμησίν|ἐνθύμησις|n-s---fa-
ἀγγέλων|ἄγγελος|n-p---mg-
ἀφίκετο|ἀφικνέομαι|v3saim---
παρασημηνάμενος|παρασημαίνομαι|v-sapmmn-
ψευσθῇ|ψεύδω|v3sasp---
ἐκεῖνός|ἐκεῖνος|p-s---mn-
μεταγράψαι|μεταγράφω|v--ana---
αἰτήσῃ|αἰτέω|v3sasa---
ἐπιγνῷ|ἐπιγιγνώσκω|v3sasa---
λύει|λύω|v3spia---
ἐπιστολάς|ἐπιστολή|n-p---fa-
ὑπονοήσας|ὑπονοέω|v-sapamn-
τοιοῦτον|τοιοῦτος|a-s---na-
προσεπεστάλθαι|προσεπιστέλλω|v--rne---
ηὗρεν|εὑρίσκω|v3saia---
ἐγγεγραμμένον|ἐγγράφω|v-srpena-
κτείνειν|κτείνω|v--pna---
δείξαντος|δείκνυμι|v-sapamg-
ἐπίστευσαν|πιστεύω|v3paia---
αὐτήκοοι|αὐτήκοος|a-p---mn-
βουληθέντες|βούλομαι|v-pappmn-
λέγοντος|λέγω|v-sppamg-
Ταίναρον|Ταίναρος|n-s---fa-
ἱκέτου|ἱκέτης|n-s---mg-
οἰχομένου|οἴχομαι|v-sppemg-
σκηνησαμένου|σκηνέω|v-sapmmg-
διπλῆν|διπλόος|a-s---fa-
διαφράγματι|διάφραγμα|n-s---nd-
καλύβην|καλύβη|n-s---fa-
ἐντός|ἐντός|d--------
ἔκρυψε|κρύπτω|v3saia---
ἐρωτῶντος|ἐρωτάω|v-sppamg-
ἱκετείας|ἱκετεία|n-p---fa-
αἰτιωμένου|αἰτιάομαι|v-sppemg-
γραφέντα|γράφω|v-pappna-
τἆλλ̓|ἄλλος|p-p---na-
ἀποφαίνοντος|ἀποφαίνω|v-sppamg-
διακονίαις|διακονία|n-p---fd-
παραβάλοιτο|παραβάλλω|v3saom---
προτιμηθείη|προτιμάω|v3saop---
διακόνων|διάκονος|n-p---mg-
ἀκείνου|ἐκεῖνος|p-s---mg-
ξυνομολογοῦντος|συνομολογέω|v-sppamg-
παρόντος|πάρειμι|v-sppang-
ἐῶντος|ἐάω|v-sppamg-
πίστιν|πίστις|n-s---fa-
διδόντος|δίδωμι|v-sppamg-
ἀναστάσεως|ἀνάστασις|n-s---fg-
ἀξιοῦντος|ἀξιόω|v-sppamg-
πρασσόμενα|πράσσω|v-pppena-
διακωλύειν|διακωλύω|v--pna---
ξύλληψιν|σύλληψις|n-s---fa-
ξυλληφθήσεσθαι|συλλαμβάνω|v--fnp---
ἑνὸς|εἷς|n-s---mg-
πρόσωπον|πρόσωπον|n-s---na-
προσιόντος|πρόσειμι|v-sppamg-
εἶδε|εἶδον|v3saia---
γνῶναι|γιγνώσκω|v--ana---
ἐχώρει|χωρέω|v3siia---
νεύματι|νεῦμα|n-s---nd-
χρησαμένου|χράω|v-sapmmg-
δηλώσαντος|δηλόω|v-sapamg-
εὐνοίᾳ|εὔνοια|n-s---fd-
χωρῆσαι|χωρέω|v--ana---
προκαταφυγεῖν|προκαταφεύγω|v--ana---
τέμενος|τέμενος|n-s---nn-
οἴκημα|οἴκημα|n-s---na-
ἐσελθών|εἰσέρχομαι|v-sapamn-
ὑπαίθριος|ὑπαίθριος|a-s---mn-
ταλαιπωροίη|ταλαιπωρέω|v3spoa---
ἡσύχαζεν|ἡσυχάζω|v3siia---
ὑστέρησαν|ὑστερέω|v3paia---
διώξει|δίωξις|n-s---fd-
οἰκήματος|οἴκημα|n-s---ng-
ὄροφον|ὄροφος|n-s---ma-
ἀφεῖλον|ἀφαιρέω|v3paia---
θύρας|θύρα|n-p---fa-
ἔνδον|ἔνδον|d--------
τηρήσαντες|τηρέω|v-papamn-
ἀπολαβόντες|ἀπολαμβάνω|v-papamn-
ἔσω|ἔσω|d--------
ἀπῳκοδόμησαν|ἀποικοδομέω|v3paia---
προσκαθεζόμενοί|προσκαθέζομαι|v-pppemn-
λιμῷ|λιμός|n-s---md-
μέλλοντος|μέλλω|v-sppamg-
ἀποψύχειν|ἀποψύχω|v--pna---
οἰκήματι|οἴκημα|n-s---nd-
ἐξάγουσιν|ἐξάγω|v3ppia---
ἔμπνουν|ἔμπνους|a-s---ma-
ἐξαχθεὶς|ἐξάγω|v-sappmn-
ἀπέθανε|ἀποθνήσκω|v3saia---
ἐμέλλησαν|μέλλω|v3paia---
Καιάδαν|Καιάδης|n-s---ma-
οὗπερ|οὗπερ|d--------
κακούργους|κάκουργος|a-p---ma-
ἐσβάλλειν|εἰσβάλλω|v--pna---
κατορύξαι|κατορύσσω|v--ana---
τάφον|τάφος|n-s---ma-
ἔχρησε|χράω|v3saia---
μετενεγκεῖν|μεταφέρω|v--ana---
προτεμενίσματι|προτεμένισμα|n-s---nd-
γραφῇ|γραφή|n-s---fd-
πεπραγμένον|πράσσω|v-srpena-
σώματα|σῶμα|n-p---na-
Χαλκιοίκῳ|χαλκίοικος|a-s---fd-
χαλκοῦς|χάλκεος|a-p---ma-
ἀνδριάντας|ἀνδριάς|n-p---ma-
κρίναντος|κρίνω|v-sapamg-
ἀντεπέταξαν|ἀντεπιτάσσω|v3paia---
μηδισμοῦ|Μηδισμός|n-s---mg-
ξυνεπῃτιῶντο|συνεπαιτιάομαι|v3piie---
ηὕρισκον|εὑρίσκω|v3piia---
ἐλέγχων|ἔλεγχος|n-p---mg-
κολάζεσθαι|κολάζω|v--pne---
ὠστρακισμένος|ὀστρακίζω|v-srpemn-
Ἄργει|Ἄργος|n-s---nd-
ἐπιφοιτῶν|ἐπιφοιτάω|v-sppamn-
πέμπουσι|πέμπω|v3ppia---
ξυνδιώκειν|συνδιώκω|v--pna---
ἄγειν|ἄγω|v--pna---
ὅπου|ὅπου|d--------
περιτύχωσιν|περιτυγχάνω|v3pasa---
προαισθόμενος|προαισθάνομαι|v-sapmmn-
φεύγει|φεύγω|v3spia---
εὐεργέτης|εὐεργέτης|n-s---mn-
δεδιέναι|δείδω|v--rna---
φασκόντων|φάσκω|v-pppamg-
ἀπεχθέσθαι|ἀπεχθάνομαι|v--anm---
διακομίζεται|διακομίζω|v3spie---
καταντικρύ|καταντικρύ|r--------
διωκόμενος|διώκω|v-sppemn-
προστεταγμένων|προστάσσω|v-prpemg-
πύστιν|πύστις|n-s---fa-
χωροίη|χωρέω|v3spoa---
ἀναγκάζεται|ἀναγκάζω|v3spie---
ἄπορον|ἄπορος|a-s---na-
Ἄδμητον|Ἄδμητος|n-s---ma-
Μολοσσῶν|Μολοσσός|n-p---mg-
ἐπιδημῶν|ἐπιδημέω|v-sppamn-
γυναικὸς|γυνή|n-s---fg-
ἱκέτης|ἱκέτης|n-s---mn-
διδάσκεται|διδάσκω|v3spie---
παῖδα|παῖς|n-s---ma-
καθέζεσθαι|κατά-ἕζομαι|v--pne---
ἑστίαν|ἑστία|n-s---fa-
Ἀδμήτου|Ἄδμητος|n-s---mg-
ὅς|ὅς|p-s---mn-
ἀξιοῖ|ἀξιόω|v3spia---
ἀντεῖπεν|ἀντεῖπον|v3saia---
δεομένῳ|δέομαι|v-sppemd-
τιμωρεῖσθαι|τιμωρέω|v--pne---
ἀσθενεστέρου|ἀσθενής|a-s---mgc
γενναῖον|γενναῖος|a-s---na-
ἐναντιωθῆναι|ἐναντιόομαι|v--ane---
ἐκδοίη|ἐκδίδωμι|v3saoa---
εἰπὼν|εἶπον|v-sapamn-
διώκεται|διώκω|v3spie---
ψυχῆς|ψυχή|n-s---fg-
ἀποστερῆσαι|ἀποστερέω|v--ana---
ἀκούσας|ἀκούω|v-sapamn-
ἀνίστησί|ἀνίστημι|v3spia---
ἐκαθέζετο|κατά-καθέζομαι|v3siie---
ἱκέτευμα|ἱκέτευμα|n-s---nn-
ἐλθοῦσι|ἔρχομαι|v-papamd-
εἰποῦσιν|εἶπον|v-papamd-
ἐκδίδωσιν|ἐκδίδωμι|v3spia---
πορευθῆναι|πορεύω|v--anp---
ὁλκάδος|ὁλκάς|n-s---fg-
τυχὼν|τυγχάνω|v-sapamn-
ἀναγομένης|ἀνάγω|v-sppefg-
ἐπιβὰς|ἐπιβαίνω|v-sapamn-
καταφέρεται|καταφέρω|v3spie---
χειμῶνι|χειμών|n-s---md-
Νάξον|Νάξος|n-s---fa-
ἀγνὼς|ἀγνώς|n-s---mn-
νηί|ναῦς|n-s---fd-
φράζει|φράζω|v3spia---
ναυκλήρῳ|ναύκληρος|n-s---md-
σώσει|σώζω|v3sasa---
ἐρεῖν|ἐρῶ|v--fna---
πεισθεὶς|πείθω|v-sappmn-
ἄγει|ἄγω|v3spia---
ἐκβῆναι|ἐκβαίνω|v--ana---
νεὼς|ναῦς|n-s---fg-
πλοῦς|πλόος|n-s---mn-
πειθομένῳ|πείθω|v-sppemd-
ἀπομνήσεσθαι|ἀπομιμνήσκομαι|v--fnm---
ἀξίαν|ἄξιος|a-s---fa-
ναύκληρος|ναύκληρος|n-s---mn-
ποιεῖ|ποιέω|v3spia---
ἀποσαλεύσας|ἀποσαλεύω|v-sapamn-
Ἔφεσον|Ἔφεσος|n-s---fa-
ἐκεῖνόν|ἐκεῖνος|p-s---ma-
ἐθεράπευσε|θεραπεύω|v3saia---
δόσει|δόσις|n-s---fd-
Ἄργους|Ἄργος|n-s---ng-
ὑπεξέκειτο|ὑπέκκειμαι|v3siie---
πορευθεὶς|πορεύω|v-sappmn-
ἐσπέμπει|εἰσπέμπω|v3spia---
Ἀρταξέρξην|Ἀρταξέρξης|n-s---ma-
βασιλεύοντα|βασιλεύω|v-sppama-
ἥκω|ἥκω|v1spia---
σέ|σύ|p2s----a-
κακὰ|κακός|a-p---na-
εἴργασμαι|ἐργάζομαι|v1srie---
σὸν|σός|a-s---ma-
ἐπιόντα|ἔπειμι|v-sppama-
ἠμυνόμην|ἀμύνω|v1siie---
ἀγαθά|ἀγαθός|a-p---na-
ἀσφαλεῖ|ἀσφαλής|a-s---nd-
ἐπικινδύνῳ|ἐπικίνδυνος|a-s---nd-
ἀποκομιδὴ|ἀποκομιδή|n-s---fn-
ὀφείλεται|ὀφείλω|v3spie---
γράψας|γράφω|v-sapamn-
προάγγελσιν|προάγγελσις|n-s---fa-
γεφυρῶν|γέφυρα|n-p---fg-
ψευδῶς|ψευδής|d--------
προσεποιήσατο|προσποιέω|v3saim---
ἀγαθὰ|ἀγαθός|a-p---na-
πάρειμι|πάρειμι|v1spia---
βούλομαι|βούλομαι|v1spie---
ἐπισχὼν|ἐπώχατο|v-sapamn-
ἐθαύμασέ|θαυμάζω|v3saia---
ἐκέλευε|κελεύω|v3siia---
ἐπέσχε|ἐπώχατο|v3saia---
Περσίδος|Περσίς|n-s---fg-
γλώσσης|γλῶσσα|n-s---fg-
ἐπιτηδευμάτων|ἐπιτήδευμα|n-p---ng-
διά|διά|r--------
προϋπάρχουσαν|προυπάρχω|v-sppafa-
ὑπετίθει|ὑποτίθημι|v3siia---
δουλώσειν|δουλόω|v--fna---
διδοὺς|δίδωμι|v-sppamn-
βεβαιότατα|βέβαιος|a-p---nas
φύσεως|φύσις|n-s---fg-
δηλώσας|δηλόω|v-sapamn-
ἑτέρου|ἕτερος|a-s---mg-
ἄξιος|ἄξιος|a-s---mn-
θαυμάσαι|θαυμάζω|v--ana---
ξυνέσει|σύνεσις|n-s---fd-
προμαθὼν|προμανθάνω|v-sapamn-
ἐπιμαθών|ἐπιμανθάνω|v-sapamn-
ἐλαχίστης|ἐλάχιστος|a-s---fg-
βουλῆς|βουλή|n-s---fg-
κράτιστος|κράτιστος|a-s---mn-
γνώμων|γνώμων|n-s---mn-
γενησομένου|γίγνομαι|v-sfpmmg-
ἄριστος|ἄριστος|a-s---mn-
εἰκαστής|εἰκαστής|n-s---mn-
ἐξηγήσασθαι|ἐξηγέομαι|v--anm---
οἷός|οἷος|a-s---mn-
ἄπειρος|ἄπειρος|a-s---mn-
κρῖναι|κρίνω|v--ana---
ἀπήλλακτο|ἀπαλλαξείω|v3slie---
προεώρα|προοράω|v3siia---
ξύμπαν|σύμπας|a-s---na-
μελέτης|μελέτη|n-s---fg-
βραχύτητι|βραχύτης|n-s---fd-
αὐτοσχεδιάζειν|αὐτοσχεδιάζω|v--pna---
νοσήσας|νοσέω|v-sapamn-
τελευτᾷ|τελευτάω|v3spia---
βίον|βίος|n-s---ma-
ἑκούσιον|ἑκούσιος|a-s---ma-
φαρμάκῳ|φάρμακον|n-s---nd-
ἀδύνατον|ἀδύνατος|a-s---ma-
μνημεῖον|μνημεῖον|n-s---nn-
Μαγνησίᾳ|Μαγνησία|n-s---fd-
Ἀσιανῇ|Ἀσιανός|a-s---fd-
ἀγορᾷ|ἀγορά|n-s---fd-
δόντος|δίδωμι|v-sapamg-
Μαγνησίαν|Μαγνησίη|n-s---fa-
ἄρτον|ἄρτος|n-s---ma-
ἐνιαυτοῦ|ἐνιαυτός|n-s---mg-
Λάμψακον|Λάμψακος|n-s---ma-
οἶνον|οἶνος|n-s---ma-
πολυοινότατον|πολύοινος|a-s---mas
Μυοῦντα|Μυόεις|n-s---fa-
ὄψον|ὄψον|n-s---na-
κομισθῆναι|κομίζω|v--anp---
προσήκοντες|προσήκω|v-pppamn-
κελεύσαντος|κελεύω|v-sapamg-
τεθῆναι|τίθημι|v--anp---
θάπτειν|θάπτω|v--pna---
φεύγοντος|φεύγω|v-sppamg-
Λακεδαιμόνιον|Λακεδαιμόνιος|a-s---ma-
Ἀθηναῖον|Ἀθηναῖος|a-s---ma-
λαμπροτάτους|λαμπρός|a-p---mas
πρεσβείας|πρέσβεια|n-s---fg-
ἐπέταξάν|ἐπιτάσσω|v3paia---
ἀντεκελεύσθησαν|ἀντικελεύω|v3paip---
ἐναγῶν|ἐναγής|a-p---mg-
ἐλάσεως|ἔλασις|n-s---fg-
φοιτῶντες|φοιτάω|v-pppamn-
ἀπανίστασθαι|ἀπανίστημι|v--pne---
αὐτόνομον|αὐτόνομος|a-s---fa-
μάλιστά|μάλιστα|d--------
ἐνδηλότατα|ἔνδηλος|a-p---nas
προύλεγον|προλέγω|v3piia---
ψήφισμα|ψήφισμα|n-s---na-
καθελοῦσι|καθαιρέω|v-papamd-
χρῆσθαι|χράομαι|v--pne---
λιμέσι|λιμήν|n-p---md-
ἐπικαλοῦντες|ἐπικαλέω|v-pppamn-
ἐπεργασίαν|ἐπεργασία|n-s---fa-
ἱερᾶς|ἱερός|a-s---fg-
ἀορίστου|ἀόριστος|a-s---fg-
ἀνδραπόδων|ἀνδράποδον|n-p---ng-
ὑποδοχὴν|ὑποδοχή|n-s---fa-
ἀφισταμένων|ἀφίστημι|v-pppeng-
ἀφικομένων|ἀφικνέομαι|v-papmmg-
τελευταίων|τελευταῖος|a-p---mg-
Ῥαμφίου|Ῥαμφίας|n-s---mg-
Μελησίππου|Μελήσιππος|n-s---mg-
Ἀγησάνδρου|Ἀγήσανδρος|n-s---mg-
εἰώθεσαν|ἔθω|v3plia---
εἰρήνην|εἰρήνη|n-s---fa-
αὐτονόμους|αὐτόνομος|a-p---ma-
ἀφεῖτε|ἀφίημι|v2paoa---
γνώμας|γνώμη|n-p---fa-
προυτίθεσαν|προτίθημι|v3piia---
ἅπαξ|ἅπαξ|d--------
βουλευσαμένους|βουλεύω|v-papmma-
ἀποκρίνασθαι|ἀποκρίνω|v--anm---
ἔχομαι|ἔχω|v1spie---
εἴκειν|εἴκω|v--pna---
εἰδὼς|οἶδα|v-srpamn-
ἀναπειθομένους|ἀναπείθω|v-pppema-
πράσσοντας|πράσσω|v-pppama-
ξυμφορὰς|συμφορά|n-p---fa-
τρεπομένους|τρέπω|v-pppema-
παραπλήσια|παραπλήσιος|a-p---na-
ξυμβουλευτέα|συμβουλευτέος|a-p---na-
δικαιῶ|δικαιόω|v1spia---
δόξασιν|δοκέω|v-papamd-
σφαλλώμεθα|σφάλλω|v1ppse---
κατορθοῦντας|κατορθόω|v-pppama-
μεταποιεῖσθαι|μεταποιέω|v--pne---
ἀμαθῶς|ἀμαθής|d--------
τύχην|τύχη|n-s---fa-
ξυμβῇ|συμβαίνω|v3sasa---
εἰώθαμεν|ἔθω|v1pria---
πρότερόν|πρότερος|a-s---na-
ἐπιβουλεύοντες|ἐπιβουλεύω|v-pppamn-
εἰρημένον|ἐρῶ|v-srpenn-
διαφορῶν|διαφορά|n-p---fg-
διδόναι|δίδωμι|v--pna---
διαλύεσθαι|διαλύω|v--pne---
ἐπιτάσσοντες|ἐπιτάσσω|v-pppamn-
αἰτιώμενοι|αἰτιάομαι|v-pppemn-
κελεύουσι|κελεύω|v3ppia---
καθαιρεῖν|καθαιρέω|v--pna---
ἥκοντες|ἥκω|v-pppamn-
προαγορεύουσιν|προαγορεύω|v3ppia---
βραχέος|βραχύς|a-s---ng-
καθέλοιμεν|καθαιρέω|v1paoa---
προύχονται|προέχω|v3ppie---
καθαιρεθείη|καθαιρέω|v3saop---
αἰτίαν|αἰτία|n-s---fa-
ὑπολίπησθε|ὑπολείπω|v2pase---
ἐπολεμήσατε|πολεμέω|v2paia---
βεβαίωσιν|βεβαίωσις|n-s---fa-
ξυγχωρήσετε|συγχωρέω|v2pasa---
ἐπιταχθήσεσθε|ἐπιτάσσω|v2pfip---
ὑπακούσαντες|ὑπακούω|v-papamn-
ἀπισχυρισάμενοι|ἀπισχυρίζομαι|v-papemn-
καταστήσαιτε|καθίστημι|v2paoa---
προσφέρεσθαι|προσφέρω|v--pne---
διανοήθητε|διανοέομαι|v2paie---
ὑπακούειν|ὑπακούω|v--pna---
βλαβῆναι|βλάπτω|v--anp---
πολεμήσομεν|πολεμέω|v1pfia---
ἔμοιγε|ἐγώ|p1s---md-
μεγάλῃ|μέγας|a-s---fd-
προφάσει|πρόφασις|n-s---fd-
εἴξοντες|εἴκω|v-pfpamn-
ἕξοντες|ἔχω|v-pfpamn-
δούλωσιν|δούλωσις|n-s---fa-
ἐλαχίστη|ἐλάχιστος|a-s---fns
δικαίωσις|δικαίωσις|n-s---fn-
ἐπιτασσομένη|ἐπιτάσσω|v-sppefn-
ἀσθενέστερα|ἀσθενής|a-p---nac
γνῶτε|γιγνώσκω|v2pama---
αὐτουργοί|αὐτουργός|a-p---mn-
χρονίων|χρόνιος|a-p---mg-
διαποντίων|διαπόντιος|a-p---mg-
πενίας|πενία|n-s---fg-
ἐπιφέρειν|ἐπιφέρω|v--pna---
τοιοῦτοι|τοιοῦτος|p-p---mn-
πληροῦντες|πληρόω|v-pppamn-
πεζὰς|πεζός|a-p---fa-
στρατιὰς|στρατιά|n-p---fa-
δύνανται|δύναμαι|v3ppie---
ἀπόντες|ἄπειμι|v-pppamn-
δαπανῶντες|δαπανάω|v-pppamn-
εἰργόμενοι|ἔργω|v-pppemn-
περιουσίαι|περιουσία|n-p---fn-
ἐσφοραὶ|εἰσφορά|n-p---fn-
ἀνέχουσιν|ἀνέχω|v3ppia---
σώμασί|σῶμα|n-p---nd-
ἑτοιμότεροι|ἑτοῖμος|a-p---mnc
αὐτουργοὶ|αὐτουργός|a-p---mn-
προαναλώσειν|προαναλίσκω|v--fna---
δόξαν|δόξα|n-s---fa-
μηκύνηται|μηκύνω|v3spse---
ἀντισχεῖν|ἀντέχω|v--ana---
ὁμοίαν|ὅμοιος|a-s---fa-
ἀντιπαρασκευὴν|ἀντιπαρασκευή|n-s---fa-
βουλευτηρίῳ|βουλευτήριον|n-s---nd-
ἑνὶ|εἷς|n-s---nd-
παραχρῆμά|παραχρῆμα|d--------
ὀξέως|ὀξέως|d--------
ἐπιτελῶσι|ἐπιτελέω|v3ppsa---
ἰσόψηφοι|ἰσόψηφος|a-p---mn-
ὁμόφυλοι|ὁμόφυλος|a-p---mn-
σπεύδῃ|σπεύδω|v3spsa---
ἐπιτελὲς|ἐπιτελής|a-s---nn-
τιμωρήσασθαί|τιμωρέω|v--anm---
φθεῖραι|φθείρω|v--ana---
χρόνιοί|χρόνιος|a-p---mn-
ξυνιόντες|σύνειμι|v-pppamn-
σκοποῦσί|σκοπέω|v3ppia---
πράσσουσι|πράσσω|v3ppia---
ἀμέλειαν|ἀμέλεια|n-s---fa-
βλάψειν|βλάπτω|v--fna---
μέλειν|μέλω|v--pna---
τινι|τις|p-s---md-
προϊδεῖν|προεῖδον|v--ana---
δοξάσματι|δόξασμα|n-s---nd-
ἁθρόον|ἀθρόος|a-s---na-
φθειρόμενον|φθείρω|v-sppena-
σπάνει|σπάνις|n-s---fd-
κωλύσονται|κωλύω|v3pfim---
σχολῇ|σχολή|n-s---fd-
ποριζόμενοι|πορίζω|v-pppemn-
διαμέλλωσιν|διαμέλλω|v3ppsa---
καιροὶ|καιρός|n-p---mn-
μενετοί|μενετός|a-p---mn-
ἐπιτείχισις|ἐπιτείχισις|n-s---fn-
φοβηθῆναι|φοβέω|v--anp---
εἰρήνῃ|εἰρήνη|n-s---fd-
κατασκευάσασθαι|κατασκευάζω|v--anm---
ἦ|ἦ|d--------
πολεμίᾳ|πολέμιος|a-s---fd-
ἀντεπιτετειχισμένων|ἀντεπιτειχίζομαι|v-prpemg-
φρούριον|φρούριον|n-s---na-
ποιήσονται|ποιέω|v3pfim---
βλάπτοιεν|βλάπτω|v3ppoa---
καταδρομαῖς|καταδρομή|n-p---fd-
αὐτομολίαις|αὐτομολία|n-p---fd-
ἱκανόν|ἱκανός|a-s---nn-
ἐπιτειχίζειν|ἐπιτειχίζω|v--pna---
πλεύσαντας|πλέω|v-papama-
ᾗπερ|ὅσπερ|a-s---fd-
ἰσχύομεν|ἰσχύω|v1ppia---
ἐμπειρίας|ἐμπειρία|n-s---fg-
ἐμπειρίαν|ἐμπειρία|n-s---fa-
ἐπιστήμονας|ἐπιστήμων|a-p---ma-
προσγενήσεται|προσγίγνομαι|v3sfim---
μελετῶντες|μελετάω|v-pppamn-
ἐξείργασθέ|ἐξεργάζομαι|v2prie---
γεωργοὶ|γεωργός|a-p---mn-
μελετῆσαι|μελετάω|v--ana---
ἐασόμενοι|ἐάω|v-pfpmmn-
ἐφορμεῖσθαι|ἐφορμάω|v--pne---
δρῷεν|δράω|v3ppoa---
ὀλίγας|ὀλίγος|a-p---fa-
ἐφορμούσας|ἐφορμάω|v-pppafa-
διακινδυνεύσειαν|διακινδυνεύω|v3paoa---
ἀμαθίαν|ἀμαθία|n-s---fa-
θρασύνοντες|θρασύνω|v-pppamn-
ἡσυχάσουσι|ἡσυχάω|v3pfia---
μελετῶντι|μελετάω|v-sppand-
ἀξυνετώτεροι|ἀσύνετος|a-p---mnc
ἔσονται|εἰμί|v3pfim---
ὀκνηρότεροι|ὀκνηρός|a-p---mnc
παρέργου|πάρεργον|n-s---ng-
μελετᾶσθαι|μελετάω|v--pne---
πάρεργον|πάρεργος|a-s---na-
κινήσαντες|κινέω|v-papamn-
Ὀλυμπίασιν|Ὀλυμπία|d--------
πειρῷντο|πειράω|v3ppoe---
ναυτῶν|ναύτης|n-p---mg-
ἀντιπάλων|ἀντίπαλος|a-p---mg-
ἐσβάντων|εἰσβαίνω|v-papamg-
μετοίκων|μέτοικος|n-p---mg-
κυβερνήτας|κυβερνήτης|n-p---ma-
πολίτας|πολίτης|n-p---ma-
ὑπηρεσίαν|ὑπηρεσία|n-s---fa-
ἀμείνους|ἀμείνων|a-p---mac
ἅπασα|ἅπας|a-s---fn-
κινδύνῳ|κίνδυνος|n-s---md-
δέξαιτο|δέχομαι|v3saom---
ξένων|ξένος|n-p---mg-
φεύγειν|φεύγω|v--pna---
ἥσσονος|ἥσσων|a-s----gc
ἐλπίδος|ἐλπίς|n-s---fg-
μισθοῦ|μισθός|n-s---mg-
δόσεως|δόσις|n-s---fg-
ξυναγωνίζεσθαι|συναγωνίζομαι|v--pne---
ὧνπερ|ὅς|p-p---ng-
ἐμεμψάμην|μέμφομαι|v1saim---
ἀπηλλάχθαι|ἀπαλλαξείω|v--rne---
πλευσούμεθα|πλέω|v1pfim---
ὁμοίου|ὁμοῖος|a-s---ng-
τμηθῆναι|τέμνω|v--anp---
ἅπασαν|ἅπας|a-s---fa-
ἀντιλαβεῖν|ἀντιλαμβάνω|v--ana---
ἀμαχεί|ἀμαχεί|d--------
τίνες|τις|p-p---mn-
διανοηθέντας|διανοέομαι|v-papema-
οἰκίας|οἰκία|n-p---fa-
ὀργισθέντας|ὀργίζω|v-pappma-
πλέοσι|πλείων|a-p---mdc
διαμάχεσθαι|διαμάχομαι|v--pne---
κρατήσαντές|κρατέω|v-papamn-
ἐλάσσοσι|ἐλάσσων|a-p---mdc
μαχούμεθα|μάχομαι|v1pfim---
σφαλῶμεν|σφάλλω|v1pasp---
προσαπόλλυται|προσαπόλλυμι|v3spie---
ἱκανῶν|ἱκανός|a-p---mg-
ὀλόφυρσιν|ὀλόφυρσις|n-s---fa-
οἰκιῶν|οἰκία|n-p---fg-
κτῶνται|κτάομαι|v3ppie---
κτᾶται|κτάομαι|v3spie---
ᾤμην|οἴομαι|v1siie---
πείσειν|πείθω|v--fna---
ἐξελθόντας|ἐξέρχομαι|v-papama-
δῃῶσαι|δηιόω|v--ana---
ὑπακούσεσθε|ὑπακούω|v2pfim---
ἔχω|ἔχω|v1spia---
περιέσεσθαι|περίειμι|v--fnm---
ἐθέλητε|ἐθέλω|v2ppsa---
ἐπικτᾶσθαι|ἐπικτάομαι|v--pne---
κινδύνους|κίνδυνος|n-p---ma-
αὐθαιρέτους|αὐθαίρετος|a-p---ma-
πεφόβημαι|φοβέω|v1srie---
οἰκείας|οἰκεῖος|a-p---fa-
ἁμαρτίας|ἁμαρτία|n-p---fa-
δηλωθήσεται|δηλόω|v3sfip---
ἀποπέμψωμεν|ἀποπέμπω|v1pasa---
ἐάσομεν|ἐάω|v1pfia---
ξενηλασίας|ξενηλασία|n-p---fa-
ποιῶσι|ποιέω|v3ppsa---
ἡμετέρων|ἡμέτερος|a-p---mg-
κωλύει|κωλύω|v3spia---
ἀφήσομεν|ἀφίημι|v1pfia---
ἐσπεισάμεθα|σπένδω|v1paim---
ἀκεῖνοι|ἐκεῖνος|p-p---mn-
ἀποδῶσι|ἀποδέω|v3ppsa---
αὐτονομεῖσθαι|αὐτονομέομαι|v--pne---
ἐθέλομεν|ἐθέλω|v1ppia---
ἄρξομεν|ἄρχω|v1pfia---
ἀρχομένους|ἄρχω|v-pppema-
πρέποντα|πρέπω|v-pppana-
δεχώμεθα|δέχομαι|v1ppse---
ἐγκεισομένους|ἔγκειμαι|v-pfpmma-
ἰδιώτῃ|ἰδιώτης|n-s---md-
τιμαὶ|τιμή|n-p---fn-
περιγίγνονται|περιγίγνομαι|v3ppie---
ὑποστάντες|ὑφίστημι|v-papamn-
τοσῶνδε|τοσόσδε|p-p---fg-
ὑπάρχοντα|ὑπάρχω|v-pppana-
τόλμῃ|τόλμα|n-s---fd-
ἀπεώσαντο|ἀπωθέω|v3paim---
προήγαγον|προάγω|v3paia---
ἐπιγιγνομένοις|ἐπιγίγνομαι|v-pppemd-
παραινεῖν|παραινέω|v--pna---
ἕκαστά|ἕκαστος|a-p---na-
ἔφρασε|φράζω|v3saia---
κελευόμενοι|κελεύω|v-pppemn-
διαφοραὶ|διαφορά|n-p---fn-
ἀρξάμεναι|ἄρχω|v-papmfn-
ἐπεμείγνυντο|ἐπιμίγνυμι|v3piie---
ἐφοίτων|φοιτάω|v3piia---
ἀκηρύκτως|ἀκήρυκτος|d--------
ἀνυπόπτως|ἀνύποπτος|d--------
οὔ|οὐ|d--------
ξύγχυσις|σύγχυσις|n-s---fn-
γιγνόμενα|γίγνομαι|v-pppenn-
